,ticker,eps,roce,divYield,fcfYield,eps_rank,roce_rank,fcfYield_rank,overall_rank
0,IX,98931.52925711316,3.025793535417307,21029.330863951494,247294.826777072,2,1,1,4
1,RE,0.1685173784801902,0.5878709677419355,0.019282083830868,0.3212341604878635,45,7,27,79
2,CVI,0.2525327159581629,0.3712396694214876,0.1487611447711935,0.2252762589691805,13,31,40,84
3,DECK,0.1893192576365502,0.3839705976106833,0.0,0.2352446241105362,32,28,38,98
4,WSM,0.1459862810751064,0.3705816841932163,0.035733331816745,0.2293043140303148,59,32,39,130
5,CEO,0.3861131669992614,0.2370224608896081,0.2108444928445225,0.3019693801471993,6,106,30,142
6,PBR,0.2393083953982756,0.221162475855934,0.188541185248791,0.2809489890521673,14,132,32,178
7,VLO,0.1925256047069078,0.2545248631530379,0.0316408803660928,0.1593593375463063,29,90,79,198
8,TS,0.1912514216379146,0.2347036180577252,0.0310698351451981,0.1876560717108046,30,109,61,200
9,BTU,0.2269880278457772,0.1970460155324998,0.0091440674724602,0.4217925240973072,19,175,19,213
10,WU,0.1416310100417743,0.2738509983498094,0.0789604193363885,0.1437351129066122,63,72,98,233
11,HRB,0.1131749028044859,0.3675644816252913,0.0363674274543763,0.1537361584252744,117,34,84,235
12,ERF,0.1406706333246212,0.3679517067590538,0.0149909549975805,0.1190803640228159,64,33,144,241
13,MO,0.1134141452130721,0.439506807089648,0.094567587995008,0.1268201714799555,116,19,123,258
14,MPC,0.1603278564723698,0.2016145817846629,0.0208835272194668,0.2024923769329269,49,167,55,271
15,CRC,0.1481976641525616,0.2643406268480189,0.0212837070857402,0.1208704353017346,56,78,140,274
16,CIVI,0.1329957386448424,0.259521428072117,0.1119738490732515,0.1237262533772582,74,85,132,291
17,MLI,0.1161414538670711,0.3016465321929781,0.0128813820951868,0.1194041800112493,105,58,142,305
18,CIG,0.233270286670182,0.1587279952229761,0.0737779605716843,0.2177596337660354,17,258,44,319
19,HPQ,0.1249264913075971,0.2761265580057526,0.039702351053012,0.1134024723423544,88,71,160,319
20,APA,0.25834672573803,0.5329439252336449,0.027870680044593,0.0698576785533307,12,9,309,330
21,PBF,0.3896797866029486,0.1836749789649848,0.0192609770719887,0.1231937919150737,5,197,134,336
22,SHG,0.2170850746651896,0.1413014695351873,0.0726280427351298,0.6628703751951701,22,306,11,339
23,TOL,0.1763697532681411,0.178293778710022,0.0117079290118141,0.1534117644518214,42,211,86,339
24,VIPS,0.1163424598901636,0.2183326539317113,0.0,0.1316388551348747,103,139,119,361
25,DHI,0.1296107125847148,0.2273876822374293,0.0093185778987092,0.1134916484703589,81,123,159,363
26,ALSN,0.1285946307442438,0.2031388152077807,0.0158593675360657,0.1259195567020158,85,164,124,373
27,BP,0.1487810200055302,0.1542251925690983,0.0469511073696827,0.173335404500176,55,272,69,396
28,TEX,0.1335550656817625,0.2549773665024236,0.0111381830838844,0.0856247824573616,73,89,235,397
29,OGN,0.2779478627300982,0.1443107221006564,0.0798794444209666,0.146173949314558,9,297,95,401
30,CMC,0.1304583237437719,0.2016054167284975,0.0113706440728381,0.1118974194484038,79,168,166,413
31,ACT,0.1431965763006848,0.1638075398142164,0.0458230076967909,0.1359942625921018,62,244,109,415
32,DVN,0.129444807180093,0.2171174844818993,0.0641869366801742,0.090822097164789,82,141,222,445
33,KBH,0.1401223808475298,0.1231240691652011,0.0134930622947793,0.2486381221520654,65,356,37,458
34,AMG,0.1266077147730826,0.1441330312770575,0.0002822285215628,0.1621685084899984,87,298,77,462
35,NUE,0.1040890198398974,0.2029524825839077,0.0118363967242541,0.1126689317513264,136,165,163,464
36,GGB,0.1823388527046772,0.1433021189193826,0.0652230499836149,0.1243787643222173,36,300,129,465
37,SM,0.177985253242366,0.1717501370042287,0.0155844817402293,0.1033797751788679,41,228,196,465
38,MTG,0.1303203846930812,0.149548955818174,0.0224768477181183,0.1299573625358154,80,281,120,481
39,TMHC,0.1329310366169098,0.1461211593145188,0.0,0.1335903939485449,75,293,116,484
40,VALE,0.1152832692171296,0.1842959800882325,0.0808576187968817,0.1063144548389944,109,195,187,491
41,DQ,0.2161257149716088,0.105803757778126,0.0,0.215953134403251,23,426,45,494
42,BG,0.1493162984338173,0.1242861181792479,0.0254962738743433,0.1439907059796464,53,351,97,501
43,BMY,0.0755931661517068,0.236525508594318,0.0446871003394015,0.11916874080813,253,108,143,504
44,ESNT,0.1243069560450834,0.1397699791706493,0.0189596909419898,0.1354835613169453,91,308,111,510
45,LEN,0.108672063028391,0.1470021382924115,0.011880084493227,0.1401665378586937,125,288,100,513
46,CHK,0.236676326269949,0.2405450926351248,0.0476483550613746,0.0539101512090706,16,103,402,521
47,CBT,0.1145122537118053,0.1890726096333572,0.0226451198351435,0.0903231484333565,112,185,224,521
48,EOG,0.108065878348331,0.2413845109720232,0.048184232826896,0.0733578618495715,126,102,294,522
49,AGCO,0.1289879565726598,0.2450406917599186,0.0503663064165397,0.0644168982371572,84,98,344,526
50,ARW,0.1311349375757246,0.1723020691277076,0.0,0.0903010357461919,78,225,225,528
51,MRO,0.105965720021384,0.1436146425605315,0.0171154412647151,0.1400602245327689,130,299,102,531
52,CRI,0.0848472250065431,0.1617757269180517,0.0408744663950875,0.1712534489824657,212,249,71,532
53,DFS,0.1029786757082411,0.1176822517312281,0.0263401238546249,0.2893210412755345,139,370,31,540
54,NEU,0.0743427889093973,0.2483896031638699,0.0162567496917217,0.101044051962341,262,94,202,558
55,AB,0.0753782743415154,0.3935760562973516,0.0844958316371243,0.0742837680111773,256,27,283,566
56,SIG,0.1800039670173382,0.1342098734805259,0.0161701490607875,0.0936002859095586,39,319,216,574
57,ICL,0.1001594716816052,0.1369539291413953,0.076889808331166,0.1281496808099534,148,316,121,585
58,BBWI,0.0886277834978701,0.3073790129372304,0.0183715906567338,0.066218480608887,200,54,331,585
59,MAIN,0.1209872535893505,0.1422505046020529,0.0766956405053927,0.1044504717763236,93,302,192,587
60,OC,0.0895509670418747,0.2032985526758667,0.014076573414609,0.089326340870365,196,163,229,588
61,PII,0.0929155239332316,0.1756315422191207,0.027220478670177,0.1016748633016389,180,213,200,593
62,PDI,0.1032122172713495,0.1326961071319514,0.0018844788387804,0.1217344388594759,138,325,138,601
63,MPLX,0.1068648127471657,0.1277392714938799,0.089670677905972,0.1214199743611508,128,340,139,607
64,SU,0.149504545142688,0.1099288084923108,0.049546473128059,0.1174408217178728,52,410,148,610
65,MSM,0.0603673162644108,0.2553087616073907,0.031080374828951,0.1067739222733389,356,87,184,627
66,BYD,0.0977344073788631,0.1704783956840468,0.010026705330225,0.0852095771594965,163,230,238,631
67,INGR,0.089767108103052,0.1635434412265758,0.0270836998009208,0.1034485647035172,195,246,195,636
68,CPG,0.113919697686426,0.0967532581431653,0.0423278694367064,0.1948000862419825,114,468,57,639
69,SKM,0.1818389639208223,0.0755861331989232,0.1286637399548064,0.3074868279127901,38,574,28,640
70,HP,0.1005055254284397,0.1417828552683871,0.0466423430792714,0.1014598764439108,146,304,201,651
71,RDN,0.1328397602977525,0.108893956331451,0.0321369145152523,0.1130243310459007,76,416,162,654
72,EME,0.0620434267093594,0.2840511282067539,0.0032035490012942,0.0804955911564535,339,64,252,655
73,MAS,0.0602501575926478,0.3675027262813522,0.0170531833714873,0.0776351149596894,357,35,270,662
74,G,0.0997367134188203,0.1808763222232129,0.0158019622115783,0.0682604509776557,151,205,314,670
75,GEF,0.0978637404203692,0.1205814995519267,0.0317403278367845,0.1187605914511106,162,363,145,670
76,NMR,5358916.732284205,0.0535022424888398,1177337.47044421,71289.14973785415,1,670,2,673
77,GIL,0.0917354176841582,0.2307069378020433,0.0230746604990097,0.058213083739276,185,115,377,677
78,MKL,0.1053251707935347,0.1048705585345818,0.0018995952769792,0.1334037217809911,132,431,118,681
79,MTH,0.115808833500041,0.2224262739395764,0.0061974941706652,0.0497536474904067,107,129,449,685
80,NVR,0.0702121926932845,0.2914729512268396,0.0,0.0649928548158094,293,62,338,693
81,AMAT,0.0622903515370889,0.3276961938605129,0.0088583857568059,0.068995468140702,336,45,313,694
82,PSX,0.1170510665741241,0.1328024142845167,0.0314027237765504,0.0769383418351085,101,324,273,698
83,RNR,0.2751352830943507,0.0552126920315601,0.0118693109231564,0.3545661079162256,10,664,24,698
84,EBAY,0.1196871782893427,0.1191228070175438,0.0228387532116996,0.0852127723997127,96,365,237,698
85,HIG,0.1014393613403737,0.0946333352445387,0.0222404989520228,0.1622462628467239,143,482,76,701
86,KT,0.2290342841695347,0.0558612306535879,0.1214720416700468,0.3067933057001538,18,658,29,705
87,TX,0.08272382849241,0.1156376749896969,0.0752728396655645,0.143265280294897,228,381,99,708
88,CINF,0.1134627247553133,0.0962815685942721,0.0279501231898601,0.125221477022413,115,471,126,712
89,DKS,0.0815311375917152,0.1908192904043095,0.0273610102189716,0.0732254741697872,235,183,295,713
90,AVT,0.1069413404427615,0.1150803314517604,0.0240094191085061,0.0993945304547686,127,387,205,719
91,MUR,0.0998992237408088,0.1168174040083621,0.0258186639086702,0.1030976768765897,150,376,198,724
92,CAT,0.0684577165995198,0.2621142033821187,0.0169769838069249,0.0648675780028154,303,82,339,724
93,CF,0.0992363680140037,0.1633028874484384,0.0202377117720361,0.0670902920802871,155,247,324,726
94,TNET,0.055317811892887,0.38130081300813,0.0,0.0693316575724183,388,29,311,728
95,RS,0.0818908640852786,0.1792522825168483,0.0145955645921886,0.0737134247043548,232,208,290,730
96,CPA,0.1150297472490403,0.205729490330008,0.0300166516006191,0.0480872347052798,110,159,462,731
97,HAL,0.0811721030128758,0.2140498034076015,0.0177237040695286,0.0639714943759548,237,148,347,732
98,OMC,0.0755532114781519,0.1783855711694607,0.0326201120990992,0.077883633561649,254,209,269,732
99,THC,0.0795483918795892,0.1030485733695652,0.0,0.2113044844853901,241,444,47,732
100,FOXA,0.0920330411493768,0.1302839116719243,0.0172293701285642,0.091665154242717,183,331,220,734
101,FOX,0.0920330411493768,0.1302839116719243,0.0172293701285642,0.091665154242717,183,331,220,734
102,CNQ,0.0869708176337904,0.1527145359019264,0.0411032978759964,0.0786360702618651,204,273,261,738
103,FITB,0.0995461517416079,0.0926388403772266,0.0449207836722453,0.1480690737271937,153,493,93,739
104,ABEV,0.0677884797711993,0.1821751483982742,0.055728614775979,0.0874465732957854,307,201,232,740
105,TROW,0.074117416623293,0.1726665028678906,0.0464792901136846,0.0797817822812592,263,222,256,741
106,AYI,0.0674507106076621,0.1682840993921296,0.0032750634052275,0.0996944896091283,310,235,204,749
107,BHP,0.0540013296211892,0.2616673858242682,0.0524832474158069,0.0779008670437619,398,83,268,749
108,BSMX,0.1662143730347077,0.0557874049963975,0.1122367639037054,0.2036119791749009,47,659,52,758
109,MUSA,0.0726556791723967,0.2294890673186453,0.0043582968469074,0.0585107876093798,269,116,375,760
110,RRC,0.1207595855587781,0.1661948958124238,0.0107073142474425,0.0515207277889622,94,240,430,764
111,XOM,0.0868207248713192,0.1395365288214507,0.0360230061178111,0.0806485211592787,205,309,250,764
112,AAL,0.091530338351984,0.097692457800761,0.0,0.1344003873367941,188,463,115,766
113,SON,0.0864869220540145,0.1151204311494886,0.0359481601658571,0.1092888457285333,206,386,175,767
114,PCAR,0.0899316804223551,0.1869490310491832,0.0296840223198984,0.0572237424874901,193,190,385,768
115,HCA,0.0710930863046068,0.2210258058591238,0.0089646184752661,0.0635660617149355,285,133,350,768
116,MMP,0.0984795158046129,0.11403282632981,0.0826680613180367,0.0917900542910615,158,394,218,770
117,DVA,0.0727077423696902,0.1068955656317179,0.0,0.1572845937915209,268,423,80,771
118,TPR,0.083201902876461,0.1130024733198113,0.0327709455692335,0.1169211054270072,225,397,151,773
119,ENS,0.0711470035338636,0.148593311304382,0.0091162584425172,0.0979817995571156,284,283,209,776
120,PAA,0.1161489539511891,0.0642000715819613,0.093391313380265,0.2047243350944536,104,622,51,777
121,T,0.1195048714003099,0.0659140905732258,0.0675202523411751,0.1698048037306765,98,615,72,785
122,SSL,0.0559317673333771,0.1579092263198465,0.0874287450736753,0.1172793621207873,384,260,149,793
123,MTDR,0.1248957164005355,0.1723468067071516,0.0113924159272254,0.0469451678437885,89,224,481,794
124,RIO,0.0833102486581483,0.1632381120190295,0.0535909036407059,0.0668768092728067,224,248,327,799
125,HOG,0.1347108320743169,0.0843110495426716,0.0183615302837552,0.104377797573888,70,536,193,799
126,SNA,0.0661730423421081,0.197764753986643,0.0232728057134345,0.0693210230924349,315,173,312,800
127,MOH,0.0523321955677652,0.2339381320642474,0.0,0.0756922132043387,418,111,276,805
128,AMX,0.0768496910963225,0.1680638596365067,0.0307624830494292,0.0679654804148141,250,237,318,805
129,WES,0.0912090284696272,0.1154765265902972,0.0873021452663012,0.0861280102443178,189,383,234,806
130,KSS,0.109159779614325,0.0629112924453803,0.0757575757575757,0.2035123966942149,124,629,53,806
131,QCOM,0.0586297675295668,0.1880614314691393,0.0280664069672788,0.0798457660949534,366,186,255,807
132,SWKS,0.0625379965417022,0.1525444412805597,0.0257838789160538,0.1031036994266586,335,275,197,807
133,WRB,0.0714040297069598,0.1034547481779871,0.0259208352938904,0.1514742351093479,281,441,88,810
134,EQT,0.1178372083888125,0.0995520180479759,0.0155061861043901,0.0787612988770688,100,455,259,814
135,COP,0.0784862869857126,0.1749322035870995,0.0399916893530376,0.0624409020401987,244,215,356,815
136,BBVA,0.161815070023158,0.035747844186738,0.0566625161023853,1.520363466245769,48,765,5,818
137,SEAS,0.0687352551628028,0.2076457987354858,0.0,0.0587223942892859,300,158,374,832
138,LOW,0.0604807239024423,0.4150712537786095,0.0198131908098733,0.0483470037304535,355,21,459,835
139,CVE,0.0983420710762317,0.1147049575516193,0.0245556011010498,0.0739540033160272,160,389,288,837
140,KR,0.0653213605678732,0.1445989491102273,0.02402763540297,0.0897112216301845,318,296,227,841
141,OLN,0.0677531412385044,0.1226839126919967,0.0148697680684244,0.1086965323259188,308,357,177,842
142,DE,0.094592819133989,0.2454976754518191,0.0132779808089909,0.0383451709277168,176,97,573,846
143,EPD,0.0966588738507343,0.1117871774040206,0.0751500029703558,0.0751849483332809,169,401,278,848
144,LMT,0.0609981992132783,0.2395056167121822,0.0269379330629737,0.0549071940606229,348,104,397,849
145,PM,0.0535092419699838,0.3262249171398473,0.0545434024125114,0.0539886540956588,402,46,401,849
146,FLT,0.0474931852159662,0.1956084845510068,0.0,0.0941897305226687,461,176,215,852
147,TLK,0.0621779700036626,0.212837743764909,0.0422622850112912,0.0611623311601099,338,150,364,852
148,UL,0.0583677246911161,0.1946314714244384,0.0393784478964972,0.0712973409052573,368,179,306,853
149,FIX,0.0439196725461511,0.2626185483982948,0.0041256771293561,0.0739780803408335,487,81,287,855
150,JNJ,0.0885241250716222,0.2047890761568653,0.0296398302305064,0.0459530689928871,201,160,495,856
151,PRI,0.0779412247514125,0.1159983855895872,0.0126677925941485,0.0890280270859317,247,380,231,858
152,UBS,0.2792164894916507,0.0178502453960993,0.0179671571509071,0.481795900435906,8,833,17,858
153,PVH,0.0900404612199152,0.0976741971576165,0.0012754375157733,0.0983308050724421,192,464,207,863
154,ABM,0.0967863690283619,0.1102050702405942,0.0221457071990879,0.0734467193541926,168,409,292,869
155,FANG,0.1125948421319504,0.1699326962406574,0.051729860654959,0.0432037478877289,118,231,523,872
156,SYY,0.054634255044008,0.2220591987751977,0.0281694777925115,0.0643035400799296,395,131,346,872
157,GILD,0.0560333640354625,0.1842462385681974,0.0376753898695634,0.0734022232139748,383,196,293,872
158,SEM,0.0841665175982792,0.0861449619525408,0.0220894289341307,0.1219709519723259,215,527,136,878
159,AZO,0.0556769540254107,0.4648081046590444,0.0,0.0472146240829108,386,16,479,881
160,KB,0.225392282388786,0.0146546320170494,0.0560520685717412,0.6330539796742667,20,848,14,882
161,SYF,0.1391304088345198,0.0256484989798892,0.027850948685373,0.5342035760120775,66,803,15,884
162,VC,0.1384737683385142,0.155902004454343,0.0,0.0404594137943807,67,265,552,884
163,SAN,0.1828571758569689,0.015723563529772,0.0373275618104556,1.1047868681087492,35,844,6,885
164,CVX,0.0764881306485566,0.1310218246183089,0.0405760423525685,0.0708004691014296,251,329,307,887
165,FMS,0.0884615192009559,0.0538136554972716,0.0582578448855919,0.344666055984494,202,666,25,893
166,WF,0.2616969545123527,0.0084640378881941,0.1021579332879985,0.6410354555773493,11,870,12,893
167,RF,0.1143349827560354,0.0668632982816106,0.0487880712338916,0.111137572437882,113,613,170,896
168,IHG,0.0486715268971836,0.3987800228745711,0.01589936545308,0.0526301444181546,453,25,419,897
169,CB,0.0972310167657141,0.0603891289341139,0.015013296120005,0.1485820898648419,166,640,92,898
170,THO,0.0605988136207943,0.1076411509522851,0.015538493616588,0.1252287401590118,353,420,125,898
171,ABC,0.0478872184900548,0.1705134085125763,0.0109409274817158,0.0947424691817918,457,229,213,899
172,BBY,0.0753138496829019,0.2431283649759138,0.0486111149041132,0.0409644226720055,257,99,546,902
173,BAM,0.1383061258860971,0.2012280200847394,0.0320948961552157,0.0311853230484761,68,170,665,903
174,NTAP,0.0467816502061049,0.2195121951219512,0.0197374913648475,0.0725922158370594,471,136,300,907
175,AGO,0.1691047653219443,0.0531512259338489,0.0153315551780382,0.1054902527921736,44,674,190,908
176,SAIC,0.0696306553558454,0.1782964388835418,0.0115321211176347,0.053865223954522,295,210,403,908
177,WNS,0.0581030233091657,0.1665285170722938,0.0,0.072533010389244,369,239,301,909
178,SMFG,0.4180255064016069,-2.363261552749548e-05,0.151074989130048,1.9395660962590413,4,905,3,912
179,CSL,0.0492230500112987,0.1818466238474704,0.0102820627010831,0.0784592582405793,447,202,263,912
180,CTRA,0.0842269161234678,0.1011566771819137,0.0461304340614685,0.0808060075301454,214,451,248,913
181,SKX,0.0566558424744297,0.1333199920359929,0.0,0.0941956489599312,379,321,214,914
182,LKQ,0.073190162116209,0.1153813451237139,0.0236147745289478,0.0780382284102314,266,385,266,917
183,BC,0.0618977156444856,0.1640987852804573,0.016490352407665,0.0654166390600499,340,243,336,919
184,LYB,0.0684120255007928,0.1022780569514237,0.0521018737257693,0.1103847771916766,304,448,172,924
185,BERY,0.0819055783347506,0.0777153558052434,0.017080473642879,0.1245395164827243,231,565,128,924
186,DAL,0.1792898968645468,0.1169059416423156,0.0049791943585727,0.0443848497119652,40,375,509,924
187,AFG,0.0846078886131188,0.0574898785425101,0.0679246429710953,0.1884809537414313,213,654,60,927
188,SNX,0.0686551594184035,0.085058196068629,0.0142777009081272,0.1376984343507777,301,531,104,936
189,FBHS,0.0511725406502265,0.1146217798158297,0.0147761501803373,0.133567289044522,432,390,117,939
190,ORAN,0.0887341066562594,0.0568015191942501,0.0677143059811291,0.1536481969765147,199,656,85,940
191,AON,0.043294304857084,0.3365290867728306,0.0082569871587808,0.0537464010764814,496,40,406,942
192,KMB,0.0429760914063458,0.2250816208949491,0.0386882274111548,0.0676313093786938,497,126,320,943
193,GPK,0.0951675172071558,0.1553692056836711,0.0161903245041219,0.0447537425317192,173,266,505,944
194,AFL,0.094725402312294,0.1047113501414493,0.0196404246906366,0.0648581312247731,175,433,340,948
195,CCZ,0.0851343045106022,0.1037963074265514,0.0263679552441857,0.0717068963323313,210,437,304,951
196,GPS,0.0684884783824713,0.0782586814292903,0.0302877334679454,0.1517115298034026,302,562,87,951
197,CMCSA,0.0851343045106022,0.1037963074265514,0.0263679552441857,0.0717068963323313,210,437,304,951
198,GIS,0.0635159699440171,0.1497290970994565,0.0346862426586849,0.064327537452314,328,280,345,953
199,HSBC,0.1490112964657785,0.0118054599346315,0.0772252484467188,0.2242546243841419,54,859,41,954
200,RL,0.0527938681674295,0.1587997040152665,0.015896157736936,0.0739179503399457,410,257,289,956
201,GIB,0.0521210420293304,0.2098209562745994,0.0,0.057681613754068,420,154,382,956
202,BDC,0.0744018591959855,0.126709881163331,0.0026045048770487,0.0621878407963446,261,344,358,963
203,STM,0.0929721070325961,0.2198523379819524,0.0049234813270645,0.0321461381713274,178,134,652,964
204,DB,0.1885931070949141,0.005020788948369,0.024107668761085,0.2048756637007617,33,885,50,968
205,AM,0.0618961821293585,0.1074501649405167,0.072486188598802,0.0990682535722825,341,421,206,968
206,CVS,0.082236388221983,0.0825207137370337,0.0308682128369188,0.1024505339846014,229,543,199,971
207,HD,0.0426150074730339,0.3978538017059524,0.0235912043615164,0.0505031317513746,503,26,443,972
208,PYPL,0.0626852525635478,0.1491988130563798,0.0,0.0623014050443174,334,282,357,973
209,OKE,0.0781885290988065,0.0938567330024136,0.0540762335512241,0.0845694658473739,245,487,241,973
210,ABG,0.1281404240395263,0.1469994645578483,0.0,0.036304681134518,86,289,599,974
211,SLB,0.0566770500424774,0.1686823679185232,0.0177596181075286,0.0612888870909017,378,233,363,974
212,SIVB,0.1231651542960531,0.018441473093547,0.0120071292764692,0.1951342665850745,92,831,56,979
213,AOS,0.0450247167935914,0.3338622939257692,0.0148437576924614,0.0483493949470528,481,41,458,980
214,CTSH,0.0557381304130677,0.1943234323432343,0.0154944661684492,0.0527755675077636,385,180,415,980
215,KOF,0.0579236085926091,0.1654407055680591,0.0361281311783856,0.0604467960881205,371,242,368,981
216,TGT,0.0616290732546726,0.1611283701320315,0.0299507168475463,0.056818490687911,344,251,386,981
217,RHI,0.0443131325420359,0.2120711074868304,0.0221928879807431,0.0636984709185327,483,151,349,983
218,PAGP,0.0636604774535809,0.0585367921329264,0.0671971706454465,0.6954424885459368,326,648,10,984
219,ACI,0.1050534605388075,0.1091343675305806,0.0224535559947914,0.0509217468445053,133,414,438,985
220,ITUB,0.1001716470500418,0.0242858930913029,0.0313117717466797,0.3259867709301361,147,813,26,986
221,ULTA,0.0518168117579405,0.414448901161326,0.0,0.0417823704967869,427,22,537,986
222,IBP,0.0473341694488339,0.2270475258425592,0.0122559954543349,0.0541128420535295,464,124,400,988
223,TKR,0.0688875320826672,0.1295952982013253,0.0164309262008899,0.0624724789808304,298,336,355,989
224,EXPD,0.0396865483631862,0.3333808612267091,0.010649508196182,0.053444265038289,545,42,409,996
225,BWA,0.0748872497567662,0.1085532472393786,0.0155765479494073,0.0676980737801166,259,418,319,996
226,AXP,0.060815614812168,0.0894251543866215,0.0129271309249652,0.1234323130341065,350,513,133,996
227,MOS,0.0984088582671677,0.0698414852472193,0.0297025964174917,0.0848838705355396,159,602,240,1001
228,NVS,0.0707964743054875,0.1328121813608864,0.0345877724637247,0.0558028775586351,289,323,391,1003
229,MTB,0.1201941740784931,0.0178321540493131,0.0424472676059764,0.160010412700628,95,834,78,1007
230,KEYS,0.0486538488094306,0.2047030449201085,0.0,0.0557885191646451,454,161,392,1007
231,GPC,0.0677195384075561,0.1722703448112651,0.0270911279788755,0.0474740545921664,309,226,473,1008
232,JBL,0.0537526301332776,0.2284143260514192,0.002957051779948,0.0462614322907425,400,119,490,1009
233,FHN,0.1155111278552882,0.0226062313718464,0.047260405711138,0.1559464613520112,108,821,81,1010
234,PNC,0.0898303160407022,0.0407282286359834,0.0463484491870098,0.1628315391695124,194,742,75,1011
235,SUN,0.06171884844643,0.1108270951250684,0.0736260217801464,0.0781904382247377,343,405,265,1013
236,CNC,0.067014382538238,0.0611371935315597,0.0,0.1799120395752697,313,637,63,1013
237,VZ,0.0731568892133587,0.0699533990557498,0.0694467628359979,0.1178421804204851,267,600,147,1014
238,BNS,0.1102582450116722,0.0075642917700254,0.0806774904795259,0.4654653738805845,122,875,18,1015
239,BABA,0.0597871444485538,0.0922124405019794,0.0134102425261376,0.1118372081484379,360,494,167,1021
240,SEE,0.0647768611590658,0.1544205495818399,0.0223571192349352,0.0515787653257199,322,270,429,1021
241,UNM,0.1443615182940733,0.0225586558061614,0.0311595082717617,0.1200951094703772,60,822,141,1023
242,ADM,0.0891453563280405,0.080152353415441,0.02500574594674,0.0759130424544841,198,553,275,1026
243,CM,0.1114884216854753,0.0078275630578805,0.0504655298159879,0.2486448483636026,119,874,36,1029
244,WMB,0.0749491634371003,0.0887236361305211,0.0513728301759804,0.0794758194232354,258,516,258,1032
245,CE,0.1158949770238021,0.053762486126526,0.0180346775470712,0.0787021502136125,106,667,260,1033
246,EXP,0.0508513113359594,0.2280341683423717,0.0037579627868258,0.047230899909567,435,121,478,1034
247,MFC,0.1018070498119174,0.0063041440947221,0.0553854204724544,0.636913699692825,142,880,13,1035
248,WFC,0.1054434152305835,0.0116243959730461,0.0326653146127552,0.222311427848495,131,862,42,1035
249,OXY,0.0706292740598904,0.0724020968239284,0.0257090557578001,0.1141934103000308,290,590,156,1036
250,MCK,0.0420092410049362,0.2603075699323876,0.0043940378666055,0.0507553354846448,513,84,440,1037
251,CAH,0.0355723304051571,0.1311043138909397,0.0208340291926918,0.1357343264638097,605,328,110,1043
252,LEA,0.0689142007937427,0.0972829879379285,0.0218960578591821,0.0749690205316034,297,467,281,1045
253,HPE,0.1013583520783717,0.0592271271015848,0.0309831209563022,0.0800856115187135,145,646,254,1045
254,BKNG,0.033456443581077,0.5303305484925536,0.0,0.054595861185348,636,12,399,1047
255,SNV,0.0988333563054697,0.0232779401835527,0.0458099391322458,0.1645346660898865,157,818,74,1049
256,AIT,0.0524322079096978,0.2083894712360403,0.0075949921085695,0.0470997158215161,414,157,480,1051
257,GL,0.0838637241636061,0.0488585725974277,0.0072667985452002,0.1237861068650222,220,702,131,1053
258,HSY,0.0487744569509194,0.2938091911835386,0.023291576971915,0.0406608854390109,452,60,550,1062
259,DCI,0.045843246658592,0.2552303217937893,0.0135979485257852,0.0450570460516451,473,88,504,1065
260,NFG,0.1001254569691397,0.1010372295873613,0.0369741027257922,0.0477056546316729,149,452,469,1070
261,AVGO,0.0403334483780838,0.2476014421901735,0.0218966917235087,0.050504168104726,535,95,442,1072
262,WCC,0.0861538447686665,0.1204883272649389,0.0150811433037247,0.0451196294810691,207,364,503,1074
263,ASGN,0.047211944169777,0.1155689573083637,0.0,0.0897737378878112,467,382,226,1075
264,CRH,0.0634775756375861,0.1117577958137548,0.0187756202326403,0.0639170050472862,329,402,348,1079
265,GWW,0.0442304198351934,0.4061114629512349,0.0094796744534695,0.038353988987762,484,23,572,1079
266,ALLE,0.0485270766091139,0.2191967324710687,0.014251012320256,0.0463719140654079,455,138,487,1080
267,F,0.0891955411668098,0.0317733832424219,0.1024917709059616,0.1371071097484755,197,778,105,1080
268,INFY,0.0435290398663315,0.3283995926357424,0.0243907346519528,0.041133217579486,494,44,543,1081
269,PKG,0.0527168574965927,0.1466050395892695,0.0309260289208317,0.0580629475929539,411,291,379,1081
270,TAP,0.0717702263609795,0.0645439246045102,0.0268277998632515,0.1064565218706698,278,620,185,1083
271,WHR,0.0718194509768789,0.1097066769587032,0.0573361105511881,0.0546484803691012,276,413,398,1087
272,COF,0.0974665323023274,-8.903668979394685e-06,0.0231151444523015,0.3911824359684571,165,902,21,1088
273,BAC,0.0980863771387648,0.0127575295171476,0.0336153463722404,0.1664009585689579,161,855,73,1089
274,SQM,0.1170079803379941,0.309165907044967,0.0855197776664004,-0.0752214880571243,102,52,936,1090
275,CSCO,0.0533116119509756,0.1547197270634267,0.0329788111138593,0.0527433680251415,406,268,417,1091
276,HBAN,0.106039344038161,0.0125246360226333,0.0561992218018752,0.1368021675776788,129,857,108,1094
277,ALV,0.0521025181104295,0.208517570397952,0.0240226774074726,0.043667889154028,421,156,518,1095
278,WIT,0.0441378096130443,0.151220943087841,0.0020851690377799,0.0662179035213407,486,277,332,1095
279,CMA,0.1195886476302172,-7.350238882763689e-05,0.0534823236847963,0.1490446482383411,97,908,91,1096
280,VIV,0.0571190141761489,0.0786639482528806,0.0435271598915252,0.1132817875931115,376,561,161,1098
281,RPM,0.0410814855350367,0.1724951903913676,0.0161899161795878,0.063419343000504,525,223,351,1099
282,CHTR,0.0785767710195841,0.0937385709700774,0.0,0.0601783916739847,243,488,369,1100
283,UNH,0.0458097458479148,0.1804071119139612,0.0138385099717506,0.0525662791147021,474,206,421,1101
284,POOL,0.0339061772065261,0.2811562253744588,0.0108517730117827,0.0536645030160257,629,67,407,1103
285,BKH,0.0725381433887098,0.0568918710656408,0.0465051941405115,0.1075622812720457,270,655,181,1106
286,AN,0.152447854801443,0.2228636390480127,0.0,-0.0746040476390961,50,127,932,1109
287,CFG,0.1021311481477181,3.702716981472869e-05,0.0589413591300263,0.1771416493681503,141,901,67,1109
288,WTM,0.1338727584172928,-0.0109022899370495,0.0006835608245973,0.1369750731918349,71,932,106,1109
289,BBDO,0.0829187232753676,0.0075354224670446,0.0519454346432147,1.0154722518408323,227,876,7,1110
290,TGS,0.0349484365829303,0.2097002892120087,0.0,0.0647888522685565,614,155,341,1110
291,DRI,0.0580655514645221,0.1239476102514596,0.0355083617558444,0.0561330467349711,370,352,388,1110
292,YUM,0.0434966632584747,0.4648768671780379,0.0184663354347187,0.0358976845176391,495,15,603,1113
293,PBH,0.0586945748301028,0.1056926930371884,0.0,0.0671163641009592,364,427,323,1114
294,ZION,0.1049106716795289,0.0156939676311917,0.0435070726670987,0.121881515627688,135,845,137,1117
295,CNA,0.1049770170027049,-0.0022869826962853,0.0685617530133848,0.1912236948721471,134,924,59,1117
296,ALLY,0.0961630480002605,0.0057013865814359,0.0450646440628672,0.179504356267153,172,882,65,1119
297,IBM,0.0503393822935649,0.1038666930379746,0.0405291747604815,0.0813334647800987,438,435,246,1119
298,IPG,0.087612498787591,0.1659169240410008,0.0382148107876319,0.0299433103103256,203,241,677,1121
299,EXPE,0.036219796747198,0.1479866112181762,0.0,0.0838008848203678,596,284,243,1123
300,HII,0.0657359003733335,0.0954417695221801,0.0193056976133138,0.0654463149091338,317,475,334,1126
301,BBD,0.078846531808997,0.0075354224670446,0.0493943611664979,0.9656017608957462,242,876,8,1126
302,RY,0.0963914191912877,0.0098587652696299,0.0359967686312979,0.1514666698093665,171,866,89,1126
303,TEL,0.0490851782036109,0.1335729607513479,0.0186318084804282,0.0616777108317624,449,320,362,1131
304,DOV,0.0491318909403122,0.1544121228518116,0.0132169560218483,0.0531730306716466,448,271,412,1131
305,OTIS,0.0381982613651102,0.6008796041781198,0.0146435724578907,0.0404532085153976,573,5,553,1131
306,PBA,0.0708610630042341,0.0716739803381297,0.0630009113083815,0.0803570838347564,286,593,253,1132
307,MFG,0.4576531041418059,-2.031749487722866e-05,0.1582498519263645,0.0892715840726925,3,904,230,1137
308,PAYX,0.039044988770639,0.4284785179345683,0.0303809002188958,0.0394099383817228,558,20,560,1138
309,ENB,0.0631440221663168,0.0703937294368422,0.0778004524446236,0.0951087072687618,331,597,212,1140
310,RZA,0.0840946133391211,-7.252382925818484e-05,0.0204176500235781,0.3842060993021265,217,906,22,1145
311,RGA,0.0840946133391211,-7.252382925818484e-05,0.0204176500235781,0.3842060993021265,217,906,22,1145
312,GPI,0.1442911087871243,0.1867549920279401,0.0060441089452053,-0.0292371777944655,61,191,894,1146
313,CL,0.0348738190928822,0.3545314109165808,0.0239416349337656,0.046094091322766,616,37,493,1146
314,NKE,0.0392425039465311,0.2431224334048043,0.0149328054491273,0.045555727827052,551,100,497,1148
315,ORI,0.072013448561228,0.0517117755297735,0.0331435099876684,0.1059148682146762,275,685,189,1149
316,VRSN,0.0383917103957764,1.7851917930419268,0.0,0.0379409271034581,568,2,581,1151
317,WYNN,0.0712052378480647,0.0800396311592741,0.0082650452176046,0.0682271762246277,283,554,315,1152
318,VOYA,0.0834112728266625,0.0046815998355981,0.0217536599531936,0.2186042638241172,222,887,43,1152
319,GOOG,0.0418271495524503,0.2629406883816107,0.0,0.0393899011877164,516,79,561,1156
320,GOOGL,0.0418271495524503,0.2629406883816107,0.0,0.0393899011877164,516,79,561,1156
321,KMI,0.0606733293138204,0.0668192291415226,0.064175177680741,0.1052077052844414,351,614,191,1156
322,GRMN,0.0524196028269275,0.1497569822191007,0.0227121831679632,0.0480135281462919,415,279,463,1157
323,ATHM,0.0833574144675622,0.0441540458642302,0.0201278840165362,0.097260777305861,223,726,210,1159
324,ADP,0.0387739086565665,0.5324959332952697,0.0225605863507863,0.0371431723063516,562,10,588,1160
325,ARMK,0.1032667891004436,0.0728744221272136,0.0175577500429578,0.0512058404960059,137,589,434,1160
326,EMN,0.0839227640215788,0.0909015509662436,0.0352963750247356,0.0507854757669733,219,503,439,1161
327,CNHI,0.1461436806264392,0.1727483799424749,0.0331612400577917,-0.0177517418896729,58,220,883,1161
328,MCHP,0.0392051000964656,0.1916083811349578,0.0187400748533894,0.0512797528242721,553,181,433,1167
329,TJX,0.0400370624715986,0.3004767827529022,0.0132800627420322,0.0387931751932007,542,59,567,1168
330,AXS,0.0798190609568707,0.000412924138704,0.0390353839374425,0.2597229160372977,239,896,34,1169
331,ENLC,0.0367278250857813,0.0944512610770279,0.0420713495890473,0.1383972846345884,589,484,103,1176
332,V,0.0366873609597598,0.3115680776249611,0.0079670173658345,0.0418337440782394,590,51,536,1177
333,ITW,0.0373061625036757,0.3725906114543945,0.020375195280161,0.0389084224421156,583,30,566,1179
334,MAR,0.0453440600053551,0.21572130415364,0.0086334619601503,0.03997572335211,479,144,556,1179
335,RMD,0.0371469608528729,0.232167325674606,0.0102721188264501,0.0468053795226011,584,113,483,1180
336,DGX,0.0553017116333043,0.1106742033259605,0.0203334162211446,0.0559492726594554,389,406,389,1184
337,PH,0.0441761692800107,0.1774556684920257,0.0121467205654614,0.0463506715773195,485,212,488,1185
338,K,0.0497353202358426,0.1425054445601742,0.0418383345832535,0.0506243848457368,445,301,441,1187
339,L,0.0905855854000596,-0.0277387951197926,0.0036006822648559,0.2034701328965078,190,944,54,1188
340,MGM,0.0720250506175594,0.0403411812912945,0.0,0.1109190067541586,274,745,171,1190
341,AMCR,0.0528434097753069,0.1098426159993476,0.0522643039147556,0.0600098447996293,409,411,371,1191
342,GFI,0.0535061647738374,0.2115616397904265,0.0280426167149672,0.033292048492864,403,152,639,1194
343,PGR,0.0418879314927088,0.0896165296324656,0.0029797278040118,0.1115390689114865,515,512,168,1195
344,CSX,0.0533631266684056,0.1391083379459568,0.0126692537608435,0.0469423143882502,405,311,482,1198
345,CI,0.0586778444915174,0.0520512045156738,0.0164761569544346,0.1163557566989037,365,682,152,1199
346,EPR,0.0474573593791265,0.0683914079339505,0.0746623949942229,0.1239467883884885,463,607,130,1200
347,NXPI,0.0471312234877112,0.1816026084379013,0.0169517378722336,0.0422445396080414,469,203,530,1202
348,SLF,0.0830891861631323,0.011582799968333,0.0467765026500194,0.1352094444293868,226,863,113,1202
349,PSA,0.0401414190410277,0.1674934226427251,0.0430748654308678,0.0520471810364028,539,238,426,1203
350,PG,0.0387438168732496,0.2276010502236796,0.0242477601131595,0.04302467142931,563,122,524,1209
351,APTV,0.1182519207364056,0.0794637851062745,0.0012879719072719,0.0398466308812258,99,555,557,1211
352,DEO,0.0550510434839941,0.1685390102791664,0.0318926200235439,0.0369140717935309,391,234,591,1216
353,CDW,0.0360914528589346,0.2143294315660622,0.0105074726923367,0.0474061870613824,597,146,475,1218
354,WMS,0.0382413091063205,0.2523172492825511,0.0032994251868106,0.0400562741920349,571,92,555,1218
355,EVR,0.0392008744339505,0.1305565905618228,0.019619540583072,0.0654234282960639,554,330,335,1219
356,KEY,0.0724240148506528,4.265544354552047e-05,0.0682298630082158,0.2067866649458661,271,900,48,1219
357,ACN,0.0336557245033651,0.2650685469580564,0.0138336051403869,0.0440613573578484,632,77,511,1220
358,TXT,0.05734244128544,0.1033819522359352,0.000996177047304,0.0537935605544192,374,442,404,1220
359,SBUX,0.0394659220159887,0.2920766957542711,0.0232690578636153,0.0351657679721082,547,61,612,1220
360,BOH,0.0601592135920154,0.1081085005208789,0.0420519235113121,0.0503072032680744,358,419,444,1221
361,SCCO,0.0370320031359015,0.2733490689061603,0.0472199268091134,0.0391590681354195,588,73,564,1225
362,NSP,0.0386715226532847,0.304964717144105,0.019003611618122,0.0357356531848348,566,56,605,1227
363,HUM,0.0438922160903148,0.1352463377434115,0.0076004600783148,0.0524978414226063,488,318,422,1228
364,CHRW,0.0317458538538034,0.1741563243412902,0.0284690287925703,0.0632551240626912,658,219,352,1229
365,CHH,0.0453231993988114,0.2582643589427515,0.009898423905189,0.0312542774254868,480,86,664,1230
366,AMP,0.0636643924081856,0.0408423338476484,0.0136993019657676,0.1121101057234911,325,741,165,1231
367,CZR,0.0779823795539328,0.0805841700352066,0.0,0.0510953250257957,246,552,435,1233
368,TDC,0.0142781541018142,0.2132269099201824,0.0,0.0817539468732915,839,149,245,1233
369,UHS,0.0679260983581827,0.0952226600864697,0.005250161866427,0.0496571816530758,306,477,450,1233
370,EA,0.0353593431439539,0.1603097773475314,0.0056941597364576,0.0587748390358259,607,253,373,1233
371,ITT,0.0418022907451663,0.1824651098521486,0.0097555650508816,0.0437982101083947,518,200,516,1234
372,FFIV,0.0409114139192362,0.1251652738460495,0.0,0.0620718221278607,528,348,359,1235
373,WEX,0.0320173321131679,0.1206623282179417,0.0,0.0917405851509714,655,362,219,1236
374,PHM,0.114621413720809,-9.034012183065883e-05,0.0062746033146885,0.0926953398982464,111,909,217,1237
375,HE,0.1291603285933596,0.0202907085779177,0.0737524176542379,0.0662568956217925,83,826,329,1238
376,IGT,0.0284567676030645,0.1141130870953032,0.0291864283108354,0.1169281284202845,696,393,150,1239
377,TKC,0.0412185304229269,0.1264287138666885,0.0081589306314765,0.0592409659383347,523,346,372,1241
378,OGS,0.0652675599633287,0.0580487240933797,0.0406719821882606,0.0770282079421208,320,650,271,1241
379,BSAC,0.0715607354885383,0.0095920815958378,0.0599223453729622,0.1474948212082267,280,867,94,1241
380,DPZ,0.035895903190538,0.726814533115634,0.0117393719278931,0.0335690774161253,602,3,637,1242
381,BAP,0.1097820256192124,0.0299128410805807,0.0449918037914923,0.0660772703989724,123,787,333,1243
382,BK,0.0805179189927227,0.0130353696071782,0.036436441126652,0.1149695909658718,238,854,155,1247
383,FNB,0.0976358540513472,0.0358305139358788,0.0366386091491653,0.067439198159178,164,764,321,1249
384,CCK,0.0409222347588751,0.1236961137265762,0.0104579044383792,0.0600192776463502,527,353,370,1250
385,WBS,0.0995309370627157,-0.0009756455258808,0.033810630877551,0.1076511999416466,154,918,180,1252
386,MGA,0.0717382345746827,0.11715074780292,0.0314378389084527,0.0361956728064659,279,372,601,1252
387,PNR,0.0518725559525111,0.1316778595222402,0.0120955438000716,0.0452499958140421,425,327,502,1254
388,UPS,0.0496666051387166,0.1718846956619845,0.0397747469894433,0.03761275404065,446,227,583,1256
389,BKR,0.0563949492416432,0.0967270601987142,0.0228133968625484,0.053347358057715,380,469,410,1259
390,BXMT,0.0671311843803586,0.0223821513544374,0.1162422792235135,0.1249317181653916,312,823,127,1262
391,POST,0.0585685405489464,0.0552419429225007,0.0,0.0869489153254023,367,663,233,1263
392,BEN,0.0732966905232394,0.038370231133389,0.0504226100529715,0.0821889374138589,264,756,244,1264
393,SJM,0.0622287685102357,0.0865510588123198,0.0365928578269195,0.0537726818215464,337,523,405,1265
394,PSO,0.0549764555944182,0.089798985534473,0.0223978152421704,0.0609395103017493,392,510,366,1268
395,ABBV,0.0177490198803621,0.1798802518839682,0.0384653342626233,0.0805220803209028,812,207,251,1270
396,A,0.0408018484553538,0.1473799126637554,0.008719749871507,0.0485015521154771,529,287,456,1272
397,FDX,0.0687655917365701,0.0862841470700048,0.0199898129753733,0.0497919408187217,299,526,448,1273
398,MMC,0.0401289854140326,0.1870727820081459,0.0138677910190134,0.0410478066988054,540,189,545,1274
399,LII,0.0371436700287531,0.4514659377177467,0.009655717645163,0.0303959977239194,585,17,673,1275
400,ROST,0.0389230256689542,0.228158155675032,0.009443877364125,0.0363723021134703,560,120,598,1278
401,BCE,0.047583570990338,0.0919058044891615,0.0771261769299867,0.0669071687544214,460,497,326,1283
402,TRV,0.0683570380198371,-0.0003676470588235,0.0207516517960588,0.1762290605720375,305,913,68,1286
403,GD,0.0467381673994255,0.1106102454531241,0.020133364418214,0.0536607737925229,472,407,408,1287
404,KHC,0.0629208590030603,0.0653204053364438,0.0433063005047332,0.0653010526185876,332,619,337,1288
405,TPX,0.0419389967043536,0.1602435746221576,0.0088526488560942,0.0432492343085374,514,254,522,1290
406,MCD,0.0392383568430264,0.2383064368870187,0.0210017504130538,0.033612159894877,552,105,636,1293
407,RDY,0.0543071085633931,0.2323632234226136,0.0064836157195861,0.0175529656620205,396,112,786,1294
408,ETSY,0.0309770536219063,0.1417189847763036,0.0,0.0670371487801363,664,305,325,1294
409,PRU,0.0659971720423989,-0.0001608881023248,0.0489673551407831,0.1726855265257303,316,911,70,1297
410,MT,0.0386764327114241,0.0676803237788989,0.0155294925685696,0.1276027682056997,565,610,122,1297
411,AIZ,0.0713361289248512,0.0205824595798935,0.0169097158525367,0.1038787271939157,282,825,194,1301
412,VSH,0.0968782887650273,0.1370173120544028,0.01664181239838,0.010857895541193,167,315,819,1301
413,HI,0.1929069042183528,0.0268048018418023,0.0207568777050816,0.046626787275526,28,798,485,1311
414,FAST,0.0312151384794597,0.4021201599326599,0.0274801322994932,0.0340501757318367,661,24,627,1312
415,TPL,0.0335835762376261,0.444559993048791,0.0082767377476068,0.0313189232913208,634,18,660,1312
416,BAX,0.1357737159262159,0.0179120929591696,0.0299560984686606,0.0528576891068175,69,832,414,1315
417,IBN,0.0572773900738586,0.0388069218041967,0.0072458041603705,0.1063097573894583,375,754,188,1317
418,AWI,0.0509226140093162,0.1586710873536775,0.0106714503889049,0.0340621774673576,433,259,626,1318
419,MSI,0.0326855949858882,0.3134210526315789,0.0112649593017484,0.0342538915270484,647,49,624,1320
420,WTS,0.0376658605607255,0.1872242067661273,0.0066824208930703,0.0403963121084316,579,188,554,1321
421,TT,0.0362995318492117,0.2169675523301145,0.012262458582591,0.037465335283274,594,142,585,1321
422,ALE,0.0705099889626613,0.0258894581675587,0.0443719274937023,0.0896284400371183,292,802,228,1322
423,NNN,0.0502373853852311,0.0653402222375504,0.0517890411840236,0.0784163663755146,440,618,264,1322
424,CAG,0.0239580325928608,0.110218211742005,0.0454940405773996,0.1123032777790351,751,408,164,1323
425,BRO,0.0437825376429232,0.1219612607818132,0.0067899397837962,0.0473082767454722,490,359,476,1325
426,SNY,0.0476857829050512,0.0897917277794074,0.0393319401961293,0.061859057268497,459,511,361,1331
427,CBOE,0.0403035246051588,0.1681663193786702,0.0118306248348476,0.0395942164495125,537,236,558,1331
428,RHP,0.0489645553428944,0.0942103937435613,0.0276906811160854,0.0551104356301521,450,486,396,1332
429,QSR,0.0488173885076483,0.1038172781918564,0.0413575757202821,0.0502557208646338,451,436,446,1333
430,CNS,0.0345596471245491,0.2340443825631609,0.0301133219208754,0.03594847098206,621,110,602,1333
431,PB,0.0666400470524032,0.0243029534430793,0.0326933798838707,0.0982756181400897,314,812,208,1334
432,BCO,0.0215834951480204,0.1060609313609721,0.0097457971249898,0.1229791622059956,776,424,135,1335
433,CW,0.0415647916915748,0.1270445742149865,0.0035465767692172,0.0472997666027948,522,341,477,1340
434,MTD,0.0297641988652917,0.5297357106756442,0.0,0.0324725221769948,680,13,649,1342
435,GGG,0.0346592330856857,0.2776521645327696,0.010833631964212,0.0319037299334788,620,70,654,1344
436,GSK,0.0417356874917799,0.1843319187073305,0.0190300506887235,0.0339102460870711,519,194,632,1345
437,NE,0.0723100936849227,0.1264627477286679,0.0148256834303345,0.0247218766370613,273,345,733,1351
438,WSO,0.0343829082747745,0.2514659972415879,0.0245302530306679,0.0336966437935221,625,93,635,1353
439,FTNT,0.0251868175909579,0.3493036526455549,0.0,0.0379930789135603,735,38,580,1353
440,TSCO,0.047198521332332,0.2109395871014819,0.0191662760461217,0.0247304725060217,468,153,732,1353
441,HST,0.053553882696299,0.0767019105917269,0.0395864511282102,0.0575342388426455,401,569,383,1353
442,PEP,0.038827583279475,0.2046101557053218,0.0285922318132524,0.0339067412284064,561,162,633,1356
443,URI,0.0617389801536533,0.1743349125364431,0.0103407697782109,0.0161479015748416,342,218,796,1356
444,KO,0.0420561938108308,0.1525791830788323,0.0312143786805793,0.0382603809104133,509,274,574,1357
445,FRO,0.1470596158879829,0.1292340554271032,0.1431421423980554,-0.1736812297425583,57,337,963,1357
446,CLF,0.0383130725355764,0.0482571815524984,0.0,0.1556528585969157,570,705,82,1357
447,NTRS,0.0633191729592322,0.0118013017847777,0.0379297457092556,0.1114961830000099,330,860,169,1359
448,CNI,0.0514208891708034,0.1385022359387793,0.0189320287062638,0.0345365545399636,429,314,622,1365
449,E,0.0469341381770112,0.0883723460192555,0.0299646583288987,0.0580798892888438,470,519,378,1367
450,SF,0.0708464969088684,0.0248530600911422,0.0271523372618432,0.0770150729875745,287,809,272,1368
451,AEL,0.0474726366486666,-1.700427331221906e-05,0.0098483228310953,0.8770982833241566,462,903,9,1374
452,PAG,0.0965450708604766,0.1171975352309324,0.0173344786362667,0.0053717633425977,170,371,840,1381
453,TSM,0.0514770192533033,0.1994629370617912,0.0176309336088634,0.0176568413434341,428,172,784,1384
454,CACI,0.0438622633763525,0.1136282033725666,0.0,0.045295461087812,489,395,501,1385
455,REGN,0.0421881392319144,0.136464487065361,0.0,0.0391362857767526,505,317,565,1387
456,LVS,0.0325190433488702,0.1332680341092417,0.0081231025564335,0.0524672525776202,651,322,423,1396
457,HON,0.0406939900414081,0.1831526543525799,0.0205339946214599,0.03093404934042,530,199,668,1397
458,CIB,0.0533722862657066,4.4055672288317495e-05,0.0287777356560028,0.1460704121892122,404,899,96,1399
459,ROK,0.038942191139975,0.1613850057211084,0.016527577835933,0.0369950815829763,559,250,590,1399
460,MKC,0.0391141064418489,0.098633672695987,0.0240512100292591,0.0559413329569434,556,458,390,1404
461,MA,0.0278049991078556,0.5555682859761687,0.0053598202835866,0.0288332500797763,704,8,693,1405
462,ASB,0.0570344519063864,0.0051160428499903,0.0439657452620592,0.1187496592696826,377,883,146,1406
463,OHI,0.0328445778599569,0.0903981174248315,0.0873215782185023,0.0786226067382258,643,508,262,1413
464,AMGN,0.0435912095927917,0.1002640867423376,0.0295670017723327,0.047757586927699,492,454,468,1414
465,PXD,0.0928320365353449,-0.0418264514402925,0.0626925053285779,0.073676521115155,181,948,291,1420
466,BCS,0.0546766378040017,-0.0007685110932905,0.0234863138998364,0.1352204508991913,394,916,112,1422
467,VAC,0.0819755461136652,0.0699809251311397,0.0342102672757815,0.0367921742399914,230,599,593,1422
468,DAR,0.0812962983100396,0.0552534958198627,0.0,0.0429570370238277,236,662,525,1423
469,TRGP,0.0428373693980452,0.1135004671441918,0.0219004641586321,0.0423453393116355,498,396,529,1423
470,KGC,0.0560804878261526,0.0793707820264975,0.0202069336322855,0.0466007833418993,382,556,486,1424
471,TXN,0.042060328078312,0.2525492627807634,0.0294422296548184,0.008715726970452,508,91,826,1425
472,APH,0.0326022570299039,0.1913905650642679,0.0084650881064159,0.0364560196736358,649,182,596,1427
473,CAJ,0.0835689112762145,0.0947405444835459,0.0408751558935468,0.0253747552752155,221,480,726,1427
474,BUD,0.0409982289624815,0.0753223867771112,0.0231281902010778,0.0662220036059404,526,575,330,1431
475,EMR,0.2383928265814909,0.0750914779657421,0.0216048571181349,0.0049413446163347,15,576,842,1433
476,BMO,0.0587084828304969,0.0050222399997253,0.0363548749348987,0.1064419090768735,363,884,186,1433
477,AXTA,0.0356183323853759,0.1005201382472709,0.0,0.0582627471404766,604,453,376,1433
478,FN,0.0333813146692178,0.1609349104251037,0.0,0.0411070714123767,637,252,544,1433
479,FMC,0.167596001183508,0.0980963753863444,0.0368419510736353,-0.0659857732998707,46,462,925,1433
480,HIW,0.0613777648451275,-0.0005550148857658,0.0881191797502167,0.1099450906422241,347,914,174,1435
481,LW,0.0561248885915159,0.195232373887757,0.0134606900274621,-0.0149769516627394,381,178,876,1435
482,LRCX,0.027463364371278,0.3032598955039777,0.0073104756261242,0.0305329225343218,708,57,672,1437
483,CHE,0.0309652164155678,0.2366406048854968,0.0026705338766744,0.0310715741599542,665,107,666,1438
484,VMW,0.0253389263633097,0.1072906717605858,0.0433885725399139,0.0742426685682971,733,422,284,1439
485,EC,0.2219303502617177,0.0961688975161493,0.0587036854892486,-0.0896174856691156,21,472,946,1439
486,AIG,0.0747334920969817,0.0074647263767781,0.0210476428469676,0.0725179507446693,260,878,302,1440
487,SRC,0.0531054153627323,0.0403042881490174,0.0667388854333165,0.0739853689317266,407,748,286,1441
488,LAD,0.1105221309302942,0.1185213907199172,0.0058309037900874,-0.1177555437759519,120,368,953,1441
489,WTW,0.0416567953881386,0.1111786148238153,0.0138987601674168,0.0435520808655137,521,403,519,1443
490,SHW,0.0299877252186374,0.2261644464859899,0.0078295982162023,0.033059558926357,678,125,643,1446
491,UNP,0.0426313396791899,0.1464224679972914,0.021205399091091,0.0318983201581397,502,292,655,1449
492,SWN,0.2159075375561065,-0.0949132722666147,0.0,0.0479794527902458,24,961,465,1450
493,MAA,0.0352838070147692,0.1545056578778168,0.0418323671170625,0.0381563296261369,609,269,576,1454
494,JBT,0.1830693815987933,0.0739892183288409,0.0040221216691804,0.0060017596782302,34,582,838,1454
495,PPG,0.035983657186248,0.1029952389561863,0.0169434858247057,0.05275714148094,600,445,416,1461
496,AME,0.0345482346408868,0.1406362429330135,0.0060596505120369,0.0420688058052664,623,307,533,1463
497,VRTX,0.0345198694436335,0.19549805033676,0.0,0.0312706376266023,624,177,663,1464
498,MDLZ,0.0502319187124178,0.1050441024857764,0.0218796016170241,0.0364862615854263,441,430,595,1466
499,DOC,0.0420304513861074,0.0251940429825587,0.0902420817693326,0.115737745421533,510,805,153,1468
500,PEAK,0.0420304513861074,0.0251940429825587,0.0902420817693326,0.115737745421533,510,805,153,1468
501,ANET,0.0286499688498925,0.2808501717015876,0.0,0.0274456610712334,693,68,707,1468
502,WWE,0.0323791270797903,0.3069006608168129,0.0059096873044402,0.0208080586601719,652,55,762,1469
503,CFR,0.0858476009278334,0.0344402043613374,0.0343115908687354,0.0459714561211061,208,769,494,1471
504,MAN,0.0224378070985338,0.1150229500062027,0.0364614365351174,0.0682230621239203,769,388,316,1473
505,NVO,0.0267251285917478,0.7082323535707135,0.0101451568415813,0.0223591374946577,718,4,753,1475
506,CUBE,0.0393129001233719,0.084986869355643,0.0423238867599509,0.0554751796312898,550,532,394,1476
507,WMT,0.0348654915193607,0.1688418841884188,0.013801438845263,0.0339866051042959,617,232,629,1478
508,CHT,0.0399333300028161,0.1025557491545403,0.0394120011251783,0.046342135677159,543,447,489,1479
509,IEX,0.0363176299337692,0.1385673544707263,0.0116184734580939,0.0381880396619468,593,313,575,1481
510,SBS,0.069752360617948,0.1153813553703676,0.0163055175681854,0.0141696511959582,294,384,804,1482
511,KLAC,0.0246515895999972,0.3548515556598512,0.0068998577339521,0.0270552100916201,742,36,709,1487
512,BR,0.0301749133524834,0.1563205583086531,0.0159152028310906,0.0407691996477043,675,264,549,1488
513,MSCI,0.0255539772538606,0.3460489543871154,0.0098112515942229,0.025478022277381,731,39,722,1492
514,CME,0.0426688215492832,0.0943262060861639,0.0427918207559066,0.0446685505859987,501,485,507,1493
515,IT,0.0247609011818518,0.2786617219456902,0.0,0.029535014919252,741,69,683,1493
516,SJR,0.0453917929017782,0.091719298245614,0.0351726981647286,0.0436688059984384,477,499,517,1493
517,PHI,0.0949675974470686,0.0985694423586519,0.0832420573098826,-0.0058806117303963,174,459,861,1494
518,FNF,0.0375306706157352,0.0002033166020712,0.0362965866689896,0.4913831903247819,581,898,16,1495
519,JKHY,0.032050295655239,0.2151803404590825,0.0130845850772406,0.0281723556037987,654,145,697,1496
520,J,0.0385246248587138,0.0960500593681853,0.0074309149847943,0.0484483277851733,567,473,457,1497
521,FUL,0.0346865267798054,0.0881066219704254,0.0103875742178354,0.0620599810874576,619,520,360,1499
522,FSS,0.0337904707437639,0.1578577946234295,0.0051093596169096,0.0352288198796166,630,261,611,1502
523,PAYC,0.0285675699934134,0.2714072317210457,0.0054352385490843,0.0241597270957947,694,75,737,1506
524,SCI,0.0521354468657465,0.0605047320633334,0.0162992586701122,0.0492180694499707,419,638,452,1509
525,AEM,0.0724193813672848,0.062763326378393,0.0242610930611789,0.0355756452637153,272,632,609,1513
526,CMI,0.0216513537589946,0.0921892995497853,0.0271304718531075,0.0810968393177036,773,495,247,1515
527,FDS,0.0280877225531587,0.1810386134813953,0.008315273272039,0.0350839006279602,699,204,614,1517
528,FCN,0.0406887863207572,0.1551763607795623,0.0,0.0259003725389561,531,267,719,1517
529,NNI,0.02772945497585,0.0612340037250909,0.0119419152394029,0.108712356980879,706,636,176,1518
530,KWR,0.0295259344997143,0.0946362574524832,0.0082883583470745,0.0629077232901814,684,481,354,1519
531,NYT,0.0287975419660259,0.1454934675393098,0.0086080222005879,0.0418788508388011,691,294,534,1519
532,VLY,0.0904442951104377,-0.0009009697538898,0.0434973938557671,0.0529394973408106,191,917,413,1521
533,GS,0.0647750289312236,0.0239238287036933,0.0318626815632803,0.0562560021107714,323,814,387,1524
534,WAT,0.0330204364785969,0.2198456508448445,0.0,0.0227345134963215,641,135,749,1525
535,AVY,0.0308318242289346,0.1749088071747289,0.0157346506552038,0.033154937823918,669,216,642,1527
536,STZ,0.0379186197510722,0.138980044345898,0.0143517387942868,0.0331661703032853,575,312,640,1527
537,SID,-0.0125825025577768,0.0963902683305935,0.157411612413592,0.1140584722487289,901,470,157,1528
538,ODFL,0.0277791434665226,0.3302658052412216,0.0039240133944196,0.018194267475045,705,43,780,1528
539,DXC,0.0220998554038032,0.0491716788013084,0.0,0.1835987987392882,771,696,62,1529
540,CPB,0.0404826502927316,0.085770649283815,0.0317720976724261,0.0476938454947879,532,528,470,1530
541,ORCL,0.0325497429232685,0.1468583229768258,0.0136549079178439,0.0367168066012259,650,290,594,1534
542,NU,0.0261061903604897,0.0356446947367265,0.0,0.2155340076945022,724,766,46,1536
543,TREX,0.0228263914787572,0.3187699949680773,0.0,0.0248243564595426,762,47,730,1539
544,COST,0.0260465458770796,0.2291378385247522,0.00517867592057,0.0279217978291325,725,117,701,1543
545,HLT,0.023916534856725,0.1905128863772583,0.0033118426883107,0.0356127894141769,753,184,607,1544
546,GHC,0.0635339123863114,0.0295821569838861,0.0095795428378351,0.0515072579528712,327,788,431,1546
547,MSFT,0.02596848037097,0.2828625118577739,0.0064146295061766,0.0218243545152732,726,65,756,1547
548,CHD,0.0326283941993658,0.1479460488023281,0.0115080294522644,0.0348522722679722,648,285,616,1549
549,RYN,0.0350757389405011,0.1053510041704171,0.0343675241219864,0.0438717144212662,612,428,514,1554
550,ATI,0.0705271526962643,0.1163672654690618,0.0027469192870989,-0.0197091458849346,291,378,885,1554
551,TM,0.0996573950770512,0.0878446403460054,0.0177389946789239,-0.0169696170727032,152,521,881,1554
552,INCY,0.0425591748642995,0.111973196807927,0.0,0.031976479333542,504,400,653,1557
553,FICO,0.0197858719780524,0.5323233904138231,0.0,0.0214126565799533,789,11,759,1559
554,MNST,0.0270946512024461,0.2291370399865897,0.0,0.0245233149990409,711,118,734,1563
555,PEG,0.0841633090005155,0.0806628141143507,0.0373365908441616,0.015794986979808,216,551,798,1565
556,EDU,0.0234233347655838,0.0773425460921184,0.0,0.08493800792413,759,568,239,1566
557,NOV,0.124591595525242,0.0712270007901569,0.0099121208927433,-0.0175657838605577,90,594,882,1566
558,MMS,0.0354432764526054,0.0903504768781742,0.0149125430055763,0.0489932231645751,606,509,454,1569
559,FISV,0.0377561765191335,0.0846035787784715,0.0,0.0481182041035893,578,535,461,1574
560,NYCB,0.3251798135750931,0.0234830805134189,0.0710902793788851,0.0226009558718999,7,817,750,1574
561,CTAS,0.0228042365997222,0.2703113468976433,0.0077036371074184,0.0242366912298836,763,76,736,1575
562,ADBE,0.0193927240628657,0.3089000371609067,0.0,0.0248018221157726,794,53,731,1578
563,SAP,0.0376132438738723,0.1182110347056394,0.0146740053881616,0.0339860993269864,580,369,630,1579
564,CLH,0.0400443826512786,0.1145745484097152,0.0,0.0328110735359073,541,391,647,1579
565,CX,0.0161917686893034,0.0926583388121849,0.1812787718888636,0.0779340075375263,824,492,267,1583
566,FLO,0.0259070963079343,0.1186891687661071,0.0409789152602046,0.0462394311858288,727,367,491,1585
567,MKTX,0.0234694749626844,0.2224295138627157,0.0099731285402648,0.0279818386071539,758,128,700,1586
568,MET,0.0314927937482852,0.0023906005601833,0.0352048720988436,0.2504854590207405,659,892,35,1586
569,M,0.020554598298549,0.1037481720926652,0.0354322123051179,0.0610765206585458,782,439,365,1586
570,LEG,-0.0383518677331551,0.0950799252646875,0.0671157685330214,0.1074861556205531,927,478,182,1587
571,TTC,0.039065388137203,0.1597729717698557,0.0168134018097334,0.0186381120836579,557,255,776,1588
572,IPGP,0.0427653230153401,0.0932216388081176,0.0,0.0362443722773172,500,490,600,1590
573,NVDA,0.0192948022097994,0.5984354865056174,0.0002560970051367,0.0175189801919015,797,6,787,1590
574,ATO,0.0576257827908673,0.0504218503772565,0.0279941655643156,0.0425280777538548,373,690,528,1591
575,ROL,0.0203288240536429,0.2889015148325392,0.0123549775746393,0.0231771972333485,785,63,744,1592
576,TRI,0.0397930144353789,0.1283196037900114,0.0134123606235006,0.0270201928764136,544,338,710,1592
577,PFG,0.0328292508625185,0.0026915763369815,0.0329504114481792,0.1944047936184824,644,891,58,1593
578,FLS,0.0345523303588882,0.0908828348105237,0.0194194150935623,0.0478131514703704,622,504,467,1593
579,JHX,0.0290218796075504,0.1864929888940193,0.0,0.0264450643464331,689,192,716,1597
580,CR,0.0382023659491071,0.1520492901151888,0.0085541053883698,0.02252730371911,572,276,751,1599
581,ADT,-0.0268570355463741,0.0748165236870823,0.0206830264114401,0.1368560193698658,916,578,107,1601
582,VRSK,0.0175429549640027,0.3148246028875845,0.0056192277619071,0.0237189659645134,814,48,741,1603
583,NFLX,0.0251543674850299,0.1744110813239094,0.0,0.0322139714487413,736,217,651,1604
584,WAL,0.1013886625749099,0.0834141394152278,0.0240699828787334,-0.0621609062215221,144,539,922,1605
585,ZTS,0.0257521524665274,0.2475598935226264,0.0076025979124731,0.0178089757458366,728,96,782,1606
586,TRQ,0.2057608973002174,0.0635853712443756,0.0,-0.1271275602617258,26,626,955,1607
587,HWM,0.0343088713323143,0.1391716797778806,0.0032739184408613,0.0305864709132528,627,310,671,1608
588,RLI,0.0501851848825301,0.0040127857961579,0.0230805621128202,0.0755129603980106,443,889,277,1609
589,ABB,0.0427878376738353,0.147530836907025,0.0293550498465342,0.0090762079914196,499,286,825,1610
590,TMUS,0.0437712560495216,0.0763892607387258,0.0039313608595638,0.0407766853278458,491,571,548,1610
591,IDXX,0.0183283297564104,0.4752809115318201,0.0,0.0167631681902257,807,14,793,1614
592,ATR,0.0350722747234812,0.1262330183176117,0.0127823016874398,0.0316633897186164,613,347,656,1616
593,RCL,0.051192418333462,0.1122425184609405,0.0,0.017496524828172,431,399,788,1618
594,WAB,0.0359193502608229,0.0886686311277792,0.0054209571559278,0.0447339147420065,601,517,506,1624
595,WLK,0.0267780692078709,0.0675253494107974,0.0123548085489341,0.0727871526276575,717,611,297,1625
596,VTRS,0.0042079353968833,0.0514456964876804,0.0442794810684832,0.1788641789998791,876,686,66,1628
597,LYV,0.0263219660425755,0.1169833649728081,0.0,0.0418482717367383,722,374,535,1631
598,TER,0.0267980097506938,0.1847783752577494,0.0040534533681356,0.0254147907347221,716,193,725,1634
599,GE,0.0855305278851081,0.031862635844128,0.0053135197684135,0.032332181409158,209,777,650,1636
600,VMI,0.0293198915650991,0.1058534403448223,0.010118657820846,0.0429154522267786,685,425,526,1636
601,DG,0.0556064808910072,0.0907965735527385,0.0173378921029541,0.023148564071116,387,505,745,1637
602,GM,0.2066950669131141,0.0520549325659644,0.0121849466719787,-0.075109889033303,25,681,935,1641
603,UAA,0.0916824739161893,0.0810844090838445,0.0,-0.0468665842349562,186,548,909,1643
604,UA,0.0916824739161893,0.0810844090838445,0.0,-0.0468665842349562,186,548,909,1643
605,WPC,0.0507471092942483,0.0012489005429123,0.0656628766675854,0.0681902236177151,436,893,317,1646
606,VNO,0.0195508017327072,0.0490929713735961,0.0354310328252075,0.1139769078926488,790,698,158,1646
607,ETN,0.0334820283600063,0.1301939058171745,0.0143479543531537,0.0298300109720752,635,334,679,1648
608,NWL,-0.1079460536814612,0.0615152169220807,0.0511909120551259,0.1797246151500617,950,634,64,1648
609,CLX,0.0167975296612218,0.2192961455590136,0.0356947505300964,0.0289757386656076,821,137,691,1649
610,STN,0.0280473817935196,0.1188298587760591,0.0071896821083025,0.0376082193674579,700,366,584,1650
611,RSG,0.0331980774614757,0.1046030800020602,0.0122378354870985,0.0381020337912847,639,434,577,1650
612,BCH,0.1336624620752173,0.0478608826994383,0.0843330945589137,-0.0109835584846652,72,709,871,1652
613,CPRT,0.0270842609597171,0.2015621608482978,0.0,0.0191261059167459,712,169,772,1653
614,RJF,0.0817542170179089,0.0989261174276192,0.0166893312486243,-0.173333983982191,234,457,962,1653
615,STOR,0.0365138495940296,0.0308600462152152,0.0488928865715621,0.075100374423858,591,783,280,1654
616,AER,0.1933223067946212,0.0479431555036652,0.0,-0.059853648093931,27,707,920,1654
617,KIM,0.0497654221095774,0.0322731334874433,0.0500078322354166,0.0510718658878688,444,775,436,1655
618,ENPH,0.0243572891084362,0.1563694610503258,0.0,0.0325391465501023,746,262,648,1656
619,BAH,0.0311698526679676,0.1974401582951097,0.0130407258210215,0.0098875433325253,662,174,822,1658
620,MDT,0.0347215669423782,0.0723810485907667,0.0346271121900866,0.0491164711916122,618,591,453,1662
621,CBU,0.0472312941543225,-0.0014054873836653,0.0340483197648978,0.0751249098638024,465,921,279,1665
622,EW,0.0303150340325382,0.1878229143710668,0.0,0.0136076111833163,673,187,808,1668
623,OSK,0.0300135176862123,0.0702399818881593,0.0167930722879152,0.0555051597923283,677,598,393,1668
624,MLM,0.0378498794577348,0.1123868758517069,0.0056342535936742,0.0284335521873872,576,398,695,1669
625,HSIC,0.0420662465741183,0.0904942965779467,0.0,0.0316508057156227,507,507,657,1671
626,TR,0.0396015917741929,0.1034994335540165,0.0108043510676479,0.0292190567735104,546,440,687,1673
627,TDY,0.0421355417171596,0.082370825432149,0.0,0.034309758029147,506,544,623,1673
628,HASI,0.052987805079761,0.0325020083086598,0.0568861661323517,0.0462210335248212,408,774,492,1674
629,VFC,-0.1626338846347889,0.0698981263327637,0.0508842519400607,0.1347927426037724,960,601,114,1675
630,MDU,0.1028520820064721,0.0630432392267465,0.0400082141390332,-0.0464093895148697,140,628,908,1676
631,APO,0.093154471279074,0.0857042754242964,0.0190849461665469,-0.328541626464735,177,530,969,1676
632,HOLX,0.0266262184823232,0.0842662632375189,0.0,0.0526101378345905,721,537,420,1678
633,FTV,0.0333582807655297,0.0749776793095466,0.00392994298693,0.0479992448344848,638,577,464,1679
634,MHK,-0.0667095747673654,0.0777174474059087,0.0,0.1078709955127111,938,564,178,1680
635,CDNS,0.0141900710203511,0.3124431180711926,0.0,0.0169912888218673,841,50,789,1680
636,MCO,0.0224596324793511,0.183220590661607,0.0078825343611412,0.0262751145371375,767,198,718,1683
637,SBAC,0.0182807655278103,0.124683869261009,0.0134774617081072,0.0429042731304357,808,350,527,1685
638,EBR,0.0478896635663677,0.0466581896981994,0.0090962461293124,0.0433851064822175,456,711,520,1687
639,TDG,0.0269143639679618,0.1589364363003643,0.0007879397771822,0.0256287780157171,714,256,720,1690
640,STWD,0.0520953569823613,0.0247432060319022,0.0923293383653922,0.0483400891449474,422,810,460,1692
641,CMG,0.0194981028125408,0.2221088415490914,0.0,0.019403035166698,792,130,770,1692
642,ETR,0.1103431424603702,0.0491113683886049,0.0437443337376746,-0.0194918796937256,121,697,884,1702
643,SPG,1.4973464902678512e-07,0.0910558283334387,0.0523263176432023,0.0673057247375399,881,501,322,1704
644,EGP,0.0241543403883847,0.1300267825606075,0.027182382501605,0.0345869538519924,750,335,620,1705
645,STR,-0.0086803638743636,0.0442089804456332,0.0853114640432557,0.1543440400802206,897,725,83,1705
646,BMI,0.0204836951706553,0.2018031663108085,0.0064266216559523,0.0217038949866484,783,166,758,1707
647,WST,0.0226813048102865,0.2140798682585426,0.0021786895419385,0.0158432774584829,764,147,797,1708
648,IQV,0.0319321709897684,0.1031203566121842,0.0,0.035271175614619,656,443,610,1709
649,ALGN,0.0212529901067412,0.1636254606581626,0.0,0.0290372004329936,777,245,690,1712
650,EPAM,0.0242562393385164,0.1421902968981502,0.0,0.0310685017686717,748,303,667,1718
651,CARR,0.0280440559854154,0.0885426709344028,0.0128890398153873,0.0444463985891906,701,518,508,1727
652,GNRC,0.0256493632790662,0.091678395533717,0.0,0.0454688951314621,729,500,498,1727
653,LIN,0.0309169462103769,0.1232678895136264,0.0123787482649065,0.0275205209209324,666,355,706,1727
654,ZBH,0.0403168812372557,0.0744118672711177,0.0079098256255514,0.035135532046999,536,579,613,1728
655,PKX,0.1819376395687841,0.0410668230836642,0.087363748374324,-0.1145721128835305,37,739,952,1728
656,AZN,0.028540577224188,0.1160859770180087,0.0214761253638264,0.0314737146316108,695,379,659,1733
657,WM,0.0317716018968639,0.125013113263629,0.0156651648241481,0.0251525181683506,657,349,728,1734
658,EQR,0.0360634885162749,0.0464075016242919,0.0428752668742957,0.0518373311343957,599,712,427,1738
659,TEF,-0.0439262729977828,0.0320420142106889,0.1053344147334725,0.2702549172778388,931,776,33,1740
660,ADSK,0.0166803705914388,0.2001438590181622,0.0,0.0230505783449021,822,171,747,1740
661,JPM,0.0991325779395684,0.0160838242599683,0.0269337644656201,0.0233727378928797,156,842,743,1741
662,HTZ,0.1894178169596595,0.0425403319540657,0.0,-2.2225843847149664,31,732,979,1742
663,SAM,0.0180214956476717,0.0985283389381976,0.0,0.047520970503652,810,460,472,1742
664,MTN,0.028715414536428,0.1048558882089673,0.0336630911270125,0.0347662039048059,692,432,618,1742
665,KOS,0.0692304699626736,0.084807031408271,5.382286443332624e-05,-0.0542874919317175,296,533,916,1745
666,BRX,0.0435606157497006,0.0612783950277762,0.0450169815753403,0.0347867255550377,493,635,617,1745
667,MPWR,0.0142308880216776,0.218160344248234,0.0061883155117079,0.0193342404228305,840,140,771,1751
668,ELS,0.0239400498307969,0.1751351923738746,0.0248705823414778,0.0175941731625259,752,214,785,1751
669,AL,0.1320191067350097,0.0490727999837772,0.0280293206947453,-0.597357771805062,77,700,977,1754
670,CRL,0.0391925300337831,0.0864521012073106,0.0,0.0301707766536107,555,524,676,1755
671,KEX,0.0477173244322238,0.0654095729987424,0.0,0.0296443088757446,458,617,680,1755
672,ABMD,0.0090681704672291,0.2428062147216561,0.0,0.0165829836945386,859,101,795,1755
673,BIP,0.0070507695500212,0.0454428091918409,0.0861991140085933,0.1099781799419984,868,716,173,1757
674,ASX,0.0255814462164927,0.0932396952516316,0.030512378485242,0.0411906246947928,730,489,540,1759
675,NOK,0.0387292955347055,0.0634468854694773,0.0355843602582031,0.0387292955347055,564,627,568,1759
676,AVB,0.0351089149281589,0.0442820784581002,0.0348757689778703,0.0517178423381696,611,724,428,1763
677,JBHT,0.0352491785337954,0.1453208003758691,0.0084166841487901,-0.0057021633924565,610,295,859,1764
678,SYK,0.0278425296197011,0.1215341814885436,0.0100197918599809,0.0275874163941177,703,360,703,1766
679,ICE,0.0326915951123856,0.0717866998328734,0.0131843215085845,0.0421484121106897,646,592,531,1769
680,FTI,0.0063622132532373,0.098130300693909,0.0049244889059755,0.0510675159881739,871,461,437,1769
681,NEE,0.0593993527697008,0.0684630097775637,0.0307316487243513,0.0142444685916943,362,606,803,1771
682,AIN,0.0362945626727629,0.1086510730709465,0.0101786128201161,0.0207821646794446,595,417,763,1775
683,WY,0.0329800658835425,0.0994751466502006,0.0477994757024883,0.029599510858531,642,456,682,1780
684,LLY,0.0099867836052255,0.2812456589064939,0.0077549840708236,-0.0060068586221797,856,66,862,1784
685,NJR,0.0671505253282363,0.0710186004170728,0.0382961736011084,-0.0157082978176378,311,595,879,1785
686,LPX,0.0349036033068222,0.1326860841423948,0.0135300484728693,0.0031374025444334,615,326,845,1786
687,BLK,0.0453870102910124,0.0577104393667347,0.0250362733975322,0.0313056532268978,478,652,661,1791
688,HES,0.0313389031619728,0.1501663692916043,0.0122226257628823,-0.00376429661714,660,278,854,1792
689,ECL,0.024275713230644,0.1234629274090327,0.0109199138506715,0.0289582034238608,747,354,692,1793
690,PAC,0.0063540901837584,0.2731761865399983,0.0049927096465417,-0.0003422617661031,872,74,851,1797
691,PWR,0.0237624428236292,0.1028904921023549,0.0015237289253821,0.0364131709555823,755,446,597,1798
692,SNPS,0.0172196743072038,0.1727428249461054,0.0,0.0211618547143901,817,221,760,1798
693,INTU,0.0163468646901102,0.1563654072480824,0.0057045757980337,0.0255657681316135,823,263,721,1807
694,ADC,0.0283629028566951,0.0343938814061531,0.0475799005770857,0.0647584486808363,697,770,342,1809
695,ABT,0.0298817158151186,0.1091068330722719,0.0185670769593853,0.0264147475639848,679,415,717,1811
696,LDOS,0.013419759280539,0.0639876352395672,0.0135546312331072,0.0646036652801829,844,625,343,1812
697,ASR,0.0068136067379235,0.2318839223861361,0.0039925225931036,0.0081529000777862,869,114,829,1812
698,IR,0.0248728472705603,0.0847614332930504,0.0010349046507848,0.0406295899937752,739,534,551,1824
699,LH,0.0211143539772952,0.0832376536184147,0.0128302533737631,0.0441532459606548,779,540,510,1829
700,AGI,0.0394180674660609,0.0839957697285212,0.0067475021986037,0.0236640445937122,549,538,742,1829
701,JLL,0.0250569719281296,0.0704045245199455,0.0,0.0458673762978983,738,596,496,1830
702,VAL,0.170319562719185,0.014952905335532,0.0,-0.0843528594654988,43,846,943,1832
703,R,0.0777514438701659,0.0640315052508751,0.0245127704812345,-0.1687168030778724,249,624,961,1834
704,MSA,0.0088277919365734,0.2159370217249794,0.0110738059477136,0.0075484454787015,861,143,832,1836
705,HAE,0.0271637241378449,0.1098238293633205,0.0,0.0266777911357363,710,412,714,1836
706,SXT,0.0336702740157662,0.0871796832866475,0.0249558184457177,0.0295008764207136,631,522,685,1838
707,BXP,0.0172811551160707,0.0409493582699731,0.0624878901202824,0.0742235219690769,816,740,285,1841
708,TFC,-0.0221855856343355,-0.0001093770974301,0.0636691738048622,0.4136361112630797,911,910,20,1841
709,FCX,0.0302725611667909,0.130282067207813,0.0141370239647947,0.0074534714993993,674,333,834,1841
710,ED,0.0796389053788951,0.0533832200303997,0.0346503534320242,-0.0739165386168546,240,673,931,1844
711,TMO,0.0292603253318667,0.086384777014425,0.0025526522349568,0.0338092199455948,686,525,634,1845
712,OGE,0.0595728222724601,0.0559962106532317,0.0476239548492891,0.0077324608563821,361,657,831,1849
713,LHX,0.0307260421011384,0.0601193480390701,0.0217361080226472,0.0412435137249999,670,642,539,1851
714,O,0.0219439137785144,0.030862477178727,0.0531245275585489,0.0727031367339642,772,782,299,1853
715,DOW,0.0152194070022915,0.0453447198500312,0.0509552981468912,0.0702573304570979,831,718,308,1857
716,TFX,0.0304183560126287,0.0731053346753682,0.0054545566887332,0.035785156280365,671,587,604,1862
717,ESS,0.0254744010436487,0.0445878611723261,0.0368455911464221,0.0527091141145679,732,720,418,1870
718,CS,-1.0002653516001097,0.0037989998068973,0.0383348341702752,1.6952211310583845,978,890,4,1872
719,VMC,0.0309085121949846,0.1022468559291829,0.0075648351750262,0.0217737418741779,667,449,757,1873
720,EXR,0.0296049180167384,0.0443761774150578,0.0385668782702984,0.0474114433054024,682,721,474,1877
721,WEC,0.050208650865036,0.0537515872545711,0.0370735645445033,0.0197949178704902,442,668,768,1878
722,BURL,0.0266958317476389,0.0975640597993608,0.0,0.0276234488060894,719,465,702,1886
723,DLB,0.02521786765171,0.0857257364498697,0.0102183268600316,0.0342321325382109,734,529,625,1888
724,GPN,0.0297389543858799,0.0404384016504204,0.0078530586886355,0.0479630585340648,681,743,466,1890
725,IP,0.0229657105196111,0.0415500984353953,0.0511943963666332,0.055181498887399,761,736,395,1892
726,RCI,0.0261942288391394,0.0737190082644628,0.0296189160018537,0.0374247344898422,723,584,586,1893
727,ESI,0.0211421562063417,0.0550741633548331,0.0138560786652908,0.049552488043314,778,665,451,1894
728,DTE,0.0615051097230024,0.0577022020991973,0.0331079760284165,-0.0314349666014486,346,653,897,1896
729,AWR,0.0420098813767745,0.0946093265733717,0.0205793636846624,-0.040643192365998,512,483,904,1899
730,SR,0.073221229106701,0.0489121544249959,0.055715463986938,-0.0748371458869868,265,701,934,1900
731,ST,-0.0006841109783839,0.0807194525984032,0.0125206866838593,0.0476140662724638,884,550,471,1905
732,CCI,0.0300445307152318,0.0692226364698681,0.054468213806642,0.0340451340062081,676,604,628,1908
733,CIEN,0.0417011519763428,0.0765707229550908,0.0,0.0101680790420562,520,570,821,1911
734,TRMB,0.0236042910826885,0.064124513618677,0.0,0.0420904014776756,757,623,532,1912
735,FIS,-0.1874293865279001,0.0429499551471987,0.0346747181869319,0.090503549581326,966,730,223,1919
736,KBR,-0.0354261498459296,0.1224643125469571,0.0096252180713469,0.0335545796653899,923,358,638,1919
737,SNN,0.0221372272407419,0.121435977190254,0.0275242331092114,0.0152351259717653,770,361,800,1931
738,ING,0.1505118221041959,-0.0006146956733271,0.061282911511342,-0.2393069810483346,51,915,967,1933
739,IVZ,-0.0119428635659098,-0.0142056128789849,0.0732963979633288,0.1400729044649794,899,934,101,1934
740,ALB,0.0928306606710042,0.016391562583488,0.0110435657802749,-0.0486113236976481,182,841,912,1935
741,JWN,0.045705460369955,0.0523082650781831,0.0419535195933169,0.0177364473077437,475,679,783,1937
742,OUT,-0.1869675291615479,0.0531473576624782,0.0899216508746292,0.0727192480986132,965,675,298,1938
743,BX,0.0143581989342645,0.0828100248252547,0.044063622430666,0.0395651027409858,838,541,559,1938
744,NI,0.0646574256242727,0.0501896397426013,0.0419553643803029,-0.0643315587164645,324,691,924,1939
745,DHR,0.0279607148434948,0.0682551762143438,0.004818586668033,0.033929658377465,702,608,631,1941
746,UDR,0.0352985750144487,0.0272657097590551,0.0432637576915629,0.0413330137431116,608,797,538,1943
747,RBC,0.0268492840516658,0.0790091918892411,0.0029420368422501,0.0308913868436269,715,559,669,1943
748,AKAM,0.0303402989053721,0.0774526784480007,0.0,0.0275582363967517,672,567,705,1944
749,WCN,0.0198415087820264,0.09179805131308,0.0071678765612306,0.0315958560687348,788,498,658,1944
750,ACM,0.0048070864398169,0.0602130922337717,0.0083568867711066,0.0512905315611062,874,641,432,1947
751,FRC,0.0754688245764567,0.0147082388474256,0.0157736642357999,0.0024929641751982,255,847,847,1949
752,NLY,-0.1715341340738539,-0.0179282948037507,0.1584424204177171,0.2056939558796495,962,939,49,1950
753,TRP,0.0548170390687241,0.0525539450789192,0.0540103543733254,-0.0160961736895843,393,677,880,1950
754,CPT,0.0373844228956054,0.0362617785587401,0.0403104094050131,0.0355960728440943,582,761,608,1951
755,C,0.0929451676691342,0.0081673486212864,0.0524956885448122,-0.0411948131520111,179,872,905,1956
756,NOC,0.0289890996191514,0.0733194613028148,0.0157353283924966,0.0296094889106119,690,586,681,1957
757,NWE,0.0627435534418704,0.0425227088290931,0.0497892887159709,-0.0250992313086976,333,733,891,1957
758,DEI,-0.017850429608689,0.0157859764586761,0.0528209571046007,0.096702670204194,907,843,211,1961
759,MTZ,-0.0085078221239212,0.0219624896263641,0.0,0.0842003394953,896,824,242,1962
760,NEA,0.0122108537662188,0.005970583595519,0.0473082366962326,0.0853593297434613,848,881,236,1965
761,ALK,0.04722155171526,0.079032967032967,0.0,-0.089218591325853,466,558,945,1969
762,BIIB,0.0310089576655753,0.0553939471604621,0.0,0.0330039358221669,663,661,646,1970
763,EVRG,0.060911211061136,0.0438367511729245,0.0474429451940696,-0.0294685990338164,349,727,895,1971
764,SWH,-0.020162589844776,0.0510443967020235,0.032850998849051,0.0580372184390818,908,687,380,1975
765,SWK,-0.020162589844776,0.0510443967020235,0.032850998849051,0.0580372184390818,908,687,380,1975
766,SJI,0.070840471324085,0.0412920530332961,0.0,-0.1021953974198793,288,737,950,1975
767,SRE,0.0652838242346569,0.0398230662463841,0.032418991741893,-0.0462612855308349,319,751,907,1977
768,CP,0.0402858698514211,0.0591438430019409,0.0072528927896497,0.0168037318096836,538,647,792,1977
769,STT,0.0778589617925095,0.0078615604993923,0.038849379083711,-0.0050464141902552,248,873,858,1979
770,GLOB,0.0156377087886091,0.1165508099760703,0.0,0.0185059733930822,829,377,778,1984
771,EXC,0.0651072255596201,0.0437496601598608,0.0400767415064156,-0.0756507925853833,321,728,937,1986
772,AMH,0.0292023196982439,0.0289536232088686,0.0256130970645132,0.044042218235583,687,790,512,1989
773,EL,0.0103088913923928,0.079270081558411,0.0250321029451181,0.038090032042149,854,557,578,1989
774,SE,0.0065682058914068,0.0113671836942344,0.0,0.0795160359859745,870,864,257,1991
775,STX,0.0155211660055885,0.093103448275862,0.0271041257112516,0.0307643409782411,830,491,670,1991
776,HMC,0.0404445775445445,0.0644258558408791,0.0088352216975934,0.0050634717101214,533,621,841,1995
777,CUK,-0.0038935646742138,0.0519673742660538,0.0,0.0524578916242057,888,683,424,1995
778,CCL,-0.0038935646742138,0.0519673742660538,0.0,0.0524578916242057,888,683,424,1995
779,ALL,-0.0051163771695276,-0.0034732980024459,0.0280856448880452,0.1077977125983984,890,926,179,1995
780,APD,0.0365112154288694,0.0887546385737208,0.0237556234287653,-0.0225413342450819,592,515,889,1996
781,PTC,0.0146446321887006,0.0817638888789811,0.0,0.0349652671121984,836,546,615,1997
782,HAS,-0.2101415411151033,0.0428810346749916,0.0547471415783657,0.0728503845281191,971,731,296,1998
783,ROP,0.0238182413176384,0.0692421531246652,0.0049935367940894,0.0331600439555129,754,603,641,1998
784,SMG,-0.1313370743034055,-0.066060606060606,0.0515189628482972,0.1514125386996904,955,958,90,2003
785,TW,0.0190458806838854,0.0819499942989926,0.0039624238948903,0.0313014731605882,799,545,662,2006
786,AMZN,0.019433571154681,0.1015382835037485,0.0,0.0205781877367414,793,450,764,2007
787,COTY,0.0104755673211044,0.0617992342337591,0.0015701633344832,0.0432849504297091,853,633,521,2007
788,FNV,-0.0223239301789098,0.1267501970182228,0.0111523921859489,0.0224770961179797,912,343,752,2007
789,ISRG,0.0151754504897467,0.1281887570014801,0.0,0.0063267617837119,832,339,837,2008
790,HDB,0.0578847521168316,0.0191118537461027,0.0075940099376439,0.0133571814812222,372,828,810,2010
791,THG,0.0081435967567722,0.0002726322645138,0.0270376640196516,0.0806977378333972,865,897,249,2011
792,AEE,0.0605966497627262,0.04156329198346,0.0348220331101777,-0.0634897189788286,354,735,923,2012
793,CRM,0.0151069286379518,0.0787528716770594,0.0,0.0346918781922792,833,560,619,2012
794,DXCM,0.0113050990485344,0.1269406392694063,0.0,0.0106871287219663,852,342,820,2014
795,NSC,0.0340638179569905,0.0730650948231676,0.0228397246838059,0.0154750787653542,628,588,799,2015
796,TU,0.0246088258175208,0.0506236872562047,0.0384787228894648,0.0376886654613161,744,689,582,2015
797,RH,0.0250609826546451,0.111028975897187,0.0,-0.0131909008035229,737,404,874,2015
798,CBRE,0.034341333736082,0.0779587556798322,0.0,0.0079758270036133,626,563,830,2019
799,SO,0.051925636637559,0.0462880569503591,0.0396363951697665,-0.0201381618951499,424,713,886,2023
800,CNP,0.0508705245135352,0.0490920755348525,0.0296790955449742,-0.0290688711505915,434,699,893,2026
801,XEL,0.0518225380929306,0.0442945898300443,0.0319538179545342,-0.0154209359542486,426,723,877,2026
802,STE,0.0173226881121526,0.0893570930178622,0.0091857570336598,0.0280719519482859,815,514,699,2028
803,EDR,0.0502611168903218,0.017045014494479,0.017648261667914,0.0220067552271966,439,837,754,2030
804,UMC,0.0185899957304335,0.117104717978679,0.0140197578241264,-0.0025112062735976,804,373,853,2030
805,NWS,0.017064355973243,0.0595054662851273,0.0110340948398413,0.0386193319394448,818,643,569,2030
806,NWSA,0.017064355973243,0.0595054662851273,0.0110340948398413,0.0386193319394448,818,643,569,2030
807,TSLA,0.0190179606436877,0.1141774752793116,0.0,0.0055244519317652,800,392,839,2031
808,STAG,0.0272554083234134,0.0411401106036103,0.0378161105492533,0.0374213668149211,709,738,587,2034
809,REG,0.0309006971277016,0.0273015930027279,0.038692134353363,0.0384651408601426,668,796,571,2035
810,PRGO,-0.0029168888784768,0.0164700524786398,0.0343825405596843,0.0697756567938016,887,839,310,2036
811,CMS,0.052454218762123,0.0403304813532754,0.034240127016087,-0.0156712153009724,413,746,878,2037
812,FE,0.0524607520263084,0.0522348493580138,0.0431301645515748,-0.0937343200905638,412,680,948,2040
813,PNW,0.061543203361399,0.037876508728766,0.0474234962214338,-0.0783679269164518,345,757,939,2041
814,LNT,0.0541648367735324,0.0479069294858768,0.0351339481774264,-0.0760465062524559,397,708,938,2043
815,ANSS,0.0158810742776516,0.0973229372568714,0.0,0.021955090424643,827,466,755,2048
816,VEEV,0.0157888609400309,0.09072921450107,0.0,0.0265841103642572,828,506,715,2049
817,DD,0.0122216162136872,0.0484289501889772,0.0188091540309938,0.0454193396877455,847,704,499,2050
818,FR,0.0394490948602016,0.0673047374409139,0.0243123191454741,-0.0252387734211631,548,612,892,2052
819,NDAQ,0.0360750949999475,0.0677951538064959,0.0150227732719328,0.0016351317847001,598,609,849,2056
820,HEI,0.0185719553879264,0.0957681040277218,0.0012594634708162,0.0183743157968721,805,474,779,2058
821,RTX,0.0266286303699404,0.0309361642978767,0.026995347032312,0.0393136931001593,720,781,563,2064
822,AEP,0.0523924853044546,0.0417882877166264,0.0417697256147647,-0.0591832689166709,416,734,919,2069
823,KKR,0.051929196879028,0.0373604076377046,0.0085573109208874,-0.0222924438793436,423,758,888,2069
824,H,0.0160878362688094,0.0434359805510534,0.0034369468392456,0.0438027905682584,825,729,515,2069
825,TECH,0.0148851506035096,0.0953530601840146,0.0044644383467377,0.0209062407310373,834,476,761,2071
826,ELP,0.0193898518170983,0.0741131930044353,0.0064412599987816,0.0283299606095637,795,581,696,2072
827,ZBRA,0.0210778730367583,0.1051156271899089,0.0,-0.0064800217781926,780,429,865,2074
828,X,0.0818501038991043,-0.0161182815245712,0.0,-0.0435314519061158,233,937,906,2076
829,PANW,0.024867391278677,0.0555645829609528,0.0,0.0299149623203452,740,660,678,2078
830,POR,0.0538126955666646,0.0458597464342313,0.0422476864317235,-0.2213873177260152,399,714,966,2079
831,FRT,0.0282821797152344,0.0499429760248649,0.0428668027961007,0.0292040939220416,698,693,688,2079
832,WPP,0.002753038917442,0.0947725627696675,0.0105433410715081,0.0254606225969958,878,479,723,2080
833,QRVO,-0.0062773654429796,0.0172223069451153,0.0,0.0630181540735545,892,836,353,2081
834,PUK,0.0552852055197451,-0.0034095467308463,0.017323347761331,0.0195009543279524,390,925,769,2084
835,KNX,0.0233682298353631,0.0308170456724462,0.0098088905832562,0.0411829417227562,760,784,541,2085
836,LXP,0.0082879535781957,0.000735113399007,0.0527681080770412,0.0665137535853282,863,894,328,2085
837,TEVA,-0.0478499207351939,0.0138639856557377,0.0,0.0720744781020273,933,850,303,2086
838,RNG,-0.0512807398925674,-0.1359703497573468,0.0,0.1069931486647393,934,971,183,2088
839,ASH,0.0411176611904717,0.0313696881269378,0.017555855339752,0.0168628610500249,524,779,791,2094
840,IDA,0.052380475053638,0.0399749191580243,0.0327975833865397,-0.0690083855767047,417,750,928,2095
841,UNF,0.0331739528313197,0.0580189912391553,0.0070716318225607,0.0140059907920953,640,651,806,2097
842,TD,0.0763671535252721,0.0084104796385001,0.0412575282215461,-0.475584204285654,252,871,974,2097
843,HXL,0.0169411387586649,0.0827249673403519,0.0067636334495331,0.0238650478823576,820,542,739,2101
844,EFX,0.0179422564685815,0.0909852840853717,0.0063108835332366,0.0169617333753049,811,502,790,2103
845,PLD,0.0242162046674972,0.0345438189175843,0.0255569476379325,0.0370555788911457,749,768,589,2106
846,RBA,0.0184900090970793,0.0655125989576479,0.0299441861433787,0.0293879756889,806,616,686,2108
847,SPGI,0.0187221634368154,0.073810223266745,0.0081775786222495,0.025431057493953,802,583,724,2109
848,PHG,-0.0239383655378913,-0.0054448179536953,0.000102739766257,0.076643865627755,914,930,274,2118
849,PCG,0.0606224767506352,0.0246438588721582,0.0,-0.1334715611792576,352,811,958,2121
850,SUI,-0.0120782832830374,0.0350445415342714,0.0288860148395534,0.0489861700018372,900,767,455,2122
851,EIX,0.0513866169089361,0.0359075997813012,0.0445569812572154,-0.0747607710110819,430,763,933,2126
852,KRG,0.0094726543535695,0.0194163006378786,0.0419897571166501,0.0502710005243225,857,827,445,2129
853,BSX,0.0189647530599861,0.0775750753236433,0.0003333415478214,0.0202743091407133,801,566,766,2133
854,MMM,-0.1381688547846324,-0.2587081597369838,0.0654005830152849,0.1000464974244693,957,975,203,2135
855,D,0.0507239740732826,0.0398197644164813,0.0568037282375326,-0.0931805000152629,437,752,947,2136
856,DIS,0.015888293284125,0.0534969043797294,0.0,0.0330522396823961,826,671,645,2142
857,DNB,-0.0093313203358818,0.0266015938716253,0.0170941847004134,0.0501905910832115,898,799,447,2144
858,AWK,0.0370572900207936,0.0534337584822538,0.020883981240532,-0.0337598192986044,586,672,900,2158
859,NEP,0.071798951448113,-0.0013435700575815,0.2660151151152589,-0.1931391793954241,277,920,964,2161
860,VTR,-0.0020459738089705,0.0282508745107125,0.0361306900457608,0.0466953212123852,886,793,484,2163
861,XYL,0.0245391432844009,0.0528510821888257,0.0120479537636057,0.0228064944153874,745,676,748,2169
862,LYG,0.0447308603410272,0.0088386941289463,0.0135257601507391,0.0111007904326175,482,869,818,2169
863,TRNO,0.029058154573574,0.0400219041695212,0.0260642189870998,0.0242933746767405,688,749,735,2172
864,AMT,0.0147425279893677,0.0583021285066087,0.0293131111703918,0.0290646360138259,835,649,689,2173
865,MS,0.059857322591907,0.0120957378727761,0.0379616760313811,-0.2433815731402862,359,858,968,2185
866,CTVA,0.0216333757955784,0.0288765458618467,0.0129211591486516,0.03455453494423,774,791,621,2186
867,AEG,-0.0144997627599039,-0.001305653043574,0.0400161050468858,0.0605911873989283,904,919,367,2190
868,NOW,0.0120024338414695,0.0760327279984035,0.0,0.0187490358794532,849,572,774,2195
869,BDX,0.0200506710560615,0.0457530505645982,0.0150515145259114,0.0285762596250473,787,715,694,2196
870,DUK,0.0379722269448035,0.0442954702086335,0.043358642804978,-0.0362213076453423,574,722,901,2197
871,KRC,0.045470522968154,-0.0001944471204649,0.0547233365926262,0.0125908878814103,476,912,813,2201
872,PFSI,0.0327531236070452,0.0737017876041036,0.0093842354345315,-0.3664368913925612,645,585,971,2201
873,PPL,0.0370487643245793,0.0454089592155114,0.0352463920060862,-0.0316416473691001,587,717,899,2203
874,WRK,-0.1799978605469577,-0.0671053040494044,0.0307055173874222,0.0748590253263211,963,959,282,2204
875,FMX,0.0083023280220791,0.0921769116644612,0.00237584926181,0.0024912418767708,862,496,848,2206
876,DV,0.011579452597249,0.07582886464178,0.0,0.0166454023482577,850,573,794,2217
877,WD,0.0295774246774859,0.0523887121335899,0.0233727693577428,-0.0046061734510361,683,678,856,2217
878,BFAM,0.0136457908238167,0.047610712839837,0.0,0.0303570723472323,843,710,674,2227
879,IFF,-0.1242290172830895,0.0305290227773695,0.0400051338307337,0.0453326940261098,954,785,500,2239
880,MRK,0.0013196726604391,0.0452451809683753,0.0269177067314224,0.0330568962586159,880,719,644,2243
881,GLW,0.0225005421817393,0.0368057565857491,0.0383012671561793,0.0238172692629426,766,759,740,2265
882,SCHW,0.0403773332313341,0.0189735315349582,0.0181367299061607,-0.0388234394124847,534,829,902,2265
883,XRAY,-0.0174948443223928,0.0496215306980656,0.0153742571317997,0.0302183674659513,906,695,675,2276
884,AR,0.0357270326048783,0.0291827423359474,0.0184045274602203,-0.0215452895301991,603,789,887,2279
885,TYL,0.0094427347861828,0.0594573564320743,0.0,0.018634659645819,858,645,777,2280
886,SWX,0.0336478604416024,0.048066533602342,0.0389295547636495,-0.081017199246059,633,706,941,2280
887,GMED,0.0203891001221137,0.0283658901991931,0.0,0.0274168374474151,784,792,708,2284
888,GOL,-0.0683485059782147,-0.1036552142495524,0.0,0.057404239282772,940,966,384,2290
889,MAC,-0.0824031195304747,0.0255885264539705,0.0440872399494773,0.040890817335395,944,804,547,2295
890,FAF,0.0322566630541584,0.0176799567021468,0.0322269059849203,0.0135245879687407,653,835,809,2297
891,DNP,-0.0569175431627175,-0.0490478467113992,0.0854965200734807,0.0533158238834794,936,952,411,2299
892,COO,0.0190641337677519,0.0498695029888025,0.0001943997325059,0.0139319808295943,798,694,807,2299
893,CUZ,0.0224574180549758,0.0265204533069329,0.0526084433319485,0.0240490868490558,768,800,738,2306
894,XPO,0.0186015566255004,0.0742121314808539,0.0,-0.0837562152820153,803,580,942,2325
895,AJG,0.0200613689588482,-0.0965057831454277,0.0097999632170299,0.0380348656867034,786,963,579,2328
896,AMRC,0.0378314002196365,0.030095597739221,0.0,-0.3765323473308908,577,786,972,2335
897,AU,-0.0307016995984553,0.0814921090387374,0.0139790717320626,-0.0092758326446397,919,547,869,2335
898,NCLH,0.0195377654749285,0.0691906499109689,0.0,-0.0875492422906439,791,605,944,2340
899,PFE,0.0130430524756039,0.023698008471968,0.0569179359329448,0.0295022890587871,845,815,684,2344
900,KMX,0.0383391908386099,-0.0048665318045148,0.0,-0.000535240078777,569,928,852,2349
901,NGG,0.0114784808086736,0.0628278273672586,0.0086113668250224,-0.0091075980914236,851,631,867,2349
902,CAE,-0.0367092060560125,0.0628302366333587,0.0,0.0144660615440698,924,630,802,2356
903,HR,-0.0431335793195082,0.0041247054669117,0.0723307190110051,0.0411697038506615,930,888,542,2360
904,EQIX,0.0128544018529242,0.0501157842213198,0.0182258653058872,0.0074554570491265,846,692,833,2371
905,IRM,0.0090179576213143,0.0604935917132433,0.0361067796354775,-0.0113330206588519,860,639,873,2372
906,LAZ,-0.02580537312163,-0.0456881261990455,0.055884895369388,0.044031453167971,915,950,513,2378
907,FLR,0.014126457322781,0.0385826771653543,0.0049357501489234,0.0180410177857203,842,755,781,2378
908,WELL,0.0073147513114258,0.0260276064798662,0.0271125470565624,0.0268574618431993,867,801,711,2379
909,REXR,0.0209120267609828,0.0279356645856667,0.0276454224440806,0.0141440143355491,781,795,805,2381
910,ORA,0.0276212354617877,0.0367249399359959,0.0063085277368814,-0.0686055721947452,707,760,927,2394
911,CCJ,0.0145919164930303,0.0281251368646578,0.0021059685103119,0.0199645038368741,837,794,767,2398
912,WDAY,0.0181544751878757,0.0106168289900851,0.0,0.0251217973092183,809,865,729,2403
913,CALX,0.010172873987283,0.0339223280117418,0.0,0.0133196136271344,855,771,811,2437
914,DLTR,-0.0327915749562885,0.0403248147378627,0.0,0.0189477760339371,921,747,773,2441
915,MC,-0.0064239904317538,-0.0697955187789935,0.0473752389103868,0.0368734449976828,893,960,592,2445
916,BIO,-0.0675754567002412,0.0325906222776293,10.613707927444835,0.0231424234859581,939,773,746,2458
917,CDAY,0.0051510924451897,0.0362078346028291,0.0,0.009879193722435,873,762,823,2458
918,ARES,0.0216157490814906,0.0226511686126152,0.0469689994248847,-0.0136916848687176,775,820,875,2470
919,LUV,0.0270606857701529,0.0092443564029548,0.024907469913173,-0.0226378640098698,713,868,890,2471
920,HUN,0.0226555844221098,0.0138248847926267,0.0379088491815501,-0.0047105670580624,765,851,857,2473
921,PNM,0.0246095059223709,0.0336142995141237,0.0352947212991421,-0.1461430715212756,743,772,960,2475
922,AUY,-0.261708570233604,0.053687562856185,0.0214933367842704,0.004369936710938,972,669,844,2485
923,DLR,0.0236111629679043,0.0185111211244498,0.0378401511113235,-0.0470516694532123,756,830,911,2497
924,AAP,0.0081979304128236,0.0164124403189532,0.0577020161389307,0.0123965610587591,864,840,815,2519
925,YPF,-0.1948403713179253,-0.0620432513049962,0.0,0.0356415313386448,969,954,606,2529
926,RKT,-0.008328623793096,-0.0022519476254158,0.0,0.0268385258017437,895,923,712,2530
927,PENN,-0.1238110976182282,0.0249481961274032,0.0,0.0186980024974467,952,808,775,2535
928,BA,-0.014079643987191,-0.0187689692849338,0.0,0.0280895867665246,903,940,698,2541
929,ARE,0.0047834560764205,0.0312920284754312,0.0391155617674149,-0.0395895734223406,875,780,903,2558
930,ES,-0.0204967372240355,0.0486968480834752,0.0429416470522568,-0.1247067766096819,910,703,954,2567
931,OFC,-0.0270521412504934,-0.0176264729723225,4.197612738102126e-07,0.0267737732478613,917,938,713,2568
932,CWT,0.0175725248917078,0.0145055138561775,0.0199844267979207,-0.0561693871295308,813,849,918,2580
933,TAL,-0.0003977014359372,-0.0222776892091516,0.0,0.0205780718360864,882,941,765,2588
934,AMD,0.0035894444084863,0.0065527158637819,0.0,0.0047116711732004,877,879,843,2599
935,CVT,-0.0384403731892883,-0.0406671794855289,0.0,0.0253686527880201,928,947,727,2602
936,FL,-0.1187117828998914,0.0398063474986551,0.0406497923263264,-0.0543196339935866,951,753,917,2621
937,WDC,-0.0323063581989731,0.0250814872106513,0.0,-0.0316181275105238,920,807,898,2625
938,GWRE,-0.0004941907343202,-0.0378588263929445,0.0,0.0149488041066468,883,946,801,2630
939,MBLY,-0.000773140088976,-0.0021310946076848,0.0,0.0084759061606259,885,922,828,2635
940,NEM,-0.0724238192489928,0.0131291912418195,0.0406504181821994,0.0027866364407585,941,853,846,2640
941,CTLT,-0.1026073885189907,0.0166246273790415,0.0,-0.0058042530418221,947,838,860,2645
942,UGI,-0.3112606304208982,-0.1100022853660394,0.0638270800064158,0.0275616936391341,974,967,704,2645
943,NRG,-0.0171366520750619,0.0232192526303059,0.0323221011910821,-0.0715158301944416,905,819,929,2653
944,TTM,-0.0764647887017587,0.012611158036458,1.0411038202837614e-05,-0.0060260858314058,943,856,863,2662
945,TV,-0.0646057254996506,0.0117802851817747,0.0064843493517715,-0.0092303298002638,937,861,868,2666
946,ILMN,-0.0543016646897929,-0.0081957616204191,0.0,0.0131427801703977,935,931,812,2678
947,HUBS,-0.006088460922513,-0.098364887513622,0.0,0.0086586724360288,891,965,827,2683
948,INTC,0.0080219427920065,0.0005687412471945,0.0146665241810042,-0.0678184257709068,866,895,926,2687
949,SNOW,-0.0130293827845126,-0.1993340316629926,0.0,0.0123212650018531,902,972,816,2690
950,MXL,-0.0381233945985341,-0.044539975388287,0.0,0.0122807708713311,926,949,817,2692
951,AES,0.0193349251645215,-0.0053895289152503,0.0344767340283035,-0.3641799157494224,796,929,970,2695
952,WK,-0.0232169748876075,-0.1287202462007734,0.0,0.0124739012068168,913,969,814,2696
953,LUMN,-5.717031199437558,0.0403490355596378,0.0061067530776668,-0.5218498084551666,979,744,975,2698
954,BEP,-0.0067469334493962,0.0138000076668452,0.1335892841531657,-0.1273821053532194,894,852,956,2702
955,MPW,-0.1893597756723873,0.0049744545443641,0.2094072562896341,-0.0080198089280522,967,886,866,2719
956,GME,0.0014908359206011,-0.0156077565820589,0.0,-0.0530915597993201,879,935,914,2728
957,TSN,-0.0369862380372636,-0.0132764183920408,0.0382419436496398,-0.0106734977051979,925,933,870,2728
958,NEWR,-0.0351284643148866,-0.4301764196358282,0.0,0.0066352914695669,922,978,835,2735
959,ENV,-0.088523550288856,-0.1290330519373163,0.0,0.0091095559094166,946,970,824,2740
960,LNC,-0.1644394633722437,0.0235447016865139,0.0846250961769392,-0.4535205412686614,961,816,973,2750
961,WBA,-0.1409766348620937,-0.0954600307935583,0.0759351419598095,0.0064538004920633,958,962,836,2756
962,HCP,-0.0450005540457791,-0.2032281139230895,0.0,-0.0045879002774241,932,973,855,2760
963,HL,-0.0290976124270932,-0.0156550712001917,0.005393608324587,-0.0509353243854653,918,936,913,2767
964,TTWO,-0.1467450519302371,-0.0465419703379032,0.0,-0.0061845972957084,959,951,864,2774
965,S,-0.0428511019461759,-0.2185682765950073,0.0,-0.0110247397273868,929,974,872,2775
966,W,-0.1049219483067474,-0.56855151045701,0.0,-0.0002843413233245,948,979,850,2777
967,RIG,-0.1956200787401575,-0.0045076099061356,0.0,-0.0539288057742782,970,927,915,2812
968,KMPR,-0.0873199620911857,-0.0638979400231954,0.0257049943531935,-0.0603313225767839,945,956,921,2822
969,AA,-0.1075677461996034,-0.0319101123595505,0.0118968935888962,-0.0727032385988103,949,945,930,2824
970,TEO,-0.2842120131096284,-0.0648327914552615,0.0016145595210116,-0.0302826449852364,973,957,896,2826
971,MU,-0.0763038034692394,-0.0965724755837213,0.0065930253640488,-0.0800189209362828,942,964,940,2846
972,SPR,-0.1818907427589065,-0.0267267140872932,0.0,-0.1103387855295021,964,943,951,2858
973,BAK,-0.1342455948756865,-0.0623522238910285,0.0002052236654574,-0.1990962731602505,956,955,965,2876
974,MRNA,-0.1240856122285133,-0.275063266497956,0.0,-0.1006846556584776,953,976,949,2878
975,CEA,-0.3354717798420933,-0.0523955268384762,0.0,-0.1291733027621429,975,953,957,2885
976,KEP,-0.8010410416763826,-0.0253157364889634,0.0075282974070141,-2.0603174193197447,977,942,978,2897
977,NIO,-0.1932175677050099,-0.3802156801451961,0.0,-0.1436531229006565,968,977,959,2904
978,LPL,-0.5898132489819542,-0.1147541837967621,0.0,-0.5284796114328209,976,968,976,2920
