,ticker,eps,roce,divYield,eps_rank,roce_rank,overall_rank
0,PBF,0.57541184,0.497484548,0.014721326,6,19,25
1,SWN,0.284601461,0.778613023,0.0,27,3,30
2,DQ,0.860150992,0.44335949,0.0,3,31,34
3,LPX,0.23518711,0.620655412,0.014942827,42,10,52
4,ERF,0.221426368,0.89771845,0.010073994,54,2,56
5,PBR,0.527250274,0.366559486,0.542769914,8,52,60
6,RRC,0.196368659,0.523872006,0.006411598,72,15,87
7,APA,0.232549736,0.390675398,0.014066549,43,44,87
8,ICL,0.229432082,0.384514436,0.123908202,47,47,94
9,MLI,0.199209054,0.463094424,0.016881369,70,25,95
10,SQM,0.171288828,0.712109629,0.098151339,92,5,97
11,VLO,0.230055259,0.360515613,0.031171609,46,56,102
12,CHK,0.415826671,0.296145409,0.102103307,12,92,104
13,NUE,0.219991823,0.373606235,0.015430527,55,50,105
14,SM,0.260930618,0.308645801,0.004608018,29,77,106
15,CF,0.193174129,0.438139308,0.017666253,76,32,108
16,BTU,0.34549882,0.294452377,0.0,16,94,110
17,CIVI,0.253451242,0.301313526,0.109034315,32,87,119
18,CVI,0.204465865,0.359328358,0.153349399,65,58,123
19,E,0.297022318,0.285394955,0.064358044,22,102,124
20,AR,0.199446755,0.359487423,0.013144486,69,57,126
21,AN,0.228008985,0.304253081,0.0,49,81,130
22,DHI,0.247287594,0.292830481,0.013361762,35,97,132
23,PHM,0.244608944,0.293601429,0.013468685,39,95,134
24,MPC,0.241730877,0.282611184,0.021298828,40,105,145
25,MTDR,0.17958165,0.353364137,0.0052129,84,62,146
26,MTH,0.293271421,0.252802701,0.0,24,128,152
27,CMC,0.249058501,0.268729765,0.013861818,34,119,153
28,GGB,0.219691652,0.287836111,0.113286399,56,99,155
29,THO,0.245305167,0.271154181,0.020469478,38,118,156
30,EC,0.32024605,0.241922689,0.128046653,18,139,157
31,DVN,0.148785055,0.391249515,0.083581829,119,43,162
32,WSM,0.127925495,0.495089978,0.024651005,143,20,163
33,CPG,0.289509786,0.239178408,0.039150373,25,141,166
34,CRC,0.146868396,0.361210543,0.016536709,120,55,175
35,CTRA,0.207846313,0.274721797,0.101852363,62,115,177
36,GPI,0.27054777,0.227559892,0.008532245,28,157,185
37,VALE,0.238719147,0.23571634,0.083897303,41,146,187
38,X,0.407952204,0.213497645,0.0,13,174,187
39,MRNA,0.118156944,0.449964175,0.0,164,27,191
40,PXD,0.143121415,0.322983706,0.114369427,124,70,194
41,NVR,0.113847204,0.449262032,0.301158389,169,28,197
42,EQT,0.141465298,0.319187393,0.016265955,128,74,202
43,FANG,0.181637437,0.26570857,0.065101243,82,121,203
44,OLN,0.172976009,0.274418461,0.015147948,91,116,207
45,OXY,0.214324875,0.225297601,0.020294358,58,158,216
46,BAM,0.168598192,0.267837864,0.280322007,99,120,219
47,ARW,0.210451463,0.220672832,0.0,59,162,221
48,UMC,0.176627857,0.245690075,0.07584877,88,133,221
49,HPQ,0.111721282,0.376065627,0.036170768,173,49,222
50,COP,0.119548257,0.346916599,0.036645253,161,64,225
51,MOS,0.23174962,0.209996527,0.012788015,44,184,228
52,PSX,0.22464305,0.210476772,0.0365371,51,181,232
53,EOG,0.1031081,0.400747392,0.018684107,202,40,242
54,KBH,0.299521729,0.188530021,0.019237379,21,225,246
55,AMG,0.187866164,0.216039098,0.000262314,79,167,246
56,STM,0.134202824,0.277801605,0.006581309,136,113,249
57,TMHC,0.301687504,0.186697536,0.0,20,231,251
58,QCOM,0.096201312,0.426940885,0.02388672,217,35,252
59,ABG,0.249494968,0.182112192,0.0,33,235,268
60,LEN,0.181264237,0.205092492,0.017208165,83,188,271
61,TX,0.294627118,0.176731184,0.08835083,23,251,274
62,MTG,0.217642507,0.18824356,0.027904098,57,226,283
63,RHI,0.07905037,0.607008807,0.022743116,272,11,283
64,EXPD,0.080129815,0.51588673,0.012620957,269,17,286
65,ESNT,0.199454652,0.192662973,0.022102955,68,220,288
66,AMAT,0.084849804,0.40254303,0.011352319,249,39,288
67,CHRW,0.081692141,0.481352823,0.024782097,264,24,288
68,MUSA,0.102406574,0.296237381,0.004550389,203,91,294
69,CVE,0.125792754,0.22930948,0.018079052,148,155,303
70,BHP,0.078621085,0.435876136,0.062654687,273,33,306
71,CNQ,0.128184488,0.218695826,0.057734003,142,164,306
72,AB,0.078386735,0.448232405,0.103220662,277,29,306
73,PFE,0.109175473,0.258144814,0.031261101,184,124,308
74,TOL,0.255740257,0.161328824,0.017672417,31,284,315
75,SU,0.152349591,0.200727536,0.043571614,114,203,317
76,JBL,0.116978845,0.231395349,0.005637535,166,152,318
77,PII,0.100746331,0.278441145,0.025044663,207,112,319
78,MAS,0.078287543,0.393268648,0.0239315,278,42,320
79,OC,0.150607162,0.198196115,0.016504894,117,208,325
80,TNET,0.083110924,0.342955326,0.0,259,66,325
81,LAD,0.22381643,0.164105035,0.008086733,53,278,331
82,MT,0.321056428,0.142372036,0.011458905,17,320,337
83,RIO,0.107691198,0.234117523,0.101682341,188,150,338
84,TKC,0.141399408,0.19639523,0.015966699,129,212,341
85,XOM,0.120217588,0.209144663,0.03221978,158,185,343
86,DKS,0.106393402,0.230369484,0.016633219,192,154,346
87,VSH,0.138633643,0.196052424,0.018488473,132,214,346
88,BBWI,0.078240757,0.334386391,0.018190976,279,67,346
89,ACT,0.179281897,0.171922223,0.063848825,85,264,349
90,TSM,0.085659946,0.278886788,0.024035827,243,110,353
91,TS,0.123026868,0.200739096,0.025597286,154,202,356
92,CVX,0.105660298,0.224562754,0.032772121,196,161,357
93,GIL,0.107339642,0.215606989,0.024532482,191,168,359
94,WLK,0.171237973,0.167104975,0.012879047,93,272,365
95,NNI,0.11936995,0.20070473,0.010727697,162,204,366
96,BC,0.120724188,0.196175022,0.0193658,157,213,370
97,IBP,0.090919782,0.238071476,0.025502773,229,142,371
98,MUR,0.14450178,0.175303827,0.019198934,123,255,378
99,LYB,0.14297916,0.172301976,0.119554444,126,261,387
100,PAG,0.161399842,0.158251343,0.018022982,103,290,393
101,ASX,0.149395839,0.16537715,0.072852326,118,276,394
102,M,0.185644462,0.144106622,0.027286739,81,314,395
103,OGN,0.129218442,0.17505626,0.040865156,140,256,396
104,LII,0.058204948,0.675172343,0.01662664,392,8,400
105,MCK,0.07086177,0.305019843,0.005812258,323,80,403
106,WSO,0.067777509,0.322105813,0.037481148,337,72,409
107,MU,0.136312168,0.165157293,0.007233787,134,277,411
108,EVR,0.109066182,0.187649473,0.029126658,185,227,412
109,WMS,0.07315415,0.285177592,0.005714577,310,103,413
110,AVT,0.165999028,0.144243023,0.022897257,101,313,414
111,MO,0.06916466,0.301079822,0.079184176,326,88,414
112,TEX,0.100897585,0.198159943,0.01197318,206,209,415
113,UPS,0.076619262,0.247131209,0.033930629,288,131,419
114,BBY,0.074105161,0.263042204,0.041204349,300,122,422
115,AGCO,0.085982645,0.210349585,0.03907687,241,182,423
116,HCA,0.084781035,0.213889411,0.009810742,250,173,423
117,TPR,0.092509132,0.201087423,0.027999826,226,200,426
118,POOL,0.062819301,0.354976238,0.01264205,366,60,426
119,CPRT,0.071253678,0.282457695,0.0,322,106,428
120,RDY,0.058081102,0.406030447,0.006415943,393,38,431
121,AZO,0.055863441,0.489143143,0.0,411,21,432
122,SWKS,0.09208651,0.199396717,0.026950036,228,205,433
123,MSM,0.077524381,0.233950596,0.03818792,283,151,434
124,TXN,0.057371222,0.418627694,0.028177408,398,37,435
125,CIG,0.170873178,0.133895352,0.087399209,95,345,440
126,YPF,0.449540933,0.106703528,0.0,11,429,440
127,CRI,0.086322265,0.198439265,0.040776929,239,207,446
128,MC,0.059578952,0.331594292,0.069210972,382,68,450
129,BYD,0.107684565,0.171393048,0.008111496,189,265,454
130,PM,0.05767631,0.356558451,0.049797451,396,59,455
131,HOLX,0.082190896,0.201659802,0.0,262,196,458
132,TSN,0.136424154,0.139964453,0.027512345,133,326,459
133,HD,0.053261172,0.450717165,0.024253216,433,26,459
134,GWW,0.05463897,0.397095733,0.013068144,422,41,463
135,BG,0.107646841,0.165554072,0.023334626,190,273,463
136,HTZ,0.353003098,0.099860302,0.0,15,451,466
137,CLF,0.159668177,0.127515454,0.0,104,362,466
138,ASR,0.073355857,0.224895199,0.03312071,307,160,467
139,EXP,0.085467863,0.18893639,0.0069435,244,224,468
140,WES,0.114773024,0.153156161,0.069381824,168,300,468
141,WY,0.081742599,0.197435897,0.070307331,263,210,473
142,DOW,0.126117532,0.139430102,0.055214266,146,327,473
143,CTSH,0.077301091,0.204619097,0.019038347,284,189,473
144,WU,0.170788395,0.121103052,0.068307856,96,378,474
145,NEU,0.089538436,0.179098012,0.026990167,232,245,477
146,PAC,0.064507378,0.257797861,0.051362661,352,125,477
147,CSL,0.07569632,0.207646982,0.011010374,293,186,479
148,NRG,0.156620788,0.124845335,0.042586488,109,370,479
149,VIPS,0.098335489,0.167727965,0.0,212,270,482
150,PSA,0.133953555,0.133464361,0.079594265,137,346,483
151,ALSN,0.111848791,0.145072775,0.016851042,172,311,483
152,ALB,0.080431698,0.194255801,0.007261372,268,217,485
153,TPX,0.075895393,0.201444385,0.011741552,290,197,487
154,ACI,0.139292045,0.130055132,0.389971709,130,358,488
155,LRCX,0.053677695,0.35452199,0.010803613,429,61,490
156,RLI,0.097962417,0.16324423,0.061262801,213,280,493
157,CNS,0.054311093,0.328986719,0.03408756,425,69,494
158,SNA,0.075002048,0.201159768,0.025757531,296,199,495
159,SEE,0.067550744,0.228604612,0.016283082,339,156,495
160,MMM,0.08511269,0.177055128,0.049635564,246,250,496
161,MRO,0.194791012,0.107916525,0.011864347,74,425,499
162,SWH,16.12972345,0.086523912,6.690207209,1,505,506
163,KLAC,0.0500691,0.386726386,0.002653431,463,45,508
164,NTAP,0.093352961,0.160289718,0.031655007,224,287,511
165,TLK,0.075342368,0.193262827,0.040436641,295,218,513
166,GSK,0.084169995,0.172300193,0.059300421,253,262,515
167,THC,0.191678621,0.102865961,0.0,77,440,517
168,ULTA,0.047797874,0.44423196,0.0,489,30,519
169,SCCO,0.056514045,0.276516828,0.057955544,405,114,519
170,FRO,0.195707183,0.100992915,0.013824838,73,449,522
171,SIG,0.106364355,0.138348238,0.019623899,193,333,526
172,LOW,0.047384842,0.419845435,0.017446338,495,36,531
173,OMC,0.078499572,0.174339105,0.034649526,275,258,533
174,CR,0.07247528,0.190915008,0.01869248,313,221,534
175,CHH,0.053201375,0.287227754,0.008416226,435,101,536
176,TER,0.051701001,0.301975434,0.00503721,452,86,538
177,CBT,0.057898185,0.237190083,0.023270084,395,143,538
178,TROW,0.063207068,0.212115526,0.044929397,361,179,540
179,ADM,0.085451658,0.155920602,0.017700701,245,296,541
180,UL,0.063595907,0.205271596,0.036025475,357,187,544
181,GEF,0.095943894,0.14078506,0.028347638,219,325,544
182,AIT,0.062036441,0.21477693,0.009562235,373,172,545
183,TGS,0.102107157,0.134174738,0.0,204,344,548
184,AVGO,0.059633439,0.214888892,0.036480412,381,169,550
185,CNHI,0.093307777,0.138152181,0.019452533,225,335,560
186,NXPI,0.067343666,0.190173295,0.01969325,341,222,563
187,AYI,0.068529145,0.185798126,0.00323015,331,232,563
188,LKQ,0.077635602,0.161871608,0.019189305,282,282,564
189,CSCO,0.05921604,0.213075713,0.029586893,388,176,564
190,PCAR,0.087340479,0.138659021,0.029137661,237,331,568
191,HOG,0.11591971,0.114251444,0.014568765,167,403,570
192,SID,0.110373903,0.117742279,0.191283949,181,390,571
193,FLT,0.068726628,0.179713096,0.0,328,243,571
194,ODFL,0.043198118,0.42717804,0.004218435,538,34,572
195,URI,0.081465894,0.148679731,0.0,265,308,573
196,GOOGL,0.052034253,0.25287535,0.0,448,126,574
197,MAN,0.086058401,0.138216984,0.032208588,240,334,574
198,MPLX,0.118908359,0.110660173,0.091864546,163,412,575
199,GOOG,0.051741036,0.25287535,0.0,451,126,577
200,BDC,0.080782425,0.14407976,0.00283874,267,315,582
201,ORLY,0.039988479,0.530985798,0.0,569,14,583
202,CARR,0.101580184,0.120325122,0.014630536,205,380,585
203,PKG,0.084903262,0.137255727,0.034652205,248,338,586
204,OTIS,0.038096454,0.68313172,0.01413795,584,7,591
205,RH,0.072342981,0.163261454,0.0,314,279,593
206,ITW,0.043776634,0.345739828,0.022249034,532,65,597
207,HI,0.079344461,0.138688748,0.023548859,271,330,601
208,ABEV,0.062970357,0.181567807,0.053320468,362,239,601
209,TEL,0.068113699,0.170650155,0.019216591,335,267,602
210,ADP,0.037524557,0.545030109,0.020935447,589,13,602
211,DPZ,0.036546782,0.720650338,0.012729874,601,4,605
212,RDN,0.206817747,0.075092298,0.037702912,63,542,605
213,NOC,0.057930552,0.19715245,0.012447496,394,211,605
214,NSP,0.041421624,0.364837853,0.017689239,554,53,607
215,INFY,0.041353766,0.362799962,0.023541543,556,54,610
216,EME,0.054915342,0.203846869,0.003676194,421,191,612
217,DECK,0.043376206,0.317050567,0.0,537,75,612
218,FAST,0.040029882,0.386719166,0.026196757,567,46,613
219,IPG,0.071927744,0.155859983,0.035066692,316,297,613
220,VZ,0.12838943,0.092461814,0.065263822,141,472,613
221,MMP,0.098573575,0.114032826,0.082747018,211,405,616
222,LAZ,0.107793788,0.104821865,0.054838047,187,432,619
223,IP,0.111551074,0.102217529,0.049916139,174,445,619
224,ABC,0.060215119,0.180878951,0.013883448,379,241,620
225,LW,0.063791749,0.170962865,0.009237758,355,266,621
226,TREX,0.039043605,0.38366148,0.0,575,48,623
227,GIB,0.059558268,0.181351367,0.0,383,240,623
228,MCHP,0.048526959,0.235139642,0.015078337,480,147,627
229,NOK,0.174196563,0.076833836,0.014468562,90,537,627
230,EMR,0.074426189,0.13902133,0.028171844,299,329,628
231,HES,0.051195243,0.212196,0.010708857,455,178,633
232,BBDO,0.1420568,0.086289367,0.0,127,506,633
233,SUN,0.131584167,0.087942478,0.099449929,138,496,634
234,INGR,0.075891189,0.134178553,0.02791932,291,343,634
235,DCI,0.0489516,0.225046938,0.016194625,475,159,634
236,DE,0.059165073,0.179052807,0.010893807,390,246,636
237,REGN,0.056144834,0.186825361,0.0,409,230,639
238,SON,0.078405508,0.127066274,0.03144931,276,363,639
239,AVY,0.050886532,0.210340342,0.01605705,458,183,641
240,VRTX,0.044918261,0.274002405,0.0,524,117,641
241,TRQ,0.158565065,0.077785186,0.0,106,535,641
242,ALV,0.063417169,0.161717791,0.033582614,358,283,641
243,YUM,0.034831976,0.523080603,0.017061096,627,16,643
244,DVA,0.110631162,0.093585039,0.0,177,467,644
245,BERY,0.126052813,0.087929204,0.003620316,147,497,644
246,FICO,0.034814181,0.488408257,0.0,629,22,651
247,BBD,0.127271583,0.086289367,0.0,145,506,651
248,FCX,0.063333212,0.157258425,0.015815041,359,293,652
249,AON,0.040746219,0.295934828,0.00728679,559,93,652
250,JHX,0.053131792,0.196044212,0.013448985,437,215,652
251,WTS,0.050884418,0.202937766,0.007991787,459,193,652
252,AMX,0.064265907,0.151317184,0.001278857,353,304,657
253,PBA,0.117529171,0.088178328,0.065311566,165,493,658
254,WWE,0.038338428,0.306900661,0.006997351,582,79,661
255,CRH,0.088954417,0.107275683,0.030391654,234,428,662
256,V,0.040322624,0.291006682,0.008634978,565,98,663
257,ACN,0.037677599,0.314970221,0.013462718,587,76,663
258,CSX,0.062955924,0.15270911,0.012875287,363,302,665
259,WPP,0.076519957,0.122204027,0.040955606,289,377,666
260,GM,0.204362083,0.059671187,0.008167077,66,603,669
261,MXL,0.047195163,0.214846371,0.0,498,171,669
262,ITT,0.054259921,0.180360721,0.012995769,428,242,670
263,BKNG,0.038056958,0.302125896,0.0,585,85,670
264,CCK,0.073169009,0.128845597,0.010668384,309,361,670
265,GGG,0.040536492,0.280875319,0.012506917,562,109,671
266,MAR,0.048819961,0.201934081,0.006645974,476,195,671
267,DAR,0.073205392,0.12651552,0.0,308,366,674
268,KMB,0.042225184,0.252068447,0.034015945,545,129,674
269,SYY,0.047019831,0.212772935,0.026456365,502,177,679
270,VRSN,0.030396568,1.529764801,0.0,679,1,680
271,FBHS,0.052109017,0.1827966,0.009647319,447,234,681
272,CE,0.170926602,0.06206089,0.026803168,94,590,684
273,TSCO,0.043466311,0.234706429,0.016353206,536,149,685
274,ITUB,0.120016312,0.080460864,0.027096808,160,527,687
275,DOV,0.055142446,0.169800369,0.014883258,419,268,687
276,EPD,0.104851334,0.088945794,0.078208782,197,491,688
277,WRK,0.120202341,0.079860587,0.033021922,159,530,689
278,CDW,0.046160506,0.212013098,0.011704764,511,180,691
279,RL,0.066176628,0.132968278,0.025105845,346,347,693
280,HUN,0.08328083,0.103083295,0.030958743,256,439,695
281,AWI,0.061682098,0.140910602,0.013436909,374,324,698
282,WAT,0.0344412,0.349957687,0.0,636,63,699
283,PKX,0.151266668,0.064479445,0.058619264,116,584,700
284,SYF,0.191056043,0.055962915,0.030153407,78,623,701
285,UNP,0.054272258,0.16547915,0.024499294,427,274,701
286,GNRC,0.062880449,0.135569388,4.86e-05,364,339,703
287,WIT,0.056211344,0.153739418,0.016251269,406,298,704
288,WBA,0.143107618,0.064923528,0.054741881,125,582,707
289,CHTR,0.092303292,0.090307871,0.0,227,482,709
290,MA,0.02950066,0.499490897,0.00565355,692,18,710
291,FN,0.052273998,0.16805329,0.0,442,269,711
292,MRK,0.05168276,0.173219816,0.024960363,453,259,712
293,DISH,0.309457842,0.043915079,0.0,19,694,713
294,BIIB,0.075724822,0.109025295,0.0,292,421,713
295,GPC,0.048182823,0.186904157,0.020203484,485,229,714
296,TJX,0.036163432,0.281423188,0.013843006,609,107,716
297,ANET,0.036365364,0.27857346,0.0,606,111,717
298,CLH,0.066539874,0.124226042,0.0,345,373,718
299,TTC,0.040116425,0.230968731,0.011374956,566,153,719
300,CAJ,0.083278526,0.094740544,0.040733123,257,462,719
301,ALLE,0.049444665,0.178367198,0.015535125,471,248,719
302,MOH,0.041494828,0.214874519,0.0,552,170,722
303,LEG,0.070522103,0.114983404,0.052174519,324,400,724
304,BSMX,0.166214373,0.055787405,0.112236764,100,626,726
305,VRSK,0.034241846,0.303000926,0.007007033,642,84,726
306,ASGN,0.062436015,0.130256378,0.0,370,357,727
307,BEN,0.122841268,0.067131136,0.055444495,156,572,728
308,FL,0.083261712,0.092266158,0.036518295,258,473,731
309,UA,0.100442163,0.081084409,0.0,208,524,732
310,CIB,0.203965368,0.049092188,0.069476898,67,665,732
311,EMN,0.071861475,0.10984583,0.034526131,317,418,735
312,NVO,0.026068775,0.621765835,0.011879661,726,9,735
313,DFS,0.146235193,0.057791655,0.023406954,121,614,735
314,TT,0.045666556,0.19515442,0.016124337,520,216,736
315,ABM,0.077144037,0.099212106,0.017377498,285,452,737
316,JLL,0.084758333,0.089664931,0.0,251,486,737
317,APH,0.041905803,0.204409451,0.010516654,548,190,738
318,KR,0.062342079,0.125456093,0.018947102,371,368,739
319,STR,0.465213494,0.037708111,0.337300116,10,731,741
320,PG,0.040002636,0.213158111,0.024567237,568,175,743
321,OKE,0.058576535,0.131633963,0.056854191,391,353,744
322,CHE,0.032758155,0.300047082,0.002889291,657,89,746
323,SBS,0.079888804,0.09140602,0.0,270,477,747
324,OGE,0.084117233,0.088312776,0.041610042,255,492,747
325,KT,0.144908686,0.055812719,0.054726789,122,625,747
326,MTD,0.026096984,0.484308199,0.0,725,23,748
327,CAT,0.051450024,0.156788066,0.018723051,454,295,749
328,TPL,0.0246581,0.685228829,0.013660392,744,6,750
329,TRGP,0.07155876,0.104830446,0.022727613,319,431,750
330,MAIN,0.087789165,0.082590289,0.070554429,236,516,752
331,RBA,0.049895875,0.158612034,0.017984755,465,289,754
332,NSC,0.056516298,0.132713324,0.020169578,404,350,754
333,ZBRA,0.034586752,0.258995574,0.0,633,123,756
334,DEO,0.048326536,0.165387225,0.022791385,483,275,758
335,ADBE,0.029628873,0.32032358,0.0,687,73,760
336,PFSI,0.158151085,0.049898788,0.018166652,107,655,762
337,PAGP,0.481900752,0.032984473,0.06712633,9,753,762
338,PNR,0.064875112,0.110560137,0.01869763,351,413,764
339,BCH,0.158099717,0.049682287,0.06055378,108,658,766
340,IHG,0.035512911,0.23502994,0.022065355,619,148,767
341,FIX,0.059478538,0.119894776,0.004855317,387,381,768
342,CMI,0.059904123,0.118338807,0.023811262,380,389,769
343,KOF,0.068529062,0.103201294,0.041270812,332,438,770
344,CL,0.026810839,0.368873383,0.025398952,720,51,771
345,QSR,0.074646073,0.092001939,0.048907785,298,474,772
346,IT,0.029972321,0.297149267,0.0,684,90,774
347,AEL,0.285224769,0.033580254,0.017338592,26,750,776
348,DRI,0.049943968,0.144723691,0.029999951,464,312,776
349,LH,0.065385604,0.103878992,0.009978321,348,435,783
350,SNY,0.059171188,0.116458439,0.036700225,389,395,784
351,JWN,0.083077827,0.080799305,0.040352087,260,525,785
352,SBUX,0.033389227,0.245280614,0.023028351,651,136,787
353,ROST,0.036847014,0.203505812,0.010510253,599,192,791
354,IDXX,0.019905971,0.594829652,0.0,780,12,792
355,WST,0.033460803,0.236942346,0.003089656,650,144,794
356,TSLA,0.032636206,0.245483471,0.0,660,135,795
357,CBRE,0.056648935,0.116554957,0.0,402,394,796
358,EW,0.032953263,0.240505633,0.0,656,140,796
359,NLY,0.198971286,0.038039739,0.175205789,71,730,801
360,UNH,0.040500935,0.18173045,0.012059697,563,238,801
361,BWA,0.099589877,0.061216492,0.016985138,210,594,804
362,MSFT,0.028537334,0.287573865,0.007808615,704,100,804
363,HSY,0.034357645,0.218113735,0.01618916,639,165,804
364,BSAC,0.125235167,0.049727329,0.073498973,152,656,808
365,ZTS,0.030764316,0.245620003,0.008891673,675,134,809
366,DGX,0.052129714,0.126528442,0.016807149,445,365,810
367,MTCH,0.030873333,0.245227374,0.0,674,137,811
368,CPB,0.050725094,0.132578281,0.030220631,460,352,812
369,WF,0.375213339,0.021626208,0.078226693,14,799,813
370,VAC,0.064920304,0.094602717,0.018207111,350,463,813
371,MPWR,0.026924629,0.293394264,0.008487306,718,96,814
372,JNJ,0.038687495,0.181773272,0.025190754,579,237,816
373,CPA,0.10312339,0.057418073,0.0,201,617,818
374,WD,0.084282491,0.06891134,0.031591153,252,566,818
375,KEYS,0.035856701,0.199372291,0.0,613,206,819
376,DG,0.047045774,0.143488513,0.009614167,501,318,819
377,CNI,0.046329723,0.146091414,0.018140829,509,310,819
378,AIG,0.208692122,0.030272533,0.020532088,61,759,820
379,FMC,0.046846139,0.143711763,0.017014721,504,317,821
380,AM,0.063223683,0.094822106,0.083985397,360,461,821
381,SLB,0.045456131,0.153003182,0.011202208,521,301,822
382,HII,0.062592781,0.097086159,0.020756155,369,456,825
383,MSCI,0.023177814,0.322294481,0.009928351,756,71,827
384,NJR,0.073922244,0.078816031,0.034337617,301,532,833
385,SAN,0.206335158,0.027787158,0.039698841,64,771,835
386,POST,0.151674342,0.039640602,0.109696272,115,720,835
387,HAL,0.044191564,0.151144612,0.012228582,529,306,835
388,ALLY,0.193341247,0.029674799,0.05572379,75,763,838
389,JBHT,0.053588771,0.111276443,0.009217027,431,409,840
390,ORAN,0.087240725,0.0596924,0.075654702,238,602,840
391,CTAS,0.028089001,0.246390317,0.009375093,708,132,840
392,BIP,0.100371341,0.055548675,0.103510227,209,632,841
393,HUM,0.042571458,0.153379449,0.00594726,543,299,842
394,SHG,0.246940412,0.020593394,0.081969694,36,808,844
395,COF,0.1873937,0.029387186,0.029993176,80,764,844
396,MMS,0.057017036,0.10126506,0.019222004,401,447,848
397,PFG,0.228337545,0.021310318,0.030480756,48,800,848
398,BXMT,0.068832676,0.08181218,0.116654169,327,521,848
399,UHS,0.065582951,0.086664509,0.005673782,347,502,849
400,FTNT,0.021489318,0.307848616,0.0,772,78,850
401,ABB,0.042787838,0.147530837,0.02935505,541,309,850
402,XPO,0.048062481,0.126837463,0.0,487,364,851
403,SAIC,0.052122932,0.113425402,0.014420678,446,408,854
404,WAL,0.17716414,0.028268226,0.027848936,87,769,856
405,AAP,0.05331103,0.107421933,0.035715815,432,426,858
406,MKTX,0.02394614,0.280877047,0.010138524,751,108,859
407,ROL,0.020490652,0.303018467,0.011763979,777,83,860
408,GIS,0.051805199,0.111097173,0.025721854,450,410,860
409,MPW,0.135346589,0.038681939,0.104747002,135,728,863
410,HSIC,0.049505637,0.11702961,0.0,470,393,863
411,IVZ,0.11058434,0.045300312,0.068654294,179,684,863
412,GILD,0.042620433,0.141140679,0.03442491,542,323,865
413,LYG,0.174427459,0.026202722,0.047129603,89,777,866
414,BAP,0.113036974,0.043480462,0.029189968,171,696,867
415,MSI,0.031575466,0.201235764,0.012278061,669,198,867
416,PEP,0.035738524,0.176019082,0.024756248,615,252,867
417,UNM,0.159634532,0.029716534,0.030877414,105,762,867
418,MCD,0.031827528,0.200949961,0.021475621,667,201,868
419,MFG,0.583531265,0.011936418,0.220015784,5,863,868
420,G,0.041423693,0.144068859,0.010764529,553,316,869
421,HLT,0.036116147,0.172487644,0.00353967,610,260,870
422,BMO,0.162582083,0.02816034,0.03116647,102,770,872
423,TEF,0.104782096,0.046867417,0.07278995,198,674,872
424,SMFG,0.553914841,0.01186363,0.207311999,7,865,872
425,DLTR,0.048130978,0.118971745,0.0,486,386,872
426,GD,0.048727869,0.116184748,0.01967801,477,397,874
427,JKHY,0.030049579,0.202471929,0.012067253,681,194,875
428,LDOS,0.047533035,0.119245945,0.013808867,492,384,876
429,MMC,0.036936333,0.162849098,0.013781491,596,281,877
430,RKT,0.829262414,0.008248278,0.0,4,877,881
431,STWD,0.168607637,0.023325668,0.114431472,97,790,887
432,CDNS,0.019486909,0.283341184,0.0,783,104,887
433,PAA,0.125792114,0.035452934,0.094859627,149,739,888
434,TXT,0.057145219,0.088964588,0.001128303,399,490,889
435,FDX,0.071739587,0.066778145,0.021258181,318,576,894
436,BMY,0.040843505,0.137835313,0.029914462,558,336,894
437,SHW,0.032991383,0.179122603,0.010101069,653,244,897
438,DB,0.245612064,0.012821305,0.018048597,37,860,897
439,ROK,0.036865381,0.152208895,0.020833292,598,303,901
440,HDB,1.329161067,-0.00066128,0.231774465,2,901,903
441,BCO,0.067152585,0.069463971,0.014800335,342,562,904
442,FCN,0.044017619,0.122932171,0.0,530,375,905
443,BCE,0.052882148,0.093536122,0.063576585,440,468,908
444,A,0.030314275,0.186943963,0.006043516,680,228,908
445,VMI,0.035599015,0.157373239,0.006501149,618,292,910
446,SXT,0.046124815,0.115095343,0.022561994,513,399,912
447,K,0.039484885,0.134601136,0.032780681,572,342,914
448,C,0.168598841,0.019226104,0.056820478,98,817,915
449,SPG,0.055419524,0.086644463,0.06715177,412,503,915
450,HBAN,0.156070211,0.020967054,0.070433831,111,805,916
451,NKE,0.031043081,0.178815208,0.012319266,671,247,918
452,BCS,0.225194144,0.010233871,0.075140691,50,869,919
453,FSS,0.042825105,0.119660664,0.007754047,540,382,922
454,VIV,0.063768569,0.068054245,0.089123714,356,569,925
455,ENS,0.049583891,0.096041063,0.00804878,467,458,925
456,CACI,0.048662906,0.101215712,0.0,478,448,926
457,MNST,0.022282257,0.217349252,0.0,763,166,929
458,UAA,0.037419927,0.137322731,0.0,592,337,929
459,CLX,0.007580539,0.30387289,,849,82,931
460,NYCB,0.156287975,0.018880216,0.084155064,110,821,931
461,AMGN,0.046369322,0.107921673,0.029695616,508,424,932
462,SNV,0.138850116,0.021023274,0.042010522,131,802,933
463,IGT,0.060733287,0.070999647,0.035172875,377,557,934
464,NI,0.07203466,0.057338026,0.039112464,315,619,934
465,HON,0.033472659,0.16045067,0.018327056,649,286,935
466,PAYC,0.015653909,0.248236616,0.0,805,130,935
467,HPE,0.046682202,0.106188695,0.033398212,506,430,936
468,ABT,0.035651958,0.141851431,0.017016058,617,321,938
469,LNC,0.258460596,-0.00758096,0.059000578,30,908,938
470,NEP,0.208795331,0.005752946,0.118460152,60,879,939
471,KO,0.034659857,0.149358562,0.027663956,632,307,939
472,KNX,0.090700938,0.040993138,0.009207852,230,710,940
473,BBVA,0.178183649,0.013953756,0.060643501,86,854,940
474,CI,0.059546173,0.071363131,0.012359314,385,555,940
475,AFL,0.096740296,0.039059505,0.021437019,216,725,941
476,IX,0.105802051,0.033924569,0.041181727,195,748,943
477,SNX,0.066858885,0.06077754,0.011799599,344,600,944
478,MDU,0.059551241,0.070161045,0.028668049,384,560,944
479,BR,0.032347335,0.160468862,0.016979016,662,285,947
480,KB,0.231506322,-0.001443785,0.075736364,45,902,947
481,SKX,0.057137932,0.074416806,0.0,400,547,947
482,FNF,0.109806196,0.028954207,0.047266928,182,766,948
483,IEX,0.033955119,0.151238854,0.010263483,644,305,949
484,LLY,0.018929883,0.220307496,0.010718082,788,163,951
485,NGG,0.067343966,0.05838429,0.03987537,340,611,951
486,NDAQ,0.037180471,0.1299759,0.012657885,593,359,952
487,AXP,0.067717944,0.057561335,0.01410415,338,615,953
488,BNS,0.125680388,0.021014329,0.064868115,150,804,954
489,ACM,0.043081642,0.110303283,0.006575849,539,416,955
490,CMA,0.127622065,0.020463532,0.041690614,144,811,955
491,ORI,0.09421456,0.036721861,0.079569027,222,735,957
492,NYT,0.031903465,0.157707198,0.010418319,666,291,957
493,RCI,0.052462201,0.0817681,0.031539776,441,522,963
494,COST,0.024804196,0.189567272,0.006358091,743,223,966
495,WRB,0.06859673,0.054552734,0.011681881,330,637,967
496,VC,0.033729354,0.143462898,0.0,648,319,967
497,HST,0.055182947,0.071520856,0.013076528,416,554,970
498,SF,0.104219627,0.027246363,0.026918885,199,773,972
499,NFLX,0.034254837,0.138522023,0.0,641,332,973
500,R,0.224136618,-0.030978436,0.031797928,52,921,973
501,CMG,0.023266863,0.193219389,0.0,755,219,974
502,MFC,0.155712379,0.01189482,0.060416316,112,864,976
503,GS,0.094617922,0.031319375,0.030937145,220,757,977
504,SR,0.068123758,0.052806561,0.048346888,334,644,978
505,SIVB,0.123165154,0.018441473,0.012007129,153,825,978
506,BRO,0.042491096,0.103861617,0.00755833,544,436,980
507,CRL,0.043915179,0.099977961,0.0,531,450,981
508,CW,0.045919565,0.094532372,0.004489649,517,464,981
509,TD,0.110468621,0.021021395,0.042244154,180,803,983
510,ABMD,0.00906817,0.242806215,0.0,846,138,984
511,AFG,0.076866925,0.043459491,0.103830267,286,698,984
512,RF,0.111366861,0.02056436,0.037800244,175,809,984
513,VTRS,0.15407682,0.009677419,0.043111267,113,872,985
514,CM,0.111346919,0.020522112,0.053203062,176,810,986
515,VAL,0.034755985,0.13035358,0.0,631,356,987
516,APD,0.043666964,0.098572079,0.026773863,534,453,987
517,FFIV,0.036930317,0.117509734,0.0,597,391,988
518,DHR,0.037457904,0.114374482,0.004250321,590,402,992
519,HSBC,0.129629214,0.013885624,0.056346468,139,855,994
520,EXR,0.043624201,0.095635187,0.040817403,535,460,995
521,BUD,0.049387509,0.081300403,0.020205109,472,523,995
522,SKM,0.053615163,0.069301407,0.053122731,430,565,995
523,CHT,0.041834453,0.10234824,0.040996273,551,444,995
524,SJR,0.04542356,0.091719298,0.035197313,522,475,997
525,UBS,0.125308543,0.015671089,0.027397385,151,846,997
526,ABBV,0.041354061,0.102427997,0.035089459,555,443,998
527,FITB,0.108258439,0.020041747,0.041028444,186,813,999
528,KEY,0.113709297,0.017481171,0.050656098,170,831,1001
529,EPR,0.062321165,0.055655237,0.093947664,372,629,1001
530,FLO,0.037639151,0.110317405,0.030735218,588,415,1003
531,ZION,0.122947271,0.01514465,0.036463965,155,848,1003
532,WNS,0.030589245,0.139346993,0.0,677,328,1005
533,TFC,0.109538218,0.01877093,0.052301874,183,822,1005
534,HIG,0.073691866,0.042656702,0.021397032,304,701,1005
535,WM,0.034558335,0.124754384,0.01663062,634,372,1006
536,MCO,0.026815921,0.157257391,0.010051091,719,294,1013
537,EPAM,0.022337221,0.175666561,0.0,762,254,1016
538,VLY,0.103610772,0.019340075,0.039915167,200,816,1016
539,BX,0.054393382,0.061348122,0.118631502,423,593,1016
540,CFG,0.110627628,0.016332201,0.047602433,178,840,1018
541,WMB,0.051117513,0.069310796,0.051666359,456,564,1020
542,ASB,0.106302553,0.017586651,0.039091496,194,829,1023
543,TGT,0.035701228,0.113728388,0.023578221,616,407,1023
544,BMI,0.02087368,0.177164196,0.007810365,776,249,1025
545,SNPS,0.021996824,0.174911208,0.0,768,257,1025
546,WMT,0.029803378,0.135285664,0.015600844,686,340,1026
547,BP,-0.01227594,0.236718808,0.039424131,882,145,1027
548,FUL,0.041893492,0.091393937,0.009109261,549,478,1027
549,SCI,0.051845529,0.064998373,0.014676352,449,580,1029
550,AME,0.036050185,0.109732217,0.006285438,611,419,1030
551,RY,0.08935283,0.021705291,0.03937544,233,798,1031
552,ADSK,0.017708613,0.181868334,0.0,796,236,1032
553,SEM,0.052267163,0.061946882,0.021232775,443,591,1034
554,JBT,0.044721066,0.085791431,0.004482372,526,509,1035
555,SSL,0.060312332,0.049603769,,378,660,1038
556,ST,0.049558023,0.067151161,0.008146603,468,571,1039
557,J,0.046138347,0.080445598,0.008306405,512,528,1040
558,CME,0.044611198,0.082654118,0.043657967,527,515,1042
559,OHI,0.067070352,0.043025641,0.099427669,343,700,1043
560,PPG,0.034371081,0.113961181,0.019095045,638,406,1044
561,AEM,0.052898892,0.058894193,0.048010166,438,608,1046
562,MLM,0.04116733,0.089068497,0.007556209,557,489,1046
563,AIN,0.030044714,0.126505742,0.008303224,682,367,1049
564,ATR,0.033267194,0.115410972,0.01382764,652,398,1050
565,CBOE,0.017619545,0.175688647,0.01570014,797,253,1050
566,BAC,0.097860598,0.016890151,0.030487231,214,837,1051
567,MGA,0.036286356,0.101661604,0.031505384,607,446,1053
568,FNB,0.096144152,0.016950606,0.039192554,218,836,1054
569,AKAM,0.039047356,0.090356217,0.0,574,481,1055
570,TDG,0.028352054,0.132785804,0.03571835,706,349,1055
571,OUT,0.055371732,0.052901589,0.077048698,413,643,1056
572,ALGN,0.021926444,0.159767632,0.0,769,288,1057
573,STT,0.097762284,0.016069534,0.034255566,215,842,1057
574,MS,0.076713435,0.027328507,0.037567256,287,772,1059
575,RJF,0.072749825,0.033752967,0.013354342,311,749,1060
576,NVS,0.03515106,0.103573319,0.037935853,624,437,1061
577,CMCSA,0.036387642,0.096269203,0.032125477,605,457,1062
578,OGS,0.055115407,0.05312862,0.033295132,420,642,1062
579,CVS,0.035259397,0.102504746,0.023776169,621,442,1063
580,TU,0.048453545,0.064547143,0.035642608,481,583,1064
581,ENPH,0.011080286,0.183258308,0.0,832,233,1065
582,PNC,0.089575415,0.017078112,0.039916738,231,835,1066
583,CNA,0.077852538,0.023642913,0.085515875,281,788,1069
584,PRI,0.068285791,0.036007723,0.015547806,333,737,1070
585,EDR,0.085976259,0.017702909,0.0,242,828,1070
586,ORCL,0.028978667,0.123753302,0.012500735,697,374,1071
587,RSG,0.036434704,0.093197883,0.014521468,603,469,1072
588,GLW,0.049761177,0.059118566,0.035241198,466,607,1073
589,TRI,0.032965801,0.109036861,0.014622351,655,420,1075
590,ATO,0.055164468,0.04954076,0.026778344,417,661,1078
591,GL,0.062659206,0.040845453,0.006823014,368,711,1079
592,PB,0.07786526,0.021090274,0.02867195,280,801,1081
593,IBN,0.055155167,0.049208035,0.005638325,418,664,1082
594,LEA,0.044725737,0.070894609,0.025317742,525,558,1083
595,VFC,0.013348567,0.172116692,0.079116802,822,263,1085
596,CNP,0.056033516,0.046839949,0.02592279,410,675,1085
597,CUZ,0.073661919,0.025717791,0.050647229,305,780,1085
598,TDY,0.042135549,0.075756395,0.0,546,540,1086
599,JPM,0.094597479,0.011238945,0.034051678,221,866,1087
600,FNV,0.02680602,0.124790925,0.007560476,721,371,1092
601,SLF,0.088143695,0.013230159,0.045375266,235,859,1094
602,FDS,0.024190477,0.132964096,0.007675165,747,348,1095
603,PYPL,0.029432564,0.114142075,0.0,693,404,1097
604,NWE,0.060996271,0.039286611,0.046684479,375,722,1097
605,COTY,0.050142752,0.05478196,0.001312989,461,636,1097
606,TMO,0.032195231,0.104682199,0.002107745,664,434,1098
607,MTB,0.084129801,0.015398954,0.037214981,254,847,1101
608,ESI,0.041988449,0.071348672,0.017584906,547,556,1103
609,EA,0.024037417,0.130921958,0.006294087,749,355,1104
610,TRV,0.063958404,0.03319833,0.019556599,354,751,1105
611,EFX,0.02926481,0.11077659,0.0080329,694,411,1105
612,DAL,0.062867642,0.034855614,0.0,365,744,1109
613,CX,0.093703336,0.003588345,0.0,223,886,1109
614,TRMB,0.035777888,0.087981539,0.0,614,495,1109
615,TR,0.025924269,0.119265166,0.008408138,727,383,1110
616,CB,0.057373682,0.040726435,0.014848261,397,713,1110
617,EVRG,0.052231043,0.048745773,0.037110618,444,667,1111
618,PENN,0.046390288,0.059595923,0.0,507,604,1111
619,NWL,0.036230845,0.086606441,0.070806473,608,504,1112
620,ING,0.082893713,0.014335602,0.069785044,261,852,1113
621,BXP,0.055299487,0.043381813,0.06492677,414,699,1113
622,WBS,0.081275206,0.014709097,0.032986772,266,849,1115
623,NVDA,0.009165708,0.167422514,0.000835154,844,271,1115
624,LNT,0.049522859,0.052134831,0.030897644,469,646,1115
625,BLK,0.048416387,0.054885072,0.027957705,482,635,1117
626,GMED,0.025485562,0.118915115,0.0,732,387,1119
627,BK,0.069691573,0.022293827,0.037269959,325,794,1119
628,STN,0.034345457,0.090409861,0.010873744,640,480,1120
629,BABA,0.039533616,0.07337246,0.012378867,571,550,1121
630,POR,0.053254587,0.044293205,0.036112552,434,689,1123
631,ENLC,0.085072763,0.008308041,0.037617555,247,876,1123
632,ETN,0.03934418,0.072482987,0.020758769,573,553,1126
633,IRM,0.03842049,0.073815277,0.049968206,580,549,1129
634,MTN,0.036037226,0.082301264,0.0233865,612,518,1130
635,FLS,0.047081284,0.055594065,0.026086848,499,631,1130
636,PTC,0.025539927,0.114855161,0.0,730,401,1131
637,HWM,0.028604071,0.10475322,0.002683538,701,433,1134
638,KMI,0.062690927,0.028742003,0.061608352,367,767,1134
639,AJG,0.029157254,0.102815544,0.011239491,695,441,1136
640,WEC,0.047656722,0.051640988,0.031039598,491,648,1139
641,NMR,0.060967007,0.028670441,0.03762521,376,768,1144
642,HEI,0.015898029,0.135209002,0.001106025,803,341,1144
643,FRC,0.075468825,0.014708239,0.015773664,294,850,1144
644,WFC,0.078597222,0.009569527,0.031559331,274,873,1147
645,IPGP,0.022871293,0.118813076,0.0,760,388,1148
646,TECH,0.022233157,0.119092512,0.00391917,764,385,1149
647,FHN,0.068662979,0.01898047,0.027160023,329,820,1149
648,PNW,0.05618429,0.034917312,0.044017932,407,742,1149
649,CFR,0.068053051,0.019506766,0.025434556,336,815,1151
650,SAM,0.016572557,0.132603538,0.0,801,351,1152
651,SRC,0.053143924,0.040304288,0.06678728,436,716,1152
652,FISV,0.038972686,0.06514431,0.0,576,578,1154
653,INCY,0.019104543,0.125301094,0.0,785,369,1154
654,ATI,0.034382675,0.082517161,0.008930565,637,517,1154
655,ES,0.048320126,0.04734175,0.029839112,484,671,1155
656,ED,0.049283674,0.045453758,0.032331277,474,683,1157
657,CP,0.037450214,0.068253607,0.007528377,591,568,1159
658,WTW,0.036834282,0.069334903,0.013470614,600,563,1163
659,VMW,0.025375708,0.107290672,0.043451555,736,427,1163
660,NTRS,0.072477556,0.014592674,0.04322071,312,851,1163
661,BOH,0.073516818,0.013316083,0.039210663,306,858,1164
662,VEEV,0.018979777,0.120893179,0.0,787,379,1166
663,AVB,0.050118663,0.041523984,0.039240099,462,705,1167
664,AOS,0.027237564,0.097201952,0.020477286,715,455,1170
665,IDA,0.047402516,0.046775177,0.028239769,494,676,1170
666,MKC,0.029852999,0.089099819,0.01736464,685,488,1173
667,DTE,0.047254711,0.046600906,0.029888714,497,677,1174
668,BKH,0.056640437,0.025918376,0.03435317,403,778,1181
669,EXC,0.050909354,0.039120583,0.031296349,457,724,1181
670,RHP,0.028644642,0.089843225,0.001300182,699,483,1182
671,APTV,0.034444602,0.074137121,0.002497135,635,548,1183
672,HAE,0.027461434,0.092710734,0.0,713,471,1184
673,KHC,0.047344785,0.044597165,0.039270325,496,688,1184
674,AEP,0.047473844,0.044139566,0.033852275,493,691,1184
675,IQV,0.02838384,0.091047118,0.0,705,479,1184
676,CPT,0.054291991,0.029984123,0.032961793,426,760,1186
677,UNF,0.037146654,0.061509632,0.007468919,594,592,1186
678,PCG,0.056146007,0.025569729,0.0,408,782,1190
679,ATHM,0.073842062,0.001611784,0.016010864,302,889,1191
680,AXTA,0.033931329,0.07469905,0.0,645,546,1191
681,L,0.071447362,0.009324143,0.00430661,321,874,1195
682,WEX,0.027724389,0.089747366,0.0,711,485,1196
683,FTV,0.032980038,0.075010446,0.004345225,654,543,1197
684,WAB,0.034808177,0.067180544,0.006103804,630,570,1200
685,DUK,0.049317611,0.038817226,0.04008711,473,727,1200
686,HHC,0.047803957,0.040791981,0.0,488,712,1200
687,AEE,0.046742541,0.043864729,0.026548371,505,695,1200
688,SO,0.046049182,0.045062811,0.03786845,516,685,1201
689,SYK,0.025501233,0.092900821,0.011366326,731,470,1201
690,PVH,0.034959637,0.065138654,0.001761938,625,579,1204
691,KBR,0.02588838,0.091588785,0.008992806,728,476,1204
692,TFX,0.031018572,0.07873937,0.005448723,672,533,1205
693,ANSS,0.024902225,0.094463206,0.0,741,465,1206
694,FMS,0.074981721,-0.008821764,0.044070534,297,910,1207
695,LYV,0.026099458,0.089747553,0.0,724,484,1208
696,AA,0.007168833,0.129467697,0.008748407,851,360,1211
697,AMCR,0.071532711,1.19e-05,0.0,320,892,1212
698,ETR,0.047700273,0.039267511,0.03739005,490,723,1213
699,XEL,0.045267074,0.04405734,0.02638841,523,692,1215
700,INTC,0.073811111,-0.012871129,0.055233994,303,913,1216
701,STZ,-0.000893855,0.13104545,0.013644637,865,354,1219
702,RTX,0.034900871,0.060985386,0.021006335,626,595,1221
703,KMX,0.04421578,0.044030824,0.0,528,693,1221
704,TRNO,0.046118652,0.041321065,0.025016668,514,708,1222
705,BAH,0.022186906,0.096022046,0.01924284,765,459,1224
706,HE,0.052898765,0.024059335,0.033764026,439,786,1225
707,FR,0.04185371,0.045909291,0.024379429,550,680,1230
708,H,0.04610819,0.040221607,0.0,515,717,1232
709,VOYA,0.065102288,0.004853875,0.015190534,349,883,1232
710,PNM,0.040471765,0.047061034,0.028520245,564,673,1237
711,TDC,0.009499924,0.116256158,0.0,841,396,1237
712,CBU,0.055284414,0.018657856,0.027450118,415,823,1238
713,EBAY,-0.055055561,0.141745582,0.021132001,917,322,1239
714,ISRG,0.013966451,0.109002394,0.0,818,422,1240
715,WPC,0.038402945,0.049611723,0.053537374,581,659,1240
716,OSK,0.030013518,0.070239982,0.016793072,683,559,1242
717,MDT,0.031071895,0.06697437,0.029897811,670,574,1244
718,LIN,0.025441111,0.084980769,0.014380025,734,512,1246
719,LHX,0.025338398,0.085483638,0.02061429,737,510,1247
720,OFC,0.059517945,0.012077906,0.042531,386,861,1247
721,XYL,0.017815388,0.097767997,0.01088997,795,454,1249
722,PWR,0.024022499,0.08670169,0.002008017,750,500,1250
723,AMRC,0.032045834,0.06441061,0.0,665,585,1250
724,EXPE,0.025647626,0.080126124,0.004881792,729,529,1258
725,PEAK,0.037048502,0.048778462,0.047975259,595,666,1261
726,SJI,0.034820965,0.054953652,0.052705591,628,634,1262
727,PKI,0.032703896,0.059130452,0.001995733,658,606,1264
728,ARES,0.036539835,0.049264722,0.06962761,602,663,1265
729,DXCM,0.007737724,0.110122734,0.0,848,417,1265
730,MDLZ,0.029582867,0.06492743,0.021612805,689,581,1270
731,DD,0.03101246,0.060928845,0.01905761,673,597,1270
732,CNC,0.025481534,0.075114655,0.0,733,541,1274
733,CCI,0.028585335,0.067007461,0.044405398,702,573,1275
734,SBAC,0.015248091,0.093586375,0.010137196,809,466,1275
735,GHC,0.023018733,0.082229825,0.010539086,757,519,1276
736,WCN,0.024492737,0.079515631,0.007122561,745,531,1276
737,AU,0.036396047,0.045612089,0.024876759,604,682,1286
738,CHD,0.021138735,0.083470636,0.013023381,774,514,1288
739,IR,0.028554665,0.062427913,0.001529967,703,588,1291
740,RGA,0.054387727,0.011149859,0.021565733,424,867,1291
741,WTM,-0.047733659,0.122509876,0.000750529,915,376,1291
742,CAG,0.028241145,0.06242938,0.037387152,707,587,1294
743,AWR,0.022921565,0.077318341,0.01647747,759,536,1295
744,HXL,0.025428131,0.069870389,0.006784862,735,561,1296
745,SPGI,0.030600376,0.055857309,0.009647409,676,624,1300
746,PSO,0.035198626,0.046364414,0.022690024,622,679,1301
747,SCHW,0.045767596,0.025002058,0.013444192,518,783,1301
748,ENB,0.028015543,0.060863616,0.068159026,709,599,1308
749,ELS,0.015186827,0.086668654,0.02591042,810,501,1311
750,EL,0.014313275,0.087860262,0.013160815,815,498,1313
751,PEG,0.033789475,0.048004187,0.035362603,646,670,1316
752,REG,0.032322267,0.050053206,0.040494052,663,654,1317
753,PBH,-0.026341729,0.108194327,0.0,894,423,1317
754,ASH,0.035293796,0.043462898,0.013649535,620,697,1317
755,SAP,0.01515802,0.085398845,0.025337063,811,511,1322
756,CTVA,0.02707192,0.05860576,0.009865791,716,610,1326
757,AXS,0.048527078,0.014023562,0.039066296,479,853,1332
758,KRC,0.038790897,0.032439987,0.054806491,578,754,1332
759,RE,0.046209111,0.018595487,0.01973756,510,824,1334
760,PPL,0.035151822,0.040354793,0.036593232,623,715,1338
761,FRT,0.03260085,0.046536099,0.044443651,661,678,1339
762,AWK,0.029559733,0.05096893,0.016834628,690,650,1340
763,FAF,0.046961099,0.016817127,0.038747371,503,838,1341
764,PLD,0.03799129,0.031492168,0.029031183,586,756,1342
765,BURL,0.015634245,0.076533985,0.0,806,538,1344
766,CUBE,0.022001575,0.065383337,0.042758307,767,577,1344
767,SWX,-0.399947836,0.117238993,0.039579424,954,392,1346
768,EGP,0.029518925,0.049489537,0.030748312,691,662,1353
769,NNN,0.023364909,0.060650559,0.047620566,754,601,1355
770,WHR,-0.188678911,0.110515501,0.049319555,942,414,1356
771,COO,0.028624155,0.049705741,0.000222583,700,657,1357
772,HAS,0.025205212,0.057372435,0.047722694,739,618,1357
773,ROP,0.021539247,0.063287986,0.005732289,771,586,1357
774,ESS,0.029618721,0.04831078,0.041051505,688,669,1357
775,SJM,-0.005515944,0.089659892,0.025990792,871,487,1358
776,BDX,0.028012367,0.050572879,0.017037314,710,651,1361
777,EBR,0.039745458,0.023305989,0.0,570,791,1361
778,TRP,0.013931142,0.074701614,0.061423671,819,545,1364
779,RYN,0.030547613,0.04488238,0.047261806,678,687,1365
780,ICE,0.025214564,0.055726526,0.014874151,738,628,1366
781,GLOB,0.021200348,0.060886047,0.0,773,598,1371
782,CAE,0.022927914,0.057876871,0.0,758,613,1371
783,MHK,0.003869691,0.084306752,0.0,859,513,1372
784,ALE,0.03884243,0.021894476,0.043161543,577,797,1374
785,CAH,0.010574178,0.074863557,0.021269898,834,544,1378
786,BRX,0.023790536,0.055779683,0.042595481,753,627,1380
787,ARMK,0.024225116,0.053266845,0.014090337,746,641,1387
788,FE,0.016953583,0.06223013,0.037206016,798,589,1387
789,STOR,0.028880643,0.044142421,0.042834828,698,690,1388
790,SRE,0.032670095,0.038674918,0.06118897,659,729,1388
791,CCZ,0.019182132,0.059397179,0.018465479,784,605,1389
792,RPM,0.047051424,9.05e-05,0.021025806,500,890,1390
793,CMS,0.045731782,0.010004409,0.029832202,519,871,1390
794,TM,0.009509413,0.072885925,0.002824057,840,552,1392
795,CALX,0.009471033,0.073129065,0.0,842,551,1393
796,ECL,0.026297335,0.0457172,0.014520503,723,681,1404
797,AIZ,0.040678243,0.015862685,0.022089198,560,845,1405
798,TAP,-0.016689504,0.081928075,0.029468384,885,520,1405
799,CIEN,0.020957577,0.055300395,0.0,775,633,1408
800,T,-0.052104944,0.088012,0.074731255,916,494,1410
801,PHI,0.038247414,0.017798812,0.092052788,583,827,1410
802,BFAM,0.021904042,0.052309071,0.0,770,645,1415
803,MET,0.043679779,0.004659406,0.030673905,533,884,1417
804,AES,-0.022963657,0.080540914,0.022328717,892,526,1418
805,NCR,0.018749139,0.055612419,0.00499977,789,630,1419
806,DV,0.012022734,0.060967775,0.0,829,596,1425
807,FLR,0.014893886,0.057878704,0.007957008,813,612,1425
808,SNN,0.018594273,0.054538844,0.027266042,790,638,1428
809,LUV,0.026995474,0.04069465,0.0,717,714,1431
810,CWT,0.029147549,0.035898858,0.016450085,696,738,1434
811,EIX,0.033994493,0.021907407,0.047402515,643,795,1438
812,AZN,0.015663945,0.053526143,0.020789981,804,640,1444
813,CTLT,0.027484981,0.036989931,0.00021183,712,733,1445
814,NE,0.01786417,0.050083564,0.0,794,653,1447
815,F,-0.046098329,0.077984882,0.043035104,914,534,1448
816,TYL,0.012262023,0.056415135,0.0,828,621,1449
817,LUMN,-0.294339177,0.086786993,0.148310438,950,499,1449
818,BSX,0.010545521,0.057522587,0.000830951,835,616,1451
819,TEVA,-0.232436384,0.085963672,0.0,945,508,1453
820,SWK,0.015300259,0.051996392,0.042369949,808,647,1455
821,ADC,0.027321854,0.033007564,0.040819052,714,752,1466
822,ZBH,0.008658883,0.056880018,0.007528813,847,620,1467
823,RBC,0.02489578,0.039025131,0.003420837,742,726,1468
824,ADT,0.025097197,0.036813042,0.018423954,740,734,1474
825,SMG,-0.184394921,0.075939872,0.070048996,941,539,1480
826,HIW,0.019914271,0.042059341,0.072305466,779,703,1482
827,KWR,-0.00598003,0.058633407,0.01010933,873,609,1482
828,BAK,-0.041738787,0.066894241,0.068717822,908,575,1483
829,LXP,0.040571938,-0.035721531,0.050797736,561,923,1484
830,FMX,0.009094439,0.050240494,0.006430797,845,652,1497
831,AER,-0.09817252,0.068646643,0.0,930,567,1497
832,AGO,0.033749285,0.012052485,0.017418986,647,862,1509
833,AMT,0.018059385,0.039948983,0.026901918,792,719,1511
834,DIS,0.018298793,0.039637255,0.0,791,721,1512
835,NOW,0.00416441,0.04867014,0.0,858,668,1526
836,EQIX,0.011742911,0.042164557,0.019197241,830,702,1532
837,NOV,0.019025175,0.034294622,0.009573959,786,747,1533
838,O,0.022404936,0.027129551,0.046732726,761,774,1535
839,STAG,0.018044469,0.034868305,0.046198003,793,743,1536
840,BKR,-0.01983112,0.05128538,0.025492253,888,649,1537
841,NEE,0.019540891,0.030860557,0.02017901,782,758,1540
842,CZR,-0.058860532,0.05635309,0.0,919,622,1541
843,GPN,0.001990468,0.044998931,0.009462393,860,686,1546
844,HASI,0.016366606,0.034545565,0.052133212,802,746,1548
845,AGI,0.009345838,0.041405378,0.008842019,843,707,1550
846,SUI,0.014079099,0.036241487,0.025260929,816,736,1552
847,TMUS,0.014802796,0.03506506,0.0,814,741,1555
848,BEP,0.0197776,0.025670663,0.131134089,781,781,1562
849,AMH,0.016637559,0.029238998,0.025607577,799,765,1564
850,KEX,0.031653354,-3.24e-05,0.0,668,899,1567
851,ALK,0.010664408,0.034599243,0.0,833,745,1578
852,FTI,-0.006661307,0.041669829,0.0,876,704,1580
853,CRM,0.001248303,0.04009156,0.0,862,718,1580
854,ARE,0.022152234,0.019091734,0.03217743,766,818,1584
855,AUY,-0.26170857,0.053687563,0.021493337,948,639,1587
856,PUK,0.02654775,0.010114442,0.012608851,722,870,1592
857,NU,-0.019155678,0.041503281,0.0,886,706,1592
858,NEM,-0.013501686,0.041090111,0.046588823,883,709,1592
859,QRVO,0.010167019,0.029850688,0.0,838,761,1599
860,THG,0.024113276,0.013365497,0.022637377,748,856,1604
861,XRAY,-0.138453287,0.047273289,0.015156991,934,672,1606
862,REXR,0.013813222,0.024020376,0.0239272,820,787,1607
863,DOC,0.011528937,0.026258912,0.063868457,831,776,1607
864,D,0.020012402,0.017578448,0.044474242,778,830,1608
865,IBM,0.012887616,0.024775951,0.046769699,827,785,1612
866,KIM,-0.000947312,0.031730569,0.041784528,866,755,1621
867,ELP,0.010539782,0.023215447,0.020546465,836,792,1628
868,STE,0.005611961,0.026926218,0.009621449,855,775,1630
869,AMD,0.013055609,0.020649883,0.0,826,807,1633
870,UDR,0.006977186,0.023628961,0.039171019,852,789,1641
871,DLB,0.023885853,0.0,0.009678592,752,896,1648
872,MTZ,0.00521754,0.022849629,0.0,856,793,1649
873,NWSA,0.01326567,0.01711819,0.015491453,823,833,1656
874,NWS,0.013117675,0.01711819,0.015318627,825,833,1658
875,KGC,0.005842767,0.02077782,0.029404773,853,806,1659
876,DEI,-0.019465835,0.025772719,0.071413433,887,779,1666
877,KSS,-0.005028051,0.02190561,0.063247592,870,796,1666
878,DLR,0.01316136,0.015901295,0.050525988,824,844,1668
879,WELL,0.004661108,0.020053327,0.037348776,857,812,1669
880,AL,-0.022623223,0.024896966,0.029135467,891,784,1675
881,PGR,0.009518153,0.016667572,0.003440519,839,839,1678
882,VTR,-0.002273985,0.019734699,0.040018428,867,814,1681
883,BIO,-0.289639864,0.037316753,5.444138924,949,732,1681
884,DNB,0.000304138,0.017910697,0.008154706,864,826,1690
885,CCJ,0.007182235,0.016149997,0.00416999,850,841,1691
886,FIS,-0.40769715,0.035129851,0.027768695,955,740,1695
887,INTU,0.01658,0.0,0.006182726,800,896,1696
888,ORA,0.013580145,0.005642424,0.005598425,821,882,1703
889,AAL,0.015352277,-0.003470615,0.429017574,807,904,1711
890,LMT,0.014008177,0.0,,817,896,1713
891,MAC,-0.026878276,0.019071967,0.076955322,895,819,1714
892,MKL,-0.00565648,0.016039782,0.002012127,872,843,1715
893,PRGO,-0.028548965,0.017448024,0.031057086,897,832,1729
894,GRMN,0.010469173,0.0,,837,896,1733
895,GE,-0.011103461,0.013326352,0.008913457,880,857,1737
896,MGM,0.015067298,-0.044057246,0.000295033,812,928,1740
897,HP,0.001776085,0.005704264,0.027433143,861,881,1742
898,KRG,-0.002635575,0.009254169,0.038951173,868,875,1743
899,HL,-0.01205228,0.010295026,0.004173184,881,868,1749
900,PANW,0.00580172,0.0,0.0,854,896,1750
901,RZA,0.000382142,7.5e-06,0.000120155,863,893,1756
902,DNP,-0.006206065,0.002128325,0.077335261,874,888,1762
903,HR,-0.021797281,0.005910976,0.289407754,890,878,1768
904,MBLY,-0.00293913,-0.000531314,0.012079107,869,900,1769
905,KKR,-0.029418469,0.005739273,0.014754561,899,880,1779
906,CDAY,-0.007481307,-0.010136832,0.0,877,911,1788
907,WDAY,-0.007932828,-0.025084465,0.0,878,919,1797
908,TWTR,-0.006502209,-0.038750598,0.0,875,926,1801
909,PRU,-0.036509133,-0.001559288,0.047181433,902,903,1805
910,HUBS,-0.00811317,-0.061186651,0.0,879,930,1809
911,KMPR,-0.095261937,0.003387287,0.025207093,928,887,1815
912,TAL,-0.028933945,-0.023025061,0.0,898,917,1815
913,CINF,-0.029890159,-0.021558984,0.026015509,900,916,1816
914,GPS,-0.04169763,-0.008487085,0.045413261,907,909,1816
915,ENV,-0.025098302,-0.036986143,0.0,893,924,1817
916,ALL,-0.037090697,-0.015065952,0.028035564,903,914,1817
917,AEG,-0.085288416,-0.004058917,0.013895771,925,905,1830
918,CVT,-0.038440373,-0.040667179,0.0,905,927,1832
919,SNOW,-0.015994626,-0.147023158,0.0,884,949,1833
920,LVS,-0.041959969,-0.037271875,0.0,909,925,1834
921,RIG,-0.213789969,5.3e-05,0.0,944,891,1835
922,WYNN,-0.075702347,-0.021294629,0.000154208,922,915,1837
923,PHG,-0.130723182,-0.005098005,0.033286743,932,906,1838
924,GWRE,-0.027876731,-0.103373676,0.0,896,943,1839
925,STX,-0.041305246,-0.068896052,0.045443579,906,935,1841
926,VNO,-0.095872602,-0.011371494,0.1174385,929,912,1841
927,COUP,-0.037241024,-0.092940938,0.0,904,939,1843
928,WK,-0.020453367,-0.215091596,0.0,889,954,1843
929,BAX,-0.094243112,-0.023320024,0.022305371,927,918,1845
930,CS,-1.000265352,0.003799,0.038334834,961,885,1846
931,BA,-0.044589556,-0.075178541,0.0,910,936,1846
932,TV,-0.244532022,-0.005607294,0.020952843,946,907,1853
933,RNR,-0.146270411,-0.028932792,0.012620473,938,920,1858
934,TTWO,-0.058958685,-0.094434037,0.0,920,940,1860
935,NEWR,-0.035128464,-0.43017642,0.0,901,960,1861
936,RCL,-0.166779323,-0.033644267,0.0,939,922,1861
937,DXC,-0.09889235,-0.061831488,0.0,931,931,1862
938,GME,-0.04510329,-0.174096827,0.0,911,952,1863
939,GOL,-0.068362527,-0.103655214,0.0,921,944,1865
940,SE,-0.057471989,-0.112501569,0.0,918,947,1865
941,TTM,-0.077412565,-0.101220175,1.04e-05,924,942,1866
942,HCP,-0.045820091,-0.238307932,0.0,913,956,1869
943,MANU,-0.077097112,-0.107211485,0.022394939,923,946,1869
944,ETSY,-0.045720325,-0.328753009,0.0,912,959,1871
945,WDC,-0.141438963,-0.067649381,0.0,937,934,1871
946,SPR,-0.175895303,-0.062604748,0.001356519,940,932,1872
947,ZNH,-0.197684061,-0.046786133,0.0,943,929,1872
948,PDI,-0.140392909,-0.078679424,0.063101598,936,937,1873
949,S,-0.090332519,-0.225452696,0.0,926,955,1881
950,CEA,-0.30845019,-0.066624281,0.0,951,933,1884
951,NIO,-0.131147633,-0.310257459,0.0,933,958,1891
952,ILMN,-0.138728761,-0.44086929,0.0,935,961,1896
953,LPL,-0.714363331,-0.080366042,0.051992553,960,938,1898
954,CUK,-0.577674136,-0.095819748,0.0,959,941,1900
955,CCL,-0.520081247,-0.106525865,0.0,958,945,1903
956,NEA,-0.392244409,-0.168459055,0.073260271,953,950,1903
957,RNG,-0.260767099,-0.25739584,0.0,947,957,1904
958,NCLH,-0.441786383,-0.114920762,0.0,956,948,1904
959,TEO,-0.491679368,-0.179262728,0.002938504,957,953,1910
960,KEP,-1.747402647,-0.171610531,0.003991992,962,951,1913
961,W,-0.38177573,-0.871352785,0.0,952,962,1914
