,ticker,eps,roce,divYield,fcfYield,eps_rank,roce_rank,fcfYield_rank,overall_rank
0,CVI,0.2525327159581629,0.3712396694214876,0.1487611447711935,0.2252762589691805,10,31,35,76
1,CEO,0.3861131669992614,0.2370224608896081,0.2108444928445225,0.3019693801471993,4,107,26,137
2,PBR,0.2399117991306297,0.221162475855934,0.9180583625798804,0.2809489890521673,11,131,29,171
3,VLO,0.1925256047069078,0.2545248631530379,0.0316408803660928,0.1593593375463063,23,89,75,187
4,TS,0.1912514216379146,0.2347036180577252,0.0310698351451981,0.1876560717108046,24,111,56,191
5,BTU,0.2269880278457772,0.1970460155324998,0.0091440674724602,0.4217925240973072,15,172,16,203
6,HRB,0.1131749028044859,0.3675644816252913,0.0363674274543763,0.1537361584252744,111,34,80,225
7,WU,0.1416310100417743,0.2738509983498094,0.0789604193363885,0.1437351129066122,58,74,94,226
8,ERF,0.1406706333246212,0.3679517067590538,0.0149909549975805,0.1190803640228159,59,33,139,231
9,MO,0.1134141452130721,0.439506807089648,0.094567587995008,0.1268201714799555,110,19,119,248
10,MPC,0.1603278564723698,0.2016145817846629,0.0208835272194668,0.2024923769329269,45,167,50,262
11,CRC,0.1481976641525616,0.2643406268480189,0.0212837070857402,0.1208704353017346,52,80,136,268
12,CIVI,0.1329957386448424,0.259521428072117,0.1119738490732515,0.1237262533772582,69,85,128,282
13,MLI,0.1147620431742703,0.3016465321929781,0.0127283902606533,0.1179860179580934,104,59,142,305
14,HPQ,0.1249264913075971,0.2761265580057526,0.039702351053012,0.1134024723423544,82,73,155,310
15,APA,0.25834672573803,0.5329439252336449,0.027870680044593,0.0698576785533307,9,9,301,319
16,SHG,0.2170850746651896,0.1413014695351873,0.0726280427351298,0.6628703751951701,17,300,9,326
17,TOL,0.1763697532681411,0.178293778710022,0.0117079290118141,0.1534117644518214,36,211,82,329
18,PBF,0.3896797866029486,0.1836749789649848,0.020225846433818,0.1231937919150737,3,195,131,329
19,VIPS,0.1163424598901636,0.2183326539317113,0.0,0.1316388551348747,97,136,114,347
20,DHI,0.1296107125847148,0.2273876822374293,0.0093185778987092,0.1134916484703589,75,122,154,351
21,CIG,0.1795812798315856,0.1587279952229761,0.0567967857621409,0.1676405267279191,33,256,68,357
22,ALSN,0.1285946307442438,0.2031388152077807,0.0,0.1259195567020158,79,162,120,361
23,TEX,0.1335550656817625,0.2549773665024236,0.0111381830838844,0.0856247824573616,68,88,224,380
24,BP,0.1487810200055302,0.1542251925690983,0.0469511073696827,0.173335404500176,51,266,64,381
25,OGN,0.2779478627300982,0.1443107221006564,0.0798794444209666,0.146173949314558,7,289,91,387
26,ACT,0.1431965763006848,0.1638075398142164,0.0458230076967909,0.1359942625921018,57,243,106,406
27,DVN,0.129444807180093,0.2171174844818993,0.0641869366801742,0.090822097164789,76,138,210,424
28,GGB,0.184162241231724,0.1433021189193826,0.065875280483451,0.1256225519654395,27,293,121,441
29,KBH,0.1401223808475298,0.1231240691652011,0.0134930622947793,0.2486381221520654,60,348,34,442
30,WSM,0.0729967632057023,0.3705816841932163,0.0178675526355504,0.1146578472309008,264,32,149,445
31,AMG,0.1266077147730826,0.1441330312770575,0.0002822285215628,0.1621685084899984,81,291,73,445
32,NUE,0.1040890198398974,0.2029524825839077,0.0118363967242541,0.1126689317513264,128,163,157,448
33,SM,0.177985253242366,0.1717501370042287,0.0155844817402293,0.1033797751788679,35,227,187,449
34,MTG,0.1303203846930812,0.149548955818174,0.0224768477181183,0.1299573625358154,74,274,116,464
35,TMHC,0.1329310366169098,0.1461211593145188,0.0,0.1335903939485449,70,284,111,465
36,DQ,0.2161257149716088,0.105803757778126,0.0,0.215953134403251,18,416,39,473
37,VALE,0.1152832692171296,0.1842959800882325,0.07961376214381,0.1063144548389944,102,193,179,474
38,BG,0.1493162984338173,0.1242861181792479,0.0254962738743433,0.1439907059796464,49,344,93,486
39,BMY,0.0755931661517068,0.236525508594318,0.0446871003394015,0.11916874080813,247,109,138,494
40,LEN,0.108672063028391,0.1470021382924115,0.011880084493227,0.1401665378586937,119,280,96,495
41,ESNT,0.1243069560450834,0.1397699791706493,0.0189596909419898,0.1354835613169453,85,303,108,496
42,CBT,0.1145122537118053,0.1890726096333572,0.0226451198351435,0.0903231484333565,106,182,212,500
43,ARW,0.1311349375757246,0.1723020691277076,0.0,0.0903010357461919,72,223,213,508
44,CHK,0.236676326269949,0.2405450926351248,0.0476483550613746,0.0539101512090706,13,102,393,508
45,EOG,0.108065878348331,0.2413845109720232,0.048184232826896,0.0733578618495715,120,101,288,509
46,MRO,0.105965720021384,0.1436146425605315,0.0171154412647151,0.1400602245327689,123,292,98,513
47,AGCO,0.1289879565726598,0.2450406917599186,0.0503663064165397,0.0644168982371572,78,98,338,514
48,CRI,0.0848472250065431,0.1617757269180517,0.0408744663950875,0.1712534489824657,206,248,66,520
49,DFS,0.1029786757082411,0.1176822517312281,0.0263401238546249,0.2893210412755345,130,364,28,522
50,NEU,0.0743427889093973,0.2483896031638699,0.0162567496917217,0.101044051962341,256,93,193,542
51,BHP,0.0855217122292672,0.26819690467217,0.0878184411313302,0.0768973959197916,202,78,268,548
52,MCK,0.0708617696871064,0.3050198426512567,0.0058122575136615,0.0915828658231395,284,56,209,549
53,SIG,0.1800039670173382,0.1342098734805259,0.0161701490607875,0.0936002859095586,32,313,205,550
54,AB,0.0753782743415154,0.3935760562973516,0.0844958316371243,0.0742837680111773,250,27,278,555
55,MAIN,0.1209872535893505,0.1422505046020529,0.0766956405053927,0.1044504717763236,87,296,183,566
56,OC,0.0895509670418747,0.2032985526758667,0.014076573414609,0.089326340870365,188,161,218,567
57,ICL,0.1001594716816052,0.1369539291413953,0.0733780364406196,0.1281496808099534,141,311,117,569
58,BBWI,0.0886277834978701,0.3073790129372304,0.0183715906567338,0.066218480608887,193,54,325,572
59,PII,0.0929155239332316,0.1756315422191207,0.027220478670177,0.1016748633016389,177,212,191,580
60,MPLX,0.1068648127471657,0.1277392714938799,0.089670677905972,0.1214199743611508,121,333,135,589
61,SU,0.149504545142688,0.1099288084923108,0.049546473128059,0.1174408217178728,48,403,144,595
62,TPR,0.0925091323117795,0.2010874226026105,0.0279998260512042,0.0781781235668991,179,169,259,607
63,BYD,0.0977344073788631,0.1704783956840468,0.010026705330225,0.0852095771594965,155,230,229,614
64,SKM,0.1818389639208223,0.0755861331989232,0.1286637399548064,0.3074868279127901,31,562,24,617
65,INGR,0.089767108103052,0.1635434412265758,0.0270836998009208,0.1034485647035172,187,245,186,618
66,MSM,0.0603673162644108,0.2553087616073907,0.031080374828951,0.1067739222733389,356,87,176,619
67,CPG,0.113919697686426,0.0967532581431653,0.0423278694367064,0.1948000862419825,108,460,52,620
68,RDN,0.1335842213011725,0.108893956331451,0.0323170163128859,0.113657742358242,67,406,153,626
69,HP,0.1005055254284397,0.1417828552683871,0.0466423430792714,0.1014598764439108,137,298,192,627
70,EXP,0.0854678625296141,0.1889363902600859,0.006943499964056,0.0799204327124809,203,183,247,633
71,GIL,0.0935752208774535,0.2307069378020433,0.0231135600771875,0.0593805784764105,170,115,360,645
72,EME,0.0620434267093594,0.2840511282067539,0.0032035490993101,0.0804955911564535,338,67,244,649
73,GEF,0.0978637404203692,0.1205814995519267,0.0317403278367845,0.1187605914511106,154,357,140,651
74,G,0.0997367134188203,0.1808763222232129,0.0158019622115783,0.0682604509776557,144,203,307,654
75,MAS,0.0602501575926478,0.3675027262813522,0.0170531833714873,0.0776351149596894,358,35,264,657
76,MKL,0.1053251707935347,0.1048705585345818,0.0018995952769792,0.1334037217809911,125,421,113,659
77,MTH,0.115808833500041,0.2224262739395764,0.0061974941706652,0.0497536474904067,100,129,439,668
78,PGR,0.0418879314927088,0.9288725792096668,0.0029797278040118,0.1115390689114865,511,2,160,673
79,MTCH,0.0647285396381946,0.2306008020888716,0.0,0.0823964359410352,323,116,236,675
80,EBAY,0.1196871782893427,0.1191228070175438,0.0228387532116996,0.0852127723997127,90,359,228,677
81,HIG,0.1014393613403737,0.0946333352445387,0.0222404989520228,0.1622462628467239,134,475,72,681
82,PSX,0.1170510665741241,0.1328024142845167,0.0314027237765504,0.0769383418351085,95,320,267,682
83,RNR,0.2751352830943507,0.0552126920315601,0.0118693109231564,0.3545661079162256,8,653,21,682
84,KT,0.2290342841695347,0.0558612306535879,0.1214720416700468,0.3067933057001538,14,648,25,687
85,AMAT,0.0622903515370889,0.3276961938605129,0.0088583857568059,0.068995468140702,337,45,305,687
86,NVR,0.0702121926932845,0.2914729512268396,0.0,0.0649928548158094,292,64,332,688
87,TX,0.08272382849241,0.1156376749896969,0.0696612697270751,0.143265280294897,220,375,95,690
88,CINF,0.1134627247553133,0.0962815685942721,0.0279501231898601,0.125221477022413,109,463,123,695
89,DKS,0.0815311375917152,0.1908192904043095,0.0273610102189716,0.0732254741697872,228,179,289,696
90,MUR,0.0998992237408088,0.1168174040083621,0.0258186639086702,0.1030976768765897,143,370,189,702
91,THC,0.0795483918795892,0.1030485733695652,0.0,0.2113044844853901,234,434,42,710
92,CF,0.0992363680140037,0.1633028874484384,0.0202377117720361,0.0670902920802871,147,246,317,710
93,HAL,0.0811721030128758,0.2140498034076015,0.0177237040695286,0.0639714943759548,230,145,339,714
94,CPA,0.1150297472490403,0.205729490330008,0.0300166518243702,0.0480872347052798,103,158,455,716
95,RS,0.0818908640852786,0.1792522825168483,0.0145955645921886,0.0737134247043548,225,207,284,716
96,TNET,0.055317811892887,0.38130081300813,0.0,0.0693316575724183,385,29,303,717
97,CNQ,0.0869708176337904,0.1527145359019264,0.0411032978759964,0.0786360702618651,197,267,254,718
98,CAT,0.0684577165995198,0.2621142033821187,0.0169769838069249,0.0648675780028154,301,84,333,718
99,OMC,0.0755532114781519,0.1783855711694607,0.0326201120990992,0.077883633561649,248,209,262,719
100,FITB,0.0995461517416079,0.0926388403772266,0.0449207836722453,0.1480690737271937,145,485,89,719
101,ABEV,0.0677884797711993,0.1821751483982742,0.0557283857276813,0.0874465732957854,305,199,221,725
102,TROW,0.074117416623293,0.1726665028678906,0.0464792901136846,0.0797817822812592,257,221,249,727
103,XOM,0.0888874714725768,0.1395365288214507,0.0368805251672249,0.082568339926623,191,304,235,730
104,CSCO,0.0591592001608597,0.2130757126858795,0.0295584935712152,0.0892899146485599,363,148,219,730
105,AYI,0.0674507106076621,0.1682840993921296,0.0032750634052275,0.0996944896091283,308,234,195,737
106,BSMX,0.1662143730347077,0.0557874049963975,0.1122367639037054,0.2036119791749009,41,649,47,737
107,SON,0.0864869220540145,0.1151204311494886,0.0359481601658571,0.1092888457285333,198,380,167,745
108,AAL,0.091530338351984,0.097692457800761,0.0,0.1344003873367941,180,455,110,745
109,PCAR,0.0899316804223551,0.1869490310491832,0.0296840223198984,0.0572237424874901,185,189,372,746
110,MMP,0.0984795158046129,0.11403282632981,0.0826680613180367,0.0917900542910615,150,389,207,746
111,MUSA,0.0726556791723967,0.2294890673186453,0.0043582968469074,0.0585107876093798,266,117,363,746
112,RRC,0.1207595855587781,0.1661948958124238,0.0107073142474425,0.0515207277889622,88,240,423,751
113,T,0.1195048714003099,0.0695861299738995,0.0675202523411751,0.1698048037306765,92,593,67,752
114,DVA,0.0727077423696902,0.1068955656317179,0.0,0.1572845937915209,265,413,76,754
115,PAA,0.1161489539511891,0.0642000715819613,0.093391313380265,0.2047243350944536,98,613,46,757
116,HCA,0.0710930863046068,0.2210258058591238,0.0089646184752661,0.0635660617149355,283,132,343,758
117,NTAP,0.0933529613918824,0.1602897181546213,0.0316550073165566,0.063603116552711,171,252,342,765
118,CMC,0.1304583237437719,0.0825540344205211,0.0113706440728381,0.1118974194484038,73,533,159,765
119,HOG,0.1347108320743169,0.0843110495426716,0.0183615302837552,0.104377797573888,65,525,184,774
120,MTDR,0.1248957164005355,0.1723468067071516,0.0113924159272254,0.0469451678437885,83,222,474,779
121,WES,0.0912090284696272,0.1154765265902972,0.0873021452663012,0.0861280102443178,181,377,223,781
122,WRB,0.0720767206258035,0.1034547481779871,0.0261650331435441,0.1529012602060409,271,431,83,785
123,RIO,0.0833102486581483,0.1632381120190295,0.0535909036407059,0.0668768092728067,218,247,320,785
124,AMX,0.0775660837912265,0.1680638596365067,0.031049094622496,0.0685987093132953,244,236,306,786
125,KSS,0.109159779614325,0.0629112924453803,0.0757575757575757,0.2035123966942149,118,620,48,786
126,SNA,0.0661730423421081,0.197764753986643,0.0232728057134345,0.0693210230924349,314,171,304,789
127,SWKS,0.0625379965417022,0.1525444412805597,0.0257838789160538,0.1031036994266586,336,269,188,793
128,EQT,0.1178372083888125,0.0995520180479759,0.0155061861043901,0.0787612988770688,94,447,252,793
129,MOH,0.0523321955677652,0.2339381320642474,0.0,0.0756922132043387,410,113,271,794
130,COP,0.0784862869857126,0.1749322035870995,0.0399916893530376,0.0624409020401987,238,214,347,799
131,BBVA,0.161815070023158,0.035747844186738,0.0566625161023853,1.520363466245769,44,755,3,802
132,QCOM,0.0586297675295668,0.1880614314691393,0.0280664069672788,0.0798457660949534,369,185,248,802
133,LRCX,0.0536776948296611,0.3545219903779786,0.0108036134624345,0.0556582309650518,396,37,382,815
134,SEAS,0.0687352551628028,0.2076457987354858,0.0,0.0587223942892859,298,156,362,816
135,CVE,0.0983420710762317,0.1147049575516193,0.0245556011010498,0.0739540033160272,152,382,283,817
136,KR,0.0653213605678732,0.1445989491102273,0.02402763540297,0.0897112216301845,317,288,216,821
137,OLN,0.0677531412385044,0.1226839126919967,0.0148697680684244,0.1086965323259188,306,350,169,825
138,JNJ,0.0931734953619928,0.1801922886638741,0.0311965419853399,0.0483665673872968,172,205,450,827
139,EPD,0.0966588738507343,0.1117871774040206,0.0751500029703558,0.0751849483332809,161,394,273,828
140,LOW,0.0604807239024423,0.4150712537786095,0.0198131908098733,0.0483470037304535,355,21,452,828
141,DE,0.094592819133989,0.2454976754518191,0.0132779808089909,0.0383451709277168,169,97,563,829
142,CB,0.0972310167657141,0.0710381281062263,0.015013296120005,0.1485820898648419,158,586,88,832
143,PRI,0.0779412247514125,0.1159983855895872,0.0126677925941485,0.0890280270859317,241,374,220,835
144,FLT,0.0474931852159662,0.1956084845510068,0.0,0.0941897305226687,458,174,204,836
145,PVH,0.0900404612199152,0.0976741971576165,0.0012754375157733,0.0983308050724421,184,456,197,837
146,LMT,0.0609981992132783,0.2395056167121822,0.0269379330629737,0.0549071940606229,348,103,388,839
147,UBS,0.2792164894916507,0.0178502453960993,0.0168331951833566,0.481795900435906,6,826,14,846
148,ABM,0.0967863690283619,0.1102050702405942,0.0221457071990879,0.0734467193541926,160,402,286,848
149,FIX,0.0439196725461511,0.2626185483982948,0.0041256771293561,0.0739780803408335,485,83,282,850
150,PM,0.0535092419699838,0.2969091236093625,0.0545434024125114,0.0539886540956588,398,61,392,851
151,FANG,0.1125948421319504,0.1699326962406574,0.051729860654959,0.0432037478877289,112,231,509,852
152,AIT,0.0620364411343361,0.2147769302420167,0.0095622345131806,0.0568033872617166,339,142,374,855
153,MFG,0.5835575425503828,0.0119364178458961,0.2200256912624869,9.122247070863349,1,853,1,855
154,SEM,0.0841665175982792,0.0861449619525408,0.0220894289341307,0.1219709519723259,209,517,133,859
155,VC,0.1384737683385142,0.155902004454343,0.0,0.0404594137943807,62,260,540,862
156,GILD,0.0560333640354625,0.1842462385681974,0.0376753898695634,0.0734022232139748,381,194,287,862
157,UL,0.0587872738867165,0.1925783035684214,0.039538904881724,0.0662509794029247,365,177,323,865
158,SYF,0.1391304088345198,0.0256414784466773,0.027850948685373,0.5342035760120775,61,794,12,867
159,CVX,0.0764881306485566,0.1310218246183089,0.0405760423525685,0.0708004691014296,245,323,299,867
160,KB,0.225392282388786,0.0146546320170494,0.0560520685717412,0.6330539796742667,16,843,11,870
161,FOXA,0.0734448105817433,0.1140694912445451,0.0177239696238428,0.0855374186194154,258,387,225,870
162,FOX,0.0734448105817433,0.1140694912445451,0.0177239696238428,0.0855374186194154,258,387,225,870
163,AZO,0.0556769540254107,0.4648081046590444,0.0,0.0472146240829108,383,15,473,871
164,SAN,0.1828571758569689,0.015723563529772,0.0373275618104556,1.1047868681087492,29,838,4,871
165,FMS,0.0884615192009559,0.0538136554972716,0.0582578448855919,0.344666055984494,194,656,22,872
166,RF,0.1143349827560354,0.0668632982816106,0.0487880712338916,0.111137572437882,107,605,162,874
167,MCHP,0.0485269594508319,0.2351396424609672,0.015078337089942,0.0679815491292255,453,110,311,874
168,AGO,0.1691047653219443,0.0531512259338489,0.0153315551780382,0.1054902527921736,38,662,181,881
169,IHG,0.0486715268971836,0.3987800228745711,0.01589936545308,0.0526301444181546,449,25,410,884
170,THO,0.0605988136207943,0.1076411509522851,0.015538493616588,0.1252287401590118,353,410,122,885
171,BBY,0.0753138496829019,0.2431283649759138,0.0486111149041132,0.0409644226720055,251,99,535,885
172,BAM,0.1383061258860971,0.2012280200847394,0.0320948961552157,0.0311853230484761,63,168,659,890
173,CTRA,0.0842269161234678,0.1011566771819137,0.0461304340614685,0.0808060075301454,208,442,241,891
174,DAL,0.1792898968645468,0.1169059416423156,0.0049791943585727,0.0443848497119652,34,369,495,898
175,CSL,0.0492230500112987,0.1818466238474704,0.0102820627010831,0.0784592582405793,442,200,256,898
176,SKX,0.0566558424744297,0.1333199920359929,0.0,0.0941956489599312,379,316,203,898
177,SAIC,0.0696306553558454,0.1782964388835418,0.0115321211176347,0.053865223954522,294,210,394,898
178,LKQ,0.073190162116209,0.1153813451237139,0.0236147745289478,0.0780382284102314,262,379,260,901
179,BERY,0.0819055783347506,0.0777153558052434,0.017080473642879,0.1245395164827243,224,554,125,903
180,LYB,0.0684120255007928,0.1022780569514237,0.0521018737257693,0.1103847771916766,302,438,164,904
181,WNS,0.0581030233091657,0.1665285170722938,0.0,0.072533010389244,371,239,294,904
182,AFG,0.0846078886131188,0.0574898785425101,0.0679246429710953,0.1884809537414313,207,642,55,904
183,KLAC,0.0500691001583691,0.3867263855079352,0.010828290610899,0.0491960592872936,437,28,443,908
184,BC,0.0618977156444856,0.1640987852804573,0.016490352407665,0.0654166390600499,340,242,330,912
185,GPK,0.0951675172071558,0.1553692056836711,0.0161903245041219,0.0447537425317192,165,261,491,917
186,VZ,0.0731568892133587,0.0881595684825949,0.0694467628359979,0.1178421804204851,263,511,143,917
187,ORAN,0.0887341066562594,0.0568015191942501,0.0677143059811291,0.1536481969765147,192,646,81,919
188,SNX,0.0686551594184035,0.085058196068629,0.0142777009081272,0.1376984343507777,299,520,100,919
189,FBHS,0.0511725406502265,0.1146217798158297,0.0147761501803373,0.133567289044522,425,383,112,920
190,AFL,0.094725402312294,0.1047113501414493,0.0196404246906366,0.0648581312247731,168,423,334,925
191,CMCSA,0.0851343045106022,0.1037963074265514,0.0263679552441857,0.0717068963323313,204,427,297,928
192,CCZ,0.0851343045106022,0.1037963074265514,0.0263679552441857,0.0717068963323313,204,427,297,928
193,AON,0.043294304857084,0.3365290867728306,0.0082569871587808,0.0537464010764814,494,40,396,930
194,KMB,0.0429760914063458,0.2250816208949491,0.0386882274111548,0.0676313093786938,495,126,313,934
195,GPS,0.0684884783824713,0.0782586814292903,0.0302877334679454,0.1517115298034026,300,550,84,934
196,HSBC,0.1490112964657785,0.0118054599346315,0.0772252484467188,0.2242546243841419,50,855,36,941
197,BDC,0.0744018591959855,0.126709881163331,0.0026045048770487,0.0621878407963446,255,337,350,942
198,GIB,0.0517490537803789,0.2098209562745994,0.0,0.0572699396650311,421,153,371,945
199,AM,0.0618961821293585,0.1074501649405167,0.0,0.0990682535722825,341,411,196,948
200,ABG,0.1281404240395263,0.1469994645578483,0.0,0.036304681134518,80,281,588,949
201,OKE,0.0781885290988065,0.0938567330024136,0.0540762335512241,0.0845694658473739,239,480,231,950
202,STM,0.0929721070325961,0.2198523379819524,0.0049234813270645,0.0321461381713274,175,133,644,952
203,CVS,0.082236388221983,0.0805856724854725,0.0308682128369188,0.1024505339846014,222,541,190,953
204,DCI,0.0468854497514208,0.2384191450275557,0.0149489839787139,0.0557189402842972,470,104,381,955
205,PYPL,0.0626852525635478,0.1491988130563798,0.0,0.0623014050443174,334,275,349,958
206,HD,0.0426150074730339,0.3978538017059524,0.0235912043615164,0.0505031317513746,500,26,433,959
207,SIVB,0.1231651542960531,0.018441473093547,0.0120071292764692,0.1951342665850745,86,824,51,961
208,DB,0.1689117644014381,0.005020788948369,0.024107668761085,0.2048756637007617,39,880,45,964
209,CTSH,0.0557381304130677,0.1943234323432343,0.0154944661684492,0.0527755675077636,382,176,406,964
210,SLB,0.0566770500424774,0.1686823679185232,0.0177596181075286,0.0612888870909017,378,233,354,965
211,ULTA,0.0518168117579405,0.414448901161326,0.0,0.0417823704967869,419,22,524,965
212,TGT,0.0616290732546726,0.1611283701320315,0.0299507168475463,0.056818490687911,344,250,373,967
213,ITUB,0.1001716470500418,0.0242858930913029,0.0313117717466797,0.3259867709301361,140,804,23,967
214,RE,0.165097334619304,0.0,0.0,0.2986444833220864,43,898,27,968
215,PAGP,0.0636604774535809,0.0585367921329264,0.0671971706454465,0.6954424885459368,327,635,8,970
216,TKR,0.0688875320826672,0.1295952982013253,0.0164309262008899,0.0624724789808304,297,329,346,972
217,AOS,0.0450247167935914,0.3338622939257692,0.0148437576924614,0.0483493949470528,480,41,451,972
218,BWA,0.0748872497567662,0.1085532472393786,0.0155765479494073,0.0676980737801166,253,408,312,973
219,MOS,0.0984088582671677,0.0698414852472193,0.0297025964174917,0.0848838705355396,151,592,230,973
220,RHI,0.0443131325420359,0.2120711074868304,0.0221928879807431,0.0636984709185327,482,151,341,974
221,IBP,0.0473341694488339,0.2270475258425592,0.0122559954543349,0.0541128420535295,461,124,391,976
222,AXP,0.060815614812168,0.0894251543866215,0.0129271309249652,0.1234323130341065,350,505,129,984
223,EXPD,0.0396865483631862,0.3333808612267091,0.010649508196182,0.053444265038289,543,42,399,984
224,NVS,0.0707964743054875,0.1328121813608864,0.0345877724637247,0.0558028775586351,288,319,379,986
225,PNC,0.0898303160407022,0.0407282286359834,0.0463484491870098,0.1628315391695124,186,732,71,989
226,KEYS,0.0486538488094306,0.2047030449201085,0.0,0.0557885191646451,451,159,380,990
227,MTB,0.1201941740784931,0.0178321540493131,0.0424472676059764,0.160010412700628,89,827,74,990
228,FHN,0.1155111278552882,0.0226062313718464,0.047260405711138,0.1559464613520112,101,812,77,990
229,JBL,0.0537526301332776,0.2284143260514192,0.002957051779948,0.0462614322907425,395,120,479,994
230,CNC,0.067014382538238,0.0611371935315597,0.0,0.1799120395752697,311,627,58,996
231,GPC,0.0677195384075561,0.1722703448112651,0.0270911279788755,0.0474740545921664,307,224,467,998
232,SUN,0.06171884844643,0.1108270951250684,0.0736260217801464,0.0781904382247377,343,399,258,1000
233,BNS,0.1103982989326005,0.0075642917700254,0.0807799698802375,0.466056624454738,115,870,15,1000
234,ADM,0.0891453563280405,0.080152353415441,0.02500574594674,0.0759130424544841,190,543,270,1003
235,UNM,0.1443615182940733,0.0225586558061614,0.0311595082717617,0.1200951094703772,55,813,137,1005
236,SYY,0.0470198313418756,0.2127729345707693,0.0264563650450691,0.055099052211219,468,150,387,1005
237,SEE,0.0647768611590658,0.1544205495818399,0.0223571192349352,0.0515787653257199,321,264,422,1007
238,CE,0.1158949770238021,0.053762486126526,0.0180346775470712,0.0787021502136125,99,657,253,1009
239,WMB,0.0749491634371003,0.0887236361305211,0.0513728301759804,0.0794758194232354,252,507,251,1010
240,CM,0.1116300382203067,0.0078275630578805,0.0505296329161388,0.2489606858406842,113,869,33,1015
241,HPE,0.1013583520783717,0.0592271271015848,0.0309831209563022,0.0800856115187135,136,633,246,1015
242,MFC,0.1018070498119174,0.0063041440947221,0.0553854204724544,0.636913699692825,133,874,10,1017
243,WFC,0.1054434152305835,0.0116243959730461,0.0326653146127552,0.222311427848495,124,857,37,1018
244,AMCR,0.0715327111989646,0.140370473796891,0.0493493799588277,0.0501684568046174,280,302,438,1020
245,OXY,0.0706292740598904,0.0724020968239284,0.0257090557578001,0.1141934103000308,289,582,150,1021
246,CPB,0.0626269143909058,0.1333875559170394,0.032627308546311,0.0564226163451867,335,315,375,1025
247,SNV,0.0988333563054697,0.0232779401835527,0.0458099391322458,0.1645346660898865,149,809,70,1028
248,BKNG,0.033456443581077,0.5303305484925536,0.0,0.054595861185348,627,11,390,1028
249,GL,0.0838637241636061,0.0488585725974277,0.0072667985452002,0.1237861068650222,214,689,127,1030
250,LEA,0.0689142007937427,0.0972829879379285,0.0218960578591821,0.0749690205316034,296,459,276,1031
251,NFG,0.1001254569691397,0.1010372295873613,0.0369741027257922,0.0477056546316729,142,443,462,1047
252,WCC,0.0861538447686665,0.1204883272649389,0.0150811433037247,0.0451196294810691,199,358,490,1047
253,HSY,0.0487744569509194,0.2938091911835386,0.023291576971915,0.0406608854390109,447,62,538,1047
254,PKG,0.0527168574965927,0.1466050395892695,0.0309260289208317,0.0580629475929539,404,282,366,1052
255,ASGN,0.047211944169777,0.1155689573083637,0.0,0.0897737378878112,464,376,215,1055
256,F,0.0891955411668098,0.0317733832424219,0.1024917709059616,0.1371071097484755,189,767,101,1057
257,AVGO,0.0403358456112712,0.2476014421901735,0.0218979931613526,0.0505071698383429,534,94,432,1060
258,CRH,0.0634775756375861,0.1117577958137548,0.0187756202326403,0.0639170050472862,329,395,340,1064
259,ALLE,0.0485270766091139,0.2191967324710687,0.014251012320256,0.0463719140654079,452,135,478,1065
260,TAP,0.0717702263609795,0.0645439246045102,0.0268277998632515,0.1064565218706698,276,612,178,1066
261,WHR,0.0718194509768789,0.1097066769587032,0.0573361105511881,0.0546484803691012,274,404,389,1067
262,INFY,0.043550377232649,0.3283995926357424,0.0244240934141052,0.041133217579486,491,44,532,1067
263,GWW,0.0442304198351934,0.4061114629512349,0.0094796744534695,0.038353988987762,483,23,562,1068
264,BAC,0.0980863771387648,0.0127575295171476,0.0336153463722404,0.1664009585689579,153,849,69,1071
265,PAYX,0.0411801409173686,0.4288335794136258,0.0310708698246375,0.0411563419532476,521,20,531,1072
266,ALV,0.0521025181104295,0.208517570397952,0.0240226774074726,0.043667889154028,413,155,505,1073
267,COF,0.0974665323023274,-8.903668979394685e-06,0.0231151444523015,0.3911824359684571,157,901,18,1076
268,CHTR,0.0785767710195841,0.0937385709700774,0.0,0.0601783916739847,237,481,358,1076
269,HBAN,0.106039344038161,0.0125246360226333,0.0561992218018752,0.1368021675776788,122,851,105,1078
270,SQM,0.1170079803379941,0.309165907044967,0.0855197776664004,-0.0752214880571243,96,52,932,1080
271,WIT,0.0441378096130443,0.1508431657298158,0.0020851690377799,0.0662179035213407,484,271,326,1081
272,VIV,0.0571190141761489,0.0786639482528806,0.0435271598915252,0.1132817875931115,376,549,156,1081
273,CMA,0.1195886476302172,-7.350238882763689e-05,0.0534823236847963,0.1490446482383411,91,905,87,1083
274,BKH,0.0725381433887098,0.0568918710656408,0.0465051941405115,0.1075622812720457,267,645,173,1085
275,POOL,0.0339061772065261,0.2811562253744588,0.0108517730117827,0.0536645030160257,620,69,397,1086
276,UNH,0.0458097458479148,0.1804071119139612,0.0138385099717506,0.0525662791147021,472,204,412,1088
277,GFI,0.054445980023,0.2071869652863904,0.0,0.0403254812938728,391,157,543,1091
278,CFG,0.1021311481477181,3.702716981472869e-05,0.0589413591300263,0.1771416493681503,132,897,62,1091
279,IBM,0.0503393822935649,0.1038666930379746,0.0405291747604815,0.0813334647800987,431,425,239,1095
280,TGS,0.0349484365829303,0.2097002892120087,0.0,0.0647888522685565,606,154,335,1095
281,WTM,0.1338727584172928,-0.0109022899370495,0.0006835608245973,0.1369750731918349,66,929,102,1097
282,YUM,0.0434966632584747,0.4648768671780379,0.0184663354347187,0.0358976845176391,492,14,592,1098
283,EXPE,0.036219796747198,0.1479866112181762,0.0,0.0838008848203678,590,276,233,1099
284,BBD,0.078846531808997,0.0105076438805321,0.0,0.9656017608957462,235,860,5,1100
285,PBH,0.0586945748301028,0.1056926930371884,0.0,0.0671163641009592,367,417,316,1100
286,ZION,0.1049106716795289,0.0156939676311917,0.0435070726670987,0.121881515627688,127,839,134,1100
287,BBDO,0.078846531808997,0.0105076438805321,0.0,0.9656017608957462,235,860,5,1100
288,ALLY,0.0961630480002605,0.0057013865814359,0.0450646440628672,0.179504356267153,164,876,60,1100
289,AN,0.152447854801443,0.2228636390480127,0.0,-0.0746040476390961,46,127,928,1101
290,CNA,0.1049770170027049,-0.0022869826962853,0.0685617530133848,0.1912236948721471,126,921,54,1101
291,WF,0.087185741649674,0.0084640378881941,0.0340344624785905,0.213564394443917,196,866,41,1103
292,DECK,0.0433762064710852,0.3170505672415744,0.0,0.0383048138523203,493,47,564,1104
293,IPG,0.087612498787591,0.1659169240410008,0.0382148107876319,0.0299433103103256,195,241,669,1105
294,DOV,0.0491318909403122,0.1544121228518116,0.0132169560218483,0.0531730306716466,443,265,402,1110
295,RY,0.0964435662876628,0.0098587652696299,0.036016242636129,0.1515486122384171,163,862,85,1110
296,TEL,0.0490851782036109,0.1335729607513479,0.0186318084804282,0.0616777108317624,444,314,353,1111
297,HII,0.0657359003733335,0.0954417695221801,0.0193056976133138,0.0654463149091338,316,469,328,1113
298,OTIS,0.0381982613651102,0.6008796041781198,0.0146435724578907,0.0404532085153976,568,5,541,1114
299,PBA,0.0708610630042341,0.0716739803381297,0.0630009113083815,0.0803570838347564,285,584,245,1114
300,ENB,0.0631440221663168,0.0703937294368422,0.0778004524446236,0.0951087072687618,331,589,202,1122
301,ORI,0.072013448561228,0.0517117755297735,0.0331435099876684,0.1059148682146762,273,673,180,1126
302,CL,0.0348738190928822,0.3545314109165808,0.0265192650406308,0.046094091322766,608,36,483,1127
303,ADP,0.0375245568915668,0.5450301094668064,0.0209354473912036,0.039988068246699,575,8,545,1128
304,ATHM,0.0833574144675622,0.0441540458642302,0.0201278840165362,0.097260777305861,217,715,199,1131
305,RGA,0.0840946133391211,-7.252382925818484e-05,0.0204176500235781,0.3842060993021265,211,903,19,1133
306,RZA,0.0840946133391211,-7.252382925818484e-05,0.0204176500235781,0.3842060993021265,211,903,19,1133
307,WYNN,0.0712052378480647,0.0800396311592741,0.0082650452176046,0.0682271762246277,282,544,308,1134
308,ARMK,0.1032667891004436,0.0728744221272136,0.0175577500429578,0.0512058404960059,129,580,426,1135
309,GPI,0.1442911087871243,0.1867549920279401,0.0060441089452053,-0.0292371777944655,56,190,889,1135
310,GRMN,0.0524196028269275,0.1497569822191007,0.0227121831679632,0.0480135281462919,407,273,456,1136
311,VRSN,0.0383917103957764,1.7851917930419268,0.0,0.0379409271034581,563,1,572,1136
312,VOYA,0.0834112728266625,0.0046815998355981,0.0217536599531936,0.2186042638241172,216,882,38,1136
313,EMN,0.0839227640215788,0.0909015509662436,0.0352963750247356,0.0507854757669733,213,494,430,1137
314,KMI,0.0606733293138204,0.0668192291415226,0.064175177680741,0.1052077052844414,351,606,182,1139
315,GOOGL,0.0418271495524503,0.2629406883816107,0.0,0.0393899011877164,512,81,549,1142
316,ORLY,0.0408412943115793,0.4592844034133589,0.0,0.035293387882586,528,16,599,1143
317,CNHI,0.1461436806264392,0.1727483799424749,0.0331612400577917,-0.0177517418896729,54,219,875,1148
318,GOOG,0.041459125246447,0.2629406883816107,0.0,0.0390433214852204,519,81,552,1152
319,AXS,0.0798190609568707,0.000412924138704,0.0390353839374425,0.2597229160372977,232,890,31,1153
320,TJX,0.0400370624715986,0.3004767827529022,0.0132800627420322,0.0387931751932007,541,60,554,1155
321,V,0.0366873609597598,0.3115680776249611,0.0079670173658345,0.0418337440782394,582,51,523,1156
322,ENLC,0.0367278250857813,0.0944512610770279,0.0420713495890473,0.1383972846345884,581,477,99,1157
323,ITW,0.0373061625036757,0.3725906114543945,0.020375195280161,0.0389084224421156,577,30,553,1160
324,DGX,0.0553017116333043,0.1106742033259605,0.0203334162211446,0.0559492726594554,386,400,377,1163
325,MAR,0.0453440600053551,0.21572130415364,0.0086334619601503,0.03997572335211,478,141,546,1165
326,K,0.0497353202358426,0.1425054445601742,0.0418383345832535,0.0506243848457368,440,295,431,1166
327,MGM,0.0720250506175594,0.0403411812912945,0.0,0.1109190067541586,272,735,163,1170
328,DRI,0.0499439675377944,0.1447236907070001,0.0299999511699675,0.0484129425628605,438,287,449,1174
329,L,0.0905855854000596,-0.0277387951197926,0.0036006822648559,0.2034701328965078,182,943,49,1174
330,CSX,0.0533631266684056,0.1391083379459568,0.0126692537608435,0.0469423143882502,400,306,475,1181
331,NXPI,0.0471312234877112,0.1816026084379013,0.0169517378722336,0.0422445396080414,466,201,517,1184
332,CI,0.0586778444915174,0.0520512045156738,0.0164761569544346,0.1163557566989037,368,670,146,1184
333,EPR,0.0474573593791265,0.0683914079339505,0.0746623949942229,0.1239467883884885,460,598,126,1184
334,APTV,0.1182519207364056,0.0794637851062745,0.0012879719072719,0.0398466308812258,93,545,547,1185
335,SLF,0.0830891861631323,0.011582799968333,0.0467765026500194,0.1352094444293868,219,858,109,1186
336,PSA,0.0401414190410277,0.1674934226427251,0.0430748654308678,0.0520471810364028,537,238,418,1193
337,HUM,0.0438922160903148,0.1432191291934332,0.0076004600783148,0.0524978414226063,486,294,413,1193
338,ACN,0.0336557245033651,0.2650685469580564,0.0138480978221482,0.0440613573578484,623,79,498,1200
339,WMS,0.0382413091063205,0.2523172492825511,0.0032994251868106,0.0400562741920349,566,91,544,1201
340,TXT,0.05734244128544,0.1033819522359352,0.000996177047304,0.0537935605544192,374,432,395,1201
341,BOH,0.0601592135920154,0.1081085005208789,0.0420519235113121,0.0503072032680744,359,409,434,1202
342,CDW,0.0360914528589346,0.2143294315660622,0.0105074726923367,0.0474061870613824,591,143,469,1203
343,RDY,0.0542050226433986,0.2271450087313322,0.0064714278883218,0.028258957821598,392,123,689,1204
344,EVR,0.0392008744339505,0.1305565905618228,0.019619540583072,0.0654234282960639,551,325,329,1205
345,KEY,0.0724240148506528,4.265544354552047e-05,0.0682298630082158,0.2067866649458661,268,896,43,1207
346,CZR,0.0779823795539328,0.0805841700352066,0.0,0.0510953250257957,240,542,427,1209
347,WEX,0.0320173321131679,0.1206623282179417,0.0,0.0917405851509714,645,356,208,1209
348,CHRW,0.0317458538538034,0.1741563243412902,0.0284690287925703,0.0632551240626912,648,218,344,1210
349,SBUX,0.0394659220159887,0.2920766957542711,0.0232690578636153,0.0351657679721082,546,63,602,1211
350,NSP,0.0386715226532847,0.304964717144105,0.019003611618122,0.0357356531848348,560,57,594,1211
351,TDC,0.0142781541018142,0.2132269099201824,0.0,0.0817539468732915,829,146,238,1213
352,ITT,0.0418022907451663,0.1824651098521486,0.0097555650508816,0.0437982101083947,513,198,503,1214
353,UHS,0.0679260983581827,0.0952226600864697,0.005250161866427,0.0496571816530758,304,470,440,1214
354,AMP,0.0636643924081856,0.0408423338476484,0.0136993019657676,0.1121101057234911,326,731,158,1215
355,HE,0.1291603285933596,0.0202907085779177,0.0841223362440194,0.0662568956217925,77,817,322,1216
356,PHM,0.114621413720809,-9.034012183065883e-05,0.0062746033146885,0.0926953398982464,105,906,206,1217
357,SCCO,0.0364468570424331,0.2733490689061603,0.0464738003950273,0.0385403120919181,585,75,558,1218
358,FFIV,0.0409114139192362,0.1251652738460495,0.0,0.0620718221278607,527,341,351,1219
359,IGT,0.0284567676030645,0.1141130870953032,0.0291864283108354,0.1169281284202845,689,386,145,1220
360,TKC,0.0412185304229269,0.1264287138666885,0.0081589306314765,0.0592409659383347,520,339,361,1220
361,BAP,0.1097820256192124,0.0299128410805807,0.0449918037914923,0.0660772703989724,117,776,327,1220
362,OGS,0.0652675599633287,0.0580487240933797,0.0406719821882606,0.0770282079421208,319,637,265,1221
363,CHH,0.0453231993988114,0.2582643589427515,0.009898423905189,0.0312542774254868,479,86,657,1222
364,ACI,0.0826946610966348,0.0,0.0163807406151248,0.1368990142764759,221,898,103,1222
365,FNB,0.0976358540513472,0.0358305139358788,0.0366386091491653,0.067439198159178,156,754,314,1224
366,DPZ,0.035895903190538,0.726814533115634,0.0117393719278931,0.0335690774161253,596,3,629,1228
367,PNR,0.0518725559525111,0.1316778595222402,0.0120955438000716,0.0452499958140421,417,322,489,1228
368,CCK,0.0409222347588751,0.1236961137265762,0.0104579044383792,0.0600192776463502,526,345,359,1230
369,BSAC,0.0715607354885383,0.0095920815958378,0.0599223453729622,0.1474948212082267,279,863,90,1232
370,WBS,0.0995309370627157,-0.0009756455258808,0.033810630877551,0.1076511999416466,146,915,172,1233
371,MGA,0.0717382345746827,0.11715074780292,0.0308716887452468,0.0361956728064659,278,366,590,1234
372,PG,0.0407763260370508,0.2131581112691453,0.0250423911831993,0.0383636409436144,530,147,561,1238
373,BKR,0.0563949492416432,0.0967270601987142,0.0228133968625484,0.053347358057715,380,461,400,1241
374,UPS,0.0496666051387166,0.1718846956619845,0.0397747469894433,0.03761275404065,441,226,575,1242
375,BEN,0.0732966905232394,0.038370231133389,0.0504226100529715,0.0821889374138589,260,745,237,1242
376,POST,0.0585685405489464,0.0552419429225007,0.0,0.0869489153254023,370,652,222,1244
377,PSO,0.0549764555944182,0.089798985534473,0.0223978152421704,0.0609395103017493,388,501,356,1245
378,BXMT,0.0671311843803586,0.0223821513544374,0.1162422792235135,0.1249317181653916,310,814,124,1248
379,A,0.0408018484553538,0.1473799126637554,0.008719749871507,0.0485015521154771,529,279,447,1255
380,ABBV,0.0177490198803621,0.1798802518839682,0.0384653342626233,0.0805220803209028,807,206,243,1256
381,MMC,0.0401289854140326,0.1870727820081459,0.0138677910190134,0.0410478066988054,538,188,533,1259
382,LII,0.0371436700287531,0.4514659377177467,0.009655717645163,0.0303959977239194,578,17,665,1260
383,ROST,0.0389230256689542,0.228158155675032,0.009443877364125,0.0363723021134703,556,121,587,1264
384,BCE,0.047583570990338,0.0919058044891615,0.0771261769299867,0.0669071687544214,457,488,319,1264
385,GD,0.0467381673994255,0.1106102454531241,0.020133364418214,0.0536607737925229,471,401,398,1270
386,TPX,0.0419389967043536,0.1602435746221576,0.0088526488560942,0.0432492343085374,510,253,508,1271
387,ETSY,0.0309770536219063,0.1417189847763036,0.0,0.0670371487801363,655,299,318,1272
388,VSH,0.0968782887650273,0.1370173120544028,0.01664181239838,0.010857895541193,159,310,806,1275
389,KHC,0.0629208590030603,0.0653204053364438,0.0433063005047332,0.0653010526185876,333,611,331,1275
390,TRV,0.0683570380198371,-0.0003676470588235,0.0207516517960588,0.1762290605720375,303,910,63,1276
391,BK,0.0805179189927227,-6.520945276227242e-06,0.036436441126652,0.1149695909658718,231,900,148,1279
392,MT,0.0384448373059665,0.0676803237788989,0.0154365015951051,0.1268386797733302,562,601,118,1281
393,AIZ,0.0713361289248512,0.0205824595798935,0.0169097158525367,0.1038787271939157,281,816,185,1282
394,MCD,0.0392383568430264,0.2383064368870187,0.0210017504130538,0.033612159894877,550,105,628,1283
395,HI,0.1929069042183528,0.0268048018418023,0.0207568777050816,0.046626787275526,22,788,477,1287
396,PRU,0.0659971720423989,-0.0001608881023248,0.0489673551407831,0.1726855265257303,315,908,65,1288
397,FAST,0.0312151384794597,0.4021201599326599,0.0274801322994932,0.0340501757318367,651,24,619,1294
398,BAX,0.1357737159262159,0.0179120929591696,0.0299560984686606,0.0528576891068175,64,825,405,1294
399,AVT,0.1659990283121323,0.1442430225111728,0.0228972568267985,-0.1956204228973128,42,290,964,1296
400,FN,0.0522739978731354,0.1680532901400288,0.0,0.0318475124933364,411,237,648,1296
401,TPL,0.0335835762376261,0.444559993048791,0.0082767377476068,0.0313189232913208,625,18,653,1296
402,NNN,0.0502373853852311,0.0653402222375504,0.0517890411840236,0.0784163663755146,433,610,257,1300
403,AWI,0.0509226140093162,0.1586710873536775,0.0106714503889049,0.0340621774673576,426,257,618,1301
404,ALE,0.0705099889626613,0.0258894581675587,0.0443719274937023,0.0896284400371183,291,793,217,1301
405,MSI,0.0326855949858882,0.3134210526315789,0.0112649593017484,0.0342538915270484,638,49,615,1302
406,WTS,0.0376658605607255,0.1872242067661273,0.0066824208930703,0.0403963121084316,573,187,542,1302
407,TT,0.0362995318492117,0.2169675523301145,0.012262458582591,0.037465335283274,587,139,577,1303
408,SNY,0.0480629765978162,0.0897917277794074,0.0396430551419766,0.0623483613088338,454,502,348,1304
409,QSR,0.0488173885076483,0.1038172781918564,0.0406127853971192,0.0502557208646338,446,426,436,1308
410,RHP,0.0489645553428944,0.0942103937435613,0.0276906811160854,0.0551104356301521,445,479,386,1310
411,BRO,0.0437825376429232,0.1219612607818132,0.0067899397837962,0.0473082767454722,487,353,471,1311
412,PB,0.0666400470524032,0.0243029534430793,0.0326933798838707,0.0982756181400897,312,803,198,1313
413,BCO,0.0215834951480204,0.1060609313609721,0.0097457971249898,0.1229791622059956,769,414,132,1315
414,CNS,0.0345596471245491,0.2340443825631609,0.0301133219208754,0.03594847098206,612,112,591,1315
415,CBOE,0.0403035246051588,0.1681663193786702,0.0118306248348476,0.0395942164495125,535,235,548,1318
416,HST,0.053553882696299,0.0767019105917269,0.0395864511282102,0.0575342388426455,397,557,369,1323
417,CW,0.0415647916915748,0.1270445742149865,0.0035465767692172,0.0472997666027948,518,334,472,1324
418,MTD,0.0297641988652917,0.5297357106756442,0.0,0.0324725221769948,672,12,641,1325
419,GGG,0.0346592330856857,0.2776521645327696,0.010833631964212,0.0319037299334788,611,72,646,1329
420,NE,0.0723100936849227,0.1264627477286679,0.0148256834303345,0.0247218766370613,270,338,721,1329
421,GSK,0.0417356874917799,0.1843319187073305,0.0190300506887235,0.0339102460870711,514,192,624,1330
422,BABA,0.0395336155487031,0.0733724600476861,0.0,0.0898404848900911,545,575,214,1334
423,WSO,0.0343829082747745,0.2514659972415879,0.0245302530306679,0.0336966437935221,616,92,627,1335
424,CLF,0.0383130725355764,0.0482571815524984,0.0,0.1556528585969157,565,693,78,1336
425,FTNT,0.0251868175909579,0.3493036526455549,0.0,0.0379930789135603,729,38,570,1337
426,TSCO,0.047198521332332,0.2109395871014819,0.0191662760461217,0.0247304725060217,465,152,720,1337
427,KO,0.0420561938108308,0.1525791830788323,0.0312143786805793,0.0382603809104133,507,268,565,1340
428,GIS,0.0518051991896827,0.1110971734403746,0.025721853593582,0.0417233669868407,420,397,525,1342
429,PEP,0.038827583279475,0.2046101557053218,0.0285922318132524,0.0339067412284064,557,160,625,1342
430,URI,0.0617389801536533,0.1743349125364431,0.0103407697782109,0.0161479015748416,342,217,784,1343
431,E,0.0469341381770112,0.0883723460192555,0.0299646583288987,0.0580798892888438,469,510,365,1344
432,CNI,0.0514208891708034,0.1385022359387793,0.0189320287062638,0.0345365545399636,422,309,613,1344
433,FRO,0.1470596158879829,0.1292340554271032,0.1431421423980554,-0.1736812297425583,53,330,962,1345
434,FDX,0.0717395874648617,0.066778144840056,0.0212581808776793,0.0476999623601963,277,607,463,1347
435,NTRS,0.0633191729592322,0.0118013017847777,0.0379297457092556,0.1114961830000099,330,856,161,1347
436,SF,0.0708464969088684,0.0248530600911422,0.0271523372618432,0.0770150729875745,286,800,266,1352
437,PAG,0.0965450708604766,0.1171975352309324,0.0173344786362667,0.0053717633425977,162,365,827,1354
438,RL,0.0661766279140283,0.1329682779456193,0.0251058452560777,0.0244981394707566,313,318,723,1354
439,REGN,0.0421881392319144,0.136464487065361,0.0,0.0391362857767526,503,312,551,1366
440,AEL,0.0474726366486666,-1.700427331221906e-05,0.0098483228310953,0.8770982833241566,459,902,7,1368
441,LVS,0.0325190433488702,0.1332680341092417,0.0081231025564335,0.0524672525776202,641,317,414,1372
442,LW,0.0637917489302441,0.1709628653383983,0.0092377584683404,0.0068097644561277,325,228,821,1374
443,MKC,0.0391141064418489,0.098633672695987,0.0240512100292591,0.0559413329569434,553,450,378,1381
444,ROK,0.038942191139975,0.1613850057211084,0.016527577835933,0.0369950815829763,555,249,581,1385
445,KGC,0.0573119850250377,0.0793707820264975,0.0202787782709297,0.0476241113544748,375,546,464,1385
446,CIB,0.0533722862657066,4.4055672288317495e-05,0.0287777356560028,0.1460704121892122,399,895,92,1386
447,OHI,0.0328445778599569,0.0903981174248315,0.0873215782185023,0.0786226067382258,634,499,255,1388
448,HON,0.0406939900414081,0.1831526543525799,0.0205339946214599,0.03093404934042,531,197,661,1389
449,CLX,0.0075805389424963,0.3038728897715988,0.0296607664662777,0.0473147732652458,862,58,470,1390
450,DAR,0.0812962983100396,0.0552534958198627,0.0,0.0429570370238277,229,651,512,1392
451,MA,0.0278049991078556,0.5555682859761687,0.0053598202835866,0.0288332500797763,703,7,685,1395
452,ASB,0.0570344519063864,0.0051160428499903,0.0439657452620592,0.1187496592696826,377,878,141,1396
453,AMGN,0.0435912095927917,0.1002640867423376,0.0295670017723327,0.047757586927699,489,446,461,1396
454,VAC,0.0819755461136652,0.0699809251311397,0.0342102672757815,0.0367921742399914,223,591,583,1397
455,CAJ,0.0835689112762145,0.0947405444835459,0.0408751558935468,0.0253747552752155,215,473,714,1402
456,APH,0.0326055458685027,0.1913905650642679,0.0084659420444878,0.0364596972706976,640,178,585,1403
457,EMR,0.2383928265814909,0.0750914779657421,0.0216048571181349,0.0049413446163347,12,564,828,1404
458,PXD,0.0930030679230252,-0.0418264514402925,0.0626925053285779,0.073676521115155,174,946,285,1405
459,AXTA,0.0356183323853759,0.1005201382472709,0.0,0.0582627471404766,598,444,364,1406
460,TRGP,0.0424478455796375,0.1135004671441918,0.0219004641586321,0.0423453393116355,502,390,516,1408
461,TXN,0.042060328078312,0.2525492627807634,0.0294422296548184,0.008715726970452,506,90,812,1408
462,BCS,0.0549541841887936,-0.0007685110932905,0.0236055337673483,0.135906849127106,389,913,107,1409
463,BUD,0.0409982289624815,0.0753223867771112,0.0231281902010778,0.0662220036059404,524,563,324,1411
464,JCI,0.050780516309595,0.0895436164067013,0.0269144975572759,0.046194066215651,428,504,482,1414
465,FMC,0.167596001183508,0.0980963753863444,0.0368419510736353,-0.0659857732998707,40,454,921,1415
466,JHX,0.0531317922692204,0.196044211751018,0.0134489849181464,0.0008094296478514,401,173,841,1415
467,VMW,0.0253389263633097,0.1072906717605858,0.0433885725399139,0.0742426685682971,727,412,279,1418
468,WTW,0.0416567953881386,0.1111786148238153,0.0138987601674168,0.0435520808655137,516,396,506,1418
469,AIG,0.0747334920969817,0.0074647263767781,0.0210476428469676,0.0725179507446693,254,871,295,1420
470,SRC,0.0531054153627323,0.0403042881490174,0.0667388854333165,0.0739853689317266,402,738,281,1421
471,BMO,0.0587830564209915,0.0050222399997253,0.0364010541823459,0.106577115352973,366,879,177,1422
472,CHE,0.0309652164155678,0.2366406048854968,0.0026705338766744,0.0310715741599542,656,108,660,1424
473,JBT,0.1830693815987933,0.0739892183288409,0.0040221216691804,0.0060017596782302,28,571,825,1424
474,HIW,0.0613777648451275,-0.0005550148857658,0.0881191797502167,0.1099450906422241,347,911,166,1424
475,CACI,0.0486629059771564,0.1012157121742615,0.0,0.041023765089542,450,441,534,1425
476,LAD,0.1105221309302942,0.1185213907199172,0.0058309037900874,-0.1177555437759519,114,363,951,1428
477,UNP,0.0426313396791899,0.1464224679972914,0.021205399091091,0.0318983201581397,499,283,647,1429
478,SHW,0.0299877252186374,0.2261644464859899,0.0078295982162023,0.033059558926357,669,125,635,1429
479,MAA,0.0352838070147692,0.1545056578778168,0.0418323671170625,0.0381563296261369,601,263,567,1431
480,AME,0.0345482346408868,0.1406362429330135,0.0060596505120369,0.0420688058052664,614,301,520,1435
481,PPG,0.035983657186248,0.1029952389561863,0.0169434858247057,0.05275714148094,594,435,408,1437
482,MDLZ,0.0502319187124178,0.1050441024857764,0.0218796016170241,0.0364862615854263,434,420,584,1438
483,SWN,0.2159075375561065,-0.0949132722666147,0.0,0.0479794527902458,19,962,458,1439
484,CFR,0.0858476009278334,0.0344402043613374,0.0343115908687354,0.0459714561211061,200,759,484,1443
485,ABC,0.0455648118015007,0.1705134085125763,0.0,0.0220830055560768,474,229,743,1446
486,VRTX,0.0345198694436335,0.19549805033676,0.0,0.0312706376266023,615,175,656,1446
487,WWE,0.0323791270797903,0.3069006608168129,0.0059096873044402,0.0208080586601719,642,55,750,1447
488,MAN,0.0224378070985338,0.1150229500062027,0.0364614365351174,0.0682230621239203,760,381,309,1450
489,DOC,0.0420304513861074,0.0251940429825587,0.0902420817693326,0.115737745421533,508,797,147,1452
490,ANET,0.0286499688498925,0.2808501717015876,0.0,0.0274456610712334,685,70,698,1453
491,CUBE,0.0393129001233719,0.084986869355643,0.0425876591429901,0.0554751796312898,549,521,384,1454
492,BR,0.0323473346611847,0.1604688624601569,0.0169790164491788,0.0383746290200322,643,251,560,1454
493,NVO,0.0267251285917478,0.7082323535707135,0.0101451568415813,0.0223591374946577,713,4,742,1459
494,IEX,0.0363176299337692,0.1385673544707263,0.0116184734580939,0.0381880396619468,586,308,566,1460
495,SBS,0.069752360617948,0.1153813553703676,0.0,0.0141696511959582,293,378,791,1462
496,WMT,0.0348654915193607,0.1688418841884188,0.013801438845263,0.0339866051042959,609,232,621,1462
497,CME,0.0426688215492832,0.0943262060861639,0.0427918207559066,0.0446685505859987,498,478,493,1469
498,SJR,0.0453917929017782,0.091719298245614,0.0351726981647286,0.0436688059984384,476,490,504,1470
499,MSCI,0.0255539772538606,0.3460489543871154,0.0098112515942229,0.025478022277381,725,39,710,1474
500,FUL,0.0346865267798054,0.0881066219704254,0.0103875742178354,0.0620599810874576,610,512,352,1474
501,J,0.0385246248587138,0.0960500593681853,0.0074309150426584,0.0484483277851733,561,465,448,1474
502,PHI,0.0949675974470686,0.0985694423586519,0.0832420573098826,-0.0058806117303963,167,451,857,1475
503,FNF,0.0375306706157352,0.0002033166020712,0.0362965866689896,0.4913831903247819,574,892,13,1479
504,FSS,0.0337904707437639,0.1578577946234295,0.0051093596169096,0.0352288198796166,621,258,601,1480
505,IT,0.0247609011818518,0.2786617219456902,0.0,0.029535014919252,734,71,676,1481
506,SCI,0.0521354468657465,0.0605047320633334,0.0162992586701122,0.0492180694499707,412,628,442,1482
507,MSFT,0.0285373338809775,0.2875738645407972,0.0078086152878395,0.02345542395173,688,66,731,1485
508,GE,0.0855305278851081,0.0571013381593845,0.0053135197684135,0.032332181409158,201,644,642,1487
509,AEM,0.0724193813672848,0.062763326378393,0.0238241857445347,0.0355756452637153,269,621,598,1488
510,PAYC,0.0285675699934134,0.2714072317210457,0.0054352386329123,0.0241597270957947,687,77,725,1489
511,NYT,0.0287975419660259,0.1454934675393098,0.0086080222005879,0.0418788508388011,683,285,521,1489
512,GS,0.0647750289312236,0.026430049701147,0.0318626815632803,0.0562560021107714,322,791,376,1489
513,CMI,0.0216513537589946,0.0921892995497853,0.0271304718531075,0.0810968393177036,766,486,240,1492
514,KWR,0.0295259344997143,0.0946362574524832,0.0082883583470745,0.0629077232901814,676,474,345,1495
515,CTAS,0.0280890012907362,0.2463903172835864,0.0093750930584522,0.0263948178277476,694,96,706,1496
516,NNI,0.02772945497585,0.0612340037250909,0.0119419152394029,0.108712356980879,704,626,168,1498
517,FDS,0.0280877225531587,0.1810386134813953,0.008315273272039,0.0350839006279602,695,202,603,1500
518,VLY,0.0904442951104377,-0.0009009697538898,0.0434973938557671,0.0529394973408106,183,914,404,1501
519,FCN,0.0406887863207572,0.1551763607795623,0.0,0.0259003725389561,532,262,708,1502
520,WAT,0.0330204364785969,0.2198456508448445,0.0,0.0227345134963215,632,134,738,1504
521,STZ,0.0379186197510722,0.138980044345898,0.0143517387942868,0.0331661703032853,569,307,632,1508
522,AVY,0.0308318242289346,0.1749088071747289,0.0157346506552038,0.033154937823918,660,215,634,1509
523,ODFL,0.0279464158259841,0.3302658052412216,0.0039476418759757,0.0183038244184724,701,43,768,1512
524,EDU,0.0280513078493191,0.0458884263596588,0.0,0.1309648925000185,696,704,115,1515
525,NU,0.0261061903604897,0.0356007642557758,0.0,0.2155340076945022,719,756,40,1515
526,SID,-0.0125825025577768,0.0963902683305935,0.157411612413592,0.1140584722487289,903,462,151,1516
527,PH,0.0416016482848391,0.0726176882898823,0.0140617891675664,0.0519124432982736,517,581,419,1517
528,TREX,0.0228263914787572,0.3187699949680773,0.0,0.0248243564595426,754,46,717,1517
529,HLT,0.023916534856725,0.1905128863772583,0.0033118426883107,0.0356127894141769,743,180,596,1519
530,DXC,0.0220998554038032,0.0467447504484541,0.0,0.1835987987392882,764,699,57,1520
531,CHD,0.0326283941993658,0.1479460488023281,0.0115080294522644,0.0348522722679722,639,277,606,1522
532,RYN,0.0350757389405011,0.1053510041704171,0.0343675241219864,0.0438717144212662,604,418,501,1523
533,HMC,0.0362779545345448,0.0464680566778781,0.0118886185544444,0.0833433511172593,589,701,234,1524
534,GHC,0.0635339123863114,0.0295821569838861,0.0095795428378351,0.0515072579528712,328,777,424,1529
535,COST,0.0260465458770796,0.2291378385247522,0.00517867592057,0.0279217978291325,720,118,692,1530
536,NKE,0.0310430813311096,0.178815207780725,0.0123192662008269,0.0298307479773503,653,208,670,1531
537,PEG,0.0841633090005155,0.0806628141143507,0.0373365908441616,0.015794986979808,210,540,786,1536
538,CPRT,0.0293665620552247,0.23803728036816,0.0,0.0201094853183299,677,106,755,1538
539,INCY,0.0425591748642995,0.111973196807927,0.0,0.031976479333542,501,393,645,1539
540,ATI,0.0705271526962643,0.1163672654690618,0.0,-0.0197091458849346,290,372,877,1539
541,FICO,0.0197858719780524,0.5323233904138231,0.0,0.0214126565799533,783,10,748,1541
542,NOV,0.124591595525242,0.0712270007901569,0.0099121208927433,-0.0175657838605577,84,585,874,1543
543,MMS,0.0354432764526054,0.0903504768781742,0.0149125430055763,0.0489932231645751,599,500,444,1543
544,ADI,0.0411016812156859,0.0838521151706974,0.0208213711422613,0.0440974877323687,523,528,497,1548
545,MNST,0.0270946512024461,0.2291370399865897,0.0,0.0245233149990409,708,119,722,1549
546,FISV,0.0377561765191335,0.0846035787784715,0.0,0.0481182041035893,572,524,454,1550
547,NYCB,0.3251799320470551,0.0234830805134189,0.0710903052790318,0.0226009641060505,5,807,739,1551
548,ADBE,0.0193927240628657,0.3089000371609067,0.0,0.0248018221157726,788,53,718,1559
549,M,0.020554598298549,0.1037481720926652,0.0354322123051179,0.0610765206585458,776,429,355,1560
550,CX,0.0161917686893034,0.0926583388121849,0.0,0.0779340075375263,815,484,261,1560
551,FLO,0.0259070963079343,0.1186891687661071,0.0409789152602046,0.0462394311858288,721,362,480,1563
552,CLH,0.0400443826512786,0.1145745484097152,0.0,0.0328110735359073,540,384,639,1563
553,ATO,0.0576257827908673,0.0504218503772565,0.0279941655643156,0.0425280777538548,372,678,515,1565
554,FLS,0.0345523303588882,0.0908828348105237,0.0194194150935623,0.0478131514703704,613,495,460,1568
555,MET,0.0314927937482852,0.0023906005601833,0.0352048720988436,0.2504854590207405,649,887,32,1568
556,MKTX,0.0234694749626844,0.2224295138627157,0.0099731285402648,0.0279818386071539,750,128,691,1569
557,IPGP,0.0427653230153401,0.0932216388081176,0.0,0.0362443722773172,497,483,589,1569
558,NVDA,0.0192963466588677,0.5984354865056174,0.0002561175043767,0.017520382495607,791,6,773,1570
559,TTC,0.039065388137203,0.1597729717698557,0.0168134018097334,0.0186381120836579,554,254,764,1572
560,TRI,0.0397930144353789,0.1283196037900114,0.013170823330745,0.0270201928764136,542,331,700,1573
561,LEG,-0.0383518677331551,0.0950799252646875,0.0671157685330214,0.1074861556205531,929,471,174,1574
562,PFG,0.0328292508625185,0.0026915763369815,0.0329504114481792,0.1944047936184824,635,886,53,1574
563,ROL,0.0203288240536429,0.2889015148325392,0.0123549775746393,0.0231771972333485,779,65,733,1577
564,CR,0.0382023659491071,0.1520492901151888,0.0085541053883698,0.02252730371911,567,270,740,1577
565,PDI,0.0330717761098329,0.020032247817643,0.1416518688945045,0.1232375564188636,631,818,130,1579
566,WAL,0.1013886625749099,0.0834141394152278,0.0240699828787334,-0.0621609062215221,135,529,918,1582
567,UA,0.1004421632469818,0.0810844090838445,0.0,-0.0513443944461959,138,537,908,1583
568,UAA,0.1004421632469818,0.0810844090838445,0.0,-0.0513443944461959,138,537,908,1583
569,TMUS,0.0437712560495216,0.0763892607387258,0.0039313608595638,0.0407766853278458,488,559,537,1584
570,ABB,0.0427878376738353,0.147530836907025,0.0293550498465342,0.0090762079914196,496,278,811,1585
571,HWM,0.0343088713323143,0.1391716797778806,0.0032739184408613,0.0305864709132528,618,305,663,1586
572,VRSK,0.0175429549640027,0.3148246028875845,0.0056192277619071,0.0237189659645134,809,48,729,1586
573,ZTS,0.0257521524665274,0.2475598935226264,0.0076025979124731,0.0178089757458366,722,95,770,1587
574,NFLX,0.0251543674850299,0.1744110813239094,0.0,0.0322139714487413,730,216,643,1589
575,ADT,-0.0268570355463741,0.0748165236870823,0.0206830265722886,0.1368560193698658,919,567,104,1590
576,RCL,0.051192418333462,0.1122425184609405,0.0,0.017496524828172,424,392,774,1590
577,TRQ,0.2057608973002174,0.0635853712443756,0.0,-0.1271275602617258,21,617,953,1591
578,RLI,0.0501851848825301,0.0040127857961579,0.0230805621128202,0.0755129603980106,436,884,272,1592
579,WAB,0.0359193502608229,0.0886686311277792,0.0054209571559278,0.0447339147420065,595,508,492,1595
580,ATR,0.0350722747234812,0.1262330183176117,0.0127823016874398,0.0316633897186164,605,340,650,1595
581,IDXX,0.0183283297564104,0.4752809115318201,0.0,0.0167631681902257,802,13,781,1596
582,WLK,0.0267780692078709,0.0675253494107974,0.0123548085489341,0.0727871526276575,712,602,291,1605
583,VMI,0.0293198915650991,0.1058534403448223,0.010118657820846,0.0429154522267786,678,415,513,1606
584,LYV,0.0263219660425755,0.1169833649728081,0.0,0.0418482717367383,717,368,522,1607
585,VTRS,0.0042079353968833,0.0514456964876804,0.0442794810684832,0.1788641789998791,874,674,61,1609
586,DG,0.0556064808910072,0.0907965735527385,0.0173378921029541,0.023148564071116,384,496,734,1614
587,CAH,0.0105741778576715,0.0748635567912676,0.0212698979895692,0.0955322275417224,847,566,201,1614
588,TER,0.0267980097506938,0.1847783752577494,0.0040534533681356,0.0254147907347221,711,191,713,1615
589,GM,0.2066950669131141,0.0520549325659644,0.0121849466719787,-0.075109889033303,20,669,931,1620
590,JKHY,0.0300495790105991,0.2024719293272347,0.0120672525127332,0.01430782077474,666,165,789,1620
591,VNO,0.0195508017327072,0.0490929713735961,0.0354310328252075,0.1139769078926488,784,685,152,1621
592,RSG,0.0331980774614757,0.1046030800020602,0.0122378354870985,0.0381020337912847,629,424,568,1621
593,ETN,0.0334820283600063,0.1301939058171745,0.0143479543531537,0.0298300109720752,626,327,671,1624
594,WPC,0.0507471092942483,0.0012489005429123,0.0656628766675854,0.0681902236177151,429,888,310,1627
595,STOR,0.0365138495940296,0.0308600462152152,0.0488928865715621,0.075100374423858,583,772,275,1630
596,KIM,0.0497654221095774,0.0322731334874433,0.0500078322354166,0.0510718658878688,439,765,428,1632
597,TM,0.0950941280609761,0.0728859247173391,0.0282405723556998,-0.0291241231070575,166,579,888,1633
598,STN,0.0280473817935196,0.1188298587760591,0.0071896821083025,0.0376082193674579,697,361,576,1634
599,NWL,-0.1079460536814612,0.0615152169220807,0.0511909120551259,0.1797246151500617,952,624,59,1635
600,AER,0.1881979130327079,0.0479431555036652,0.0,-0.0582671076371893,26,695,915,1636
601,ENPH,0.0243572891084362,0.1563694610503258,0.0,0.0325391465501023,738,259,640,1637
602,RJF,0.0817542170179089,0.0989261174276192,0.0166893312486243,-0.173333983982191,227,449,961,1637
603,OSK,0.0300135176862123,0.0702399818881593,0.0167930722879152,0.0555051597923283,668,590,383,1641
604,EW,0.0303150340325382,0.1878229143710668,0.0,0.0136076111833163,664,186,795,1645
605,HASI,0.052987805079761,0.0325020083086598,0.0568861661323517,0.0462210335248212,403,764,481,1648
606,MLM,0.0378498794577348,0.1123868758517069,0.0056342535936742,0.0284335521873872,570,391,687,1648
607,FTV,0.0333582807655297,0.0749776793095466,0.00392994298693,0.0479992448344848,628,565,457,1650
608,TDY,0.0421355417171596,0.082370825432149,0.0,0.034309758029147,504,534,614,1652
609,HOLX,0.0266262184823232,0.0842662632375189,0.0,0.0526101378345905,716,526,411,1653
610,MDU,0.1028520820064721,0.0630432392267465,0.0400082141390332,-0.0464093895148697,131,619,904,1654
611,TR,0.0396015917741929,0.1034994335540165,0.0108043510676479,0.0292190567735104,544,430,680,1654
612,HSIC,0.0420662465741183,0.0904942965779467,0.0,0.0316508057156227,505,498,651,1654
613,CBU,0.0472312941543225,-0.0014054873836653,0.0340483197648978,0.0751249098638024,462,918,274,1654
614,CDNS,0.0141900710203511,0.3124431180711926,0.0,0.0169912888218673,831,50,776,1657
615,RMD,0.0279890149580647,0.1888599949108778,0.0080539719274442,0.0174409486171677,699,184,775,1658
616,SBAC,0.0182807655278103,0.124683869261009,0.0134774617081072,0.0429042731304357,803,343,514,1660
617,COTY,0.0487051726963517,0.0547819603417701,0.0013129887169225,0.0386133689086188,448,655,557,1660
618,APO,0.093154471279074,0.0857042754242964,0.0190849461665469,-0.328541626464735,173,519,969,1661
619,MCO,0.0224596324793511,0.183220590661607,0.0,0.0262751145371375,758,196,707,1661
620,EBR,0.0479922488706034,0.0466581896981994,0.0091157313607191,0.0434780424942153,455,700,507,1662
621,MHK,-0.0667095747673654,0.0777174474059087,0.0,0.1078709955127111,941,553,170,1664
622,STWD,0.0520953569823613,0.0247432060319022,0.0923293383653922,0.0483400891449474,414,801,453,1668
623,TDG,0.0269143639679618,0.1589364363003643,0.0007879397771822,0.0256287780157171,710,255,709,1674
624,CMG,0.0194984438434781,0.2221088415490914,0.0,0.0194033745348578,786,130,759,1675
625,ETR,0.1103431424603702,0.0491113683886049,0.0437443337376746,-0.0194918796937256,116,684,876,1676
626,IQV,0.0319321709897684,0.1031203566121842,0.0,0.035271175614619,646,433,600,1679
627,EGP,0.0241543403883847,0.1300267825606075,0.027182382501605,0.0345869538519924,741,328,611,1680
628,WST,0.0226813048102865,0.2140798682585426,0.0021786895419385,0.0158432774584829,755,144,785,1684
629,SPG,1.4973464902678512e-07,0.0910558283334387,0.0523670763585534,0.0673057247375399,882,492,315,1689
630,BMI,0.0204836951706553,0.2018031663108085,0.0064266216559523,0.0217038949866484,777,166,747,1690
631,STR,-0.0086803638743636,0.0442089804456332,0.0847629550688612,0.1543440400802206,898,714,79,1691
632,ORCL,0.0297709245869533,0.1228278253993926,0.0128424969287245,0.0296553841293067,671,349,672,1692
633,ALGN,0.0212529901067412,0.1636254606581626,0.0,0.0290372004329936,770,244,683,1697
634,GNRC,0.0256493632790662,0.091678395533717,0.0,0.0454688951314621,723,491,486,1700
635,CARR,0.0280440559854154,0.0885426709344028,0.0128890398153873,0.0444463985891906,698,509,494,1701
636,LIN,0.0309169462103769,0.1232678895136264,0.0123787482649065,0.0275205209209324,657,347,697,1701
637,WM,0.0317716018968639,0.125013113263629,0.0156651648241481,0.0251525181683506,647,342,716,1705
638,EPAM,0.0237406120793275,0.1421902968981502,0.0001689972433868,0.030408062770255,747,297,664,1708
639,PKX,0.181925854669018,0.0410668230836642,0.087363711810494,-0.1145721128835305,30,729,950,1709
640,ZBH,0.0401246214316417,0.0744118672711177,0.0078721059039226,0.0349679806304659,539,568,604,1711
641,ADSK,0.0166803705914388,0.2028412156087034,0.0,0.0230505783449021,813,164,736,1713
642,JPM,0.0991325779395684,0.0160838242599683,0.0269337644656201,0.0233727378928797,148,834,732,1714
643,MTN,0.028715414536428,0.1048558882089673,0.0336630911270125,0.0347662039048059,684,422,608,1714
644,EQR,0.0360634885162749,0.0464075016242919,0.0428752668742957,0.0518373311343957,593,702,420,1715
645,CAG,0.0409712364658868,0.0624293801350223,0.0373871522928908,0.0379505367615557,525,622,571,1718
646,SAM,0.0180214956476717,0.0985283389381976,0.0,0.047520970503652,804,452,466,1722
647,BRX,0.0435606157497006,0.0612783950277762,0.0450169815753403,0.0347867255550377,490,625,607,1722
648,AZN,0.0283030436109265,0.1160859770180087,0.0212973868044604,0.0312117695034348,691,373,658,1722
649,HTZ,0.1894178169596595,0.0425403319540657,0.0,-2.2225843847149664,25,722,979,1726
650,MPWR,0.0142308880216776,0.218160344248234,0.0061883155117079,0.0193342404228305,830,137,760,1727
651,ELS,0.0239388307593017,0.1751351923738746,0.0261015397837574,0.0175941731625259,742,213,772,1727
652,KOS,0.0692304699626736,0.084807031408271,5.382286443332624e-05,-0.0542874919317175,295,522,912,1729
653,TEF,-0.0439262729977828,0.0320420142106889,0.0845531510506649,0.2702549172778388,934,766,30,1730
654,NOK,0.0387292955347055,0.0634468854694773,0.0361667556797776,0.0387292955347055,559,618,556,1733
655,AL,0.1320191067350097,0.0490727999837772,0.0280293209095425,-0.597357771805062,71,687,976,1734
656,ASX,0.0255814462164927,0.0932396952516316,0.030512378485242,0.0411906246947928,724,482,528,1734
657,CRL,0.0391925300337831,0.0864521012073106,0.0,0.0301707766536107,552,515,668,1735
658,BIP,0.0070507695500212,0.0454428091918409,0.1047937905669828,0.1099781799419984,864,707,165,1736
659,ABMD,0.0090681704672291,0.2428062147216561,0.0,0.0165829836945386,854,100,783,1737
660,AVB,0.0351089149281589,0.0442820784581002,0.0348757689778703,0.0517178423381696,603,713,421,1737
661,KEX,0.0477173244322238,0.0654095729987424,0.0,0.0296443088757446,456,609,673,1738
662,BAH,0.0221869065303789,0.0960220457375132,0.0192428400086099,0.0429950446272995,762,466,510,1738
663,ICE,0.0326915951123856,0.0717866998328734,0.0131843215085845,0.0421484121106897,637,583,518,1738
664,JBHT,0.0352491785337954,0.1453208003758691,0.0084166841487901,-0.0057021633924565,602,286,856,1744
665,AIN,0.0362945626727629,0.1086510730709465,0.0101786128201161,0.0207821646794446,588,407,751,1746
666,NEE,0.0593993527697008,0.0684630097775637,0.0307316487243513,0.0142444685916943,362,597,790,1749
667,FTI,0.0063622132532373,0.098130300693909,0.0049244889059755,0.0510675159881739,867,453,429,1749
668,SYK,0.0278425296197011,0.1215341814885436,0.0100197918599809,0.0275874163941177,702,354,694,1750
669,WY,0.0329800658835425,0.0994751466502006,0.0477994757024883,0.029599510858531,633,448,675,1756
670,LPX,0.0349036033068222,0.1326860841423948,0.0135300484728693,0.0031374025444334,607,321,834,1762
671,PEAK,0.0282538034317722,0.02337537554313,0.0606627327449402,0.0778014844222527,693,808,263,1764
672,PWR,0.0237624428236292,0.1028904921023549,0.0015237289253821,0.0364131709555823,746,436,586,1768
673,NJR,0.0671505253282363,0.0710186004170728,0.0382961736011084,-0.0157082978176378,309,587,872,1768
674,INTU,0.0165799995409899,0.1309295539808253,0.006182726338901,0.0332851836422726,814,324,631,1769
675,ECL,0.024275713230644,0.1234629274090327,0.0109199138506715,0.0289582034238608,739,346,684,1769
676,BLK,0.0453870102910124,0.0577104393667347,0.0250362733975322,0.0313056532268978,477,640,654,1771
677,HES,0.0313389031619728,0.1501663692916043,0.0122226257628823,-0.00376429661714,650,272,850,1772
678,LLY,0.0099867836052255,0.2812456589064939,0.0077549840708236,-0.0060068586221797,850,68,858,1776
679,SSL,0.0603123317234296,0.0623623507592442,0.0,0.0128023574030031,357,623,798,1778
680,SNPS,0.0172196743072038,0.1727428249461054,0.0,0.0211618547143901,811,220,749,1780
681,ABT,0.0298817158151186,0.1091068330722719,0.0185670769593853,0.0264147475639848,670,405,705,1780
682,ADC,0.0283629028566951,0.0343938814061531,0.0475799005770857,0.0647584486808363,690,760,336,1786
683,LDOS,0.013419759280539,0.0639876352395672,0.0135546312331072,0.0646036652801829,835,616,337,1788
684,PAC,0.0063540903723901,0.2731761865399983,0.0049927097947586,-0.0003422617762637,868,76,845,1789
685,SAP,0.0157829803256385,0.1225728381271525,0.0146740053881616,0.0339860993269864,820,351,622,1793
686,ASR,0.0068136067379235,0.2318839223861361,0.0039925225931036,0.0081529000777862,865,114,815,1794
687,IR,0.0248728472705603,0.0847614332930504,0.0010349046507848,0.0406295899937752,733,523,539,1795
688,LH,0.0211143539772952,0.0832376536184147,0.0128302533737631,0.0441532459606548,773,530,496,1799
689,AGI,0.0394180674660609,0.0839957697285212,0.0066259894359616,0.0236640445937122,548,527,730,1805
690,JLL,0.0250569719281296,0.0704045245199455,0.0,0.0458673762978983,732,588,485,1805
691,FCX,0.0302725611667909,0.130282067207813,0.0141370239647947,0.0074534714993993,665,326,820,1811
692,SXT,0.0336702740157662,0.0871796832866475,0.0249558184457177,0.0295008764207136,622,514,678,1814
693,MSA,0.0088277919365734,0.2159370217249794,0.0110738059477136,0.0075484454787015,856,140,818,1814
694,VAL,0.170319562719185,0.014952905335532,0.0,-0.0843528594654988,37,840,939,1816
695,R,0.0777514438701659,0.0640315052508751,0.0245127704812345,-0.1687168030778724,243,615,960,1818
696,LHX,0.0307260421011384,0.0601193480390701,0.0217361080226472,0.0412435137249999,661,631,527,1819
697,BXP,0.0172811551160707,0.0409493582699731,0.0624878901202824,0.0742235219690769,810,730,280,1820
698,ED,0.0796389053788951,0.0533832200303997,0.0346503534320242,-0.0739165386168546,233,661,927,1821
699,TMO,0.0292603253318667,0.086384777014425,0.0025526522349568,0.0338092199455948,679,516,626,1821
700,OGE,0.0595728222724601,0.0559962106532317,0.0476239548492891,0.0077324608563821,361,647,817,1825
701,O,0.0219439137785144,0.030862477178727,0.0531245275585489,0.0727031367339642,765,771,293,1829
702,MDT,0.031071895222725,0.0669743702455523,0.0298978108369807,0.0378683555402024,652,604,573,1829
703,DOW,0.0152194070022915,0.0453447198500312,0.0509552981468912,0.0702573304570979,822,709,300,1831
704,TFX,0.0304183560126287,0.0731053346753682,0.0054545566887332,0.035785156280365,662,577,593,1832
705,SMFG,0.5541061189912098,0.0118636296299289,0.2073835882068058,-4.2592807155160886,2,854,980,1836
706,TFC,-0.0221855856343355,-0.0001093770974301,0.0636691738048622,0.4136361112630797,914,907,17,1838
707,VMC,0.0309085121949846,0.1022468559291829,0.0075648351750262,0.0217737418741779,658,439,746,1843
708,ESS,0.0254744010436487,0.0445878611723261,0.0368455911464221,0.0527091141145679,726,710,409,1845
709,WEC,0.050208650865036,0.0537515872545711,0.0370735645445033,0.0197949178704902,435,658,757,1850
710,TSM,0.010295394718328,0.1994629370617912,0.0035261841741383,0.003531365136257,848,170,833,1851
711,EXR,0.0296049180167384,0.0443761774150578,0.0385668783071573,0.0474114433054024,674,711,468,1853
712,DLB,0.02521786765171,0.0857257364498697,0.0102183268600316,0.0342321325382109,728,518,616,1862
713,DEO,0.0095071090974122,0.1891669939657942,0.0044836687521539,0.0046949944230391,851,181,830,1862
714,IP,0.0229657105196111,0.0415500984353953,0.0511943963666332,0.055181498887399,752,726,385,1863
715,BURL,0.0266958317476389,0.0975640597993608,0.0,0.0276234488060894,714,457,693,1864
716,GPN,0.0297389543858799,0.0404384016504204,0.0078530586886355,0.0479630585340648,673,733,459,1865
717,CS,-1.0002653516001097,0.0037989998068973,0.0383348341702752,1.6952211310583845,978,885,2,1865
718,ESI,0.0211421562063417,0.0550741633548331,0.0138560786652908,0.049552488043314,772,654,441,1867
719,RCI,0.0261942288391394,0.0737190082644628,0.0296189160018537,0.0374247344898422,718,573,578,1869
720,TLK,0.0006217797000366,0.212837743764909,0.0004226228501129,0.000611623311601,881,149,842,1872
721,SR,0.073221229106701,0.0489121544249959,0.055715463986938,-0.0748371458869868,261,688,930,1879
722,DTE,0.0615051097230024,0.0577022020991973,0.0331079760284165,-0.0314349666014486,346,641,893,1880
723,CIEN,0.0417011519763428,0.0765707229550908,0.0,0.0101680790420562,515,558,808,1881
724,CCI,0.0300445307152318,0.0692226364698681,0.054468213806642,0.0340451340062081,667,595,620,1882
725,TRMB,0.0236042910826885,0.064124513618677,0.0,0.0420904014776756,749,614,519,1882
726,AWR,0.0420098813767745,0.0946093265733717,0.0205793636846624,-0.040643192365998,509,476,899,1884
727,IBN,0.0286386950369293,0.025563768492247,0.0036229044097776,0.0531548786947291,686,796,403,1885
728,ST,-0.0006841109783839,0.0807194525984032,0.0125206866838593,0.0476140662724638,885,539,465,1889
729,FIS,-0.1874293865279001,0.0429499551471987,0.0346747181869319,0.090503549581326,967,720,211,1898
730,TECH,0.0222331566177608,0.1190925123785795,0.0039191703113411,0.0168464699935581,761,360,779,1900
731,SNN,0.0221372272407419,0.121435977190254,0.0275242331092114,0.0152351259717653,763,355,788,1906
732,SJM,-0.0054743930319191,0.0896598921928226,0.0257950041876408,0.042991673646068,892,503,511,1906
733,KBR,-0.0354261498459296,0.1224643125469571,0.0096252180713469,0.0335545796653899,926,352,630,1908
734,JWN,0.045705460369955,0.0523082650781831,0.0419535195933169,0.0177364473077437,473,667,771,1911
735,UDR,0.0352985750144487,0.0272657097590551,0.0432637576915629,0.0413330137431116,600,786,526,1912
736,AKAM,0.0303402989053721,0.0774526784480007,0.0,0.0275582363967517,663,556,696,1915
737,ALB,0.0928306606710042,0.016391562583488,0.0110435657802749,-0.0486113236976481,178,833,906,1917
738,BX,0.0140675693346938,0.0828100248252547,0.0431717143994922,0.0387642509057917,833,531,555,1919
739,OUT,-0.1869675291615479,0.0531473576624782,0.0899216508746292,0.0727192480986132,966,663,292,1921
740,DHR,0.0279607148434948,0.0682551762143438,0.0073247212688248,0.033929658377465,700,599,623,1922
741,NI,0.0646574256242727,0.0501896397426013,0.0413941491501888,-0.0643315587164645,324,679,920,1923
742,WCN,0.0198415087820264,0.09179805131308,0.0070387934484156,0.0315958560687348,782,489,652,1923
743,CPT,0.0373844228956054,0.0362617785587401,0.0403104094050131,0.0355960728440943,576,751,597,1924
744,ING,0.1505118221041959,-0.0006146956733271,0.061282911511342,-0.2393069810483346,47,912,967,1926
745,ACM,0.0048070864398169,0.0602130922337717,0.0083568867711066,0.0512905315611062,872,630,425,1927
746,TRP,0.0548170390687241,0.0525539450789192,0.0540103543733254,-0.0160961736895843,390,665,873,1928
747,FRC,0.0754688245764567,0.0147082388474256,0.0157736642357999,0.0024929641751982,249,842,838,1929
748,IVZ,-0.0119428635659098,-0.0142056128789849,0.0732963979633288,0.1400729044649794,901,932,97,1930
749,NOC,0.0289890996191514,0.0733194613028148,0.0157353283924966,0.0296094889106119,682,576,674,1932
750,NWE,0.0630764431928884,0.0425227088290931,0.0500534488250947,-0.0252323968118092,332,723,885,1940
751,BIIB,0.0310089576655753,0.0553939471604621,0.0,0.0330039358221669,654,650,638,1942
752,MTZ,-0.0085078221239212,0.0219624896263641,0.0,0.0842003394953,897,815,232,1944
753,NEA,0.0122108537662188,0.005970583595519,0.0473082370494075,0.0853593297434613,842,875,227,1944
754,NLY,-0.1715341340738539,-0.0179282948037507,0.1584424204177171,0.2056939558796495,963,938,44,1945
755,DEI,-0.017850429608689,0.0157859764586761,0.0528209571046007,0.096702670204194,910,837,200,1947
756,CP,0.0402858698514211,0.0591438430019409,0.0072528927896497,0.0168037318096836,536,634,780,1950
757,ALK,0.04722155171526,0.079032967032967,0.0,-0.089218591325853,463,547,941,1951
758,SWK,-0.020162589844776,0.0510443967020235,0.032850998849051,0.0580372184390818,911,675,367,1953
759,SWH,-0.020162589844776,0.0510443967020235,0.032850998849051,0.0580372184390818,911,675,367,1953
760,C,0.0929451676691342,0.0055654488959862,0.0524956885448122,-0.0411948131520111,176,877,901,1954
761,EVRG,0.060911211061136,0.0438367511729245,0.0474429451940696,-0.0294685990338164,349,716,890,1955
762,RBC,0.0239072472094156,0.0780512282462422,0.0029420368422501,0.0308913868436269,744,551,662,1957
763,GLOB,0.0156377087886091,0.1165508099760703,0.0,0.0185059733930822,821,371,766,1958
764,AMH,0.0292023196982439,0.0289536232088686,0.0256130970645132,0.044042218235583,680,779,499,1958
765,SJI,0.070840471324085,0.0412920530332961,0.0,-0.1021953974198793,287,727,947,1961
766,SRE,0.0652838242346569,0.0398230662463841,0.032418991741893,-0.0462612855308349,318,741,903,1962
767,STT,0.0778589617925095,0.0078615604993923,0.038849379083711,-0.0050464141902552,242,868,855,1965
768,PTC,0.0146446321887006,0.0817638888789811,0.0,0.0349652671121984,826,536,605,1967
769,EXC,0.0651072255596201,0.0437496601598608,0.0400767415064156,-0.0756507925853833,320,717,933,1970
770,ROP,0.0238182413176384,0.0692421531246652,0.0049935367940894,0.0331600439555129,745,594,633,1972
771,APD,0.0365112154288694,0.0887546385737208,0.0237556234287653,-0.0225413342450819,584,506,882,1972
772,SE,0.0065682058914068,0.0113671836942344,0.0,0.0795160359859745,866,859,250,1975
773,CUK,-0.0038935646742138,0.0519673742660538,0.0,0.0524578916242057,889,671,415,1975
774,CCL,-0.0038935646742138,0.0519673742660538,0.0,0.0524578916242057,889,671,415,1975
775,ISRG,0.0151754504897467,0.1281887570014801,0.0,0.0063267617837119,823,332,824,1979
776,AMZN,0.019433571154681,0.1015382835037485,0.0,0.0205781877367414,787,440,753,1980
777,CRM,0.0151069286379518,0.0787528716770594,0.0,0.0346918781922792,824,548,610,1982
778,HAS,-0.2101415411151033,0.0428810346749916,0.0547471415783657,0.0728503845281191,972,721,290,1983
779,NSC,0.0340638179569905,0.0730650948231676,0.0228397246838059,0.0154750787653542,619,578,787,1984
780,TW,0.0190458806838854,0.0819499942989926,0.0039624238948903,0.0313014731605882,794,535,655,1984
781,ALL,-0.0051163771695276,-0.0034732980024459,0.0280856448880452,0.1077977125983984,891,923,171,1985
782,CBRE,0.034341333736082,0.0779587556798322,0.0,0.0079758270036133,617,552,816,1985
783,TU,0.0246088258175208,0.0506236872562047,0.0384787228894648,0.0376886654613161,736,677,574,1987
784,DXCM,0.0113050990485344,0.1269406392694063,0.0,0.0106871287219663,845,335,807,1987
785,DUK,0.057419460385384,0.0431198285648375,0.043358642804978,-0.0362213076453423,373,719,896,1988
786,FNV,-0.0223239301789098,0.1267501970182228,0.0109515537105556,0.0224770961179797,915,336,741,1992
787,THG,0.0081435967567722,0.0002726322645138,0.0270376640196516,0.0806977378333972,860,891,242,1993
788,RH,0.0250609826546451,0.111028975897187,0.0,-0.0131909008035229,731,398,868,1997
789,SO,0.051925636637559,0.0462880569503591,0.0396363951697665,-0.0201381618951499,416,703,878,1997
790,SMG,-0.1313370743034055,-0.066060606060606,0.0515189628482972,0.1514125386996904,957,955,86,1998
791,AEE,0.0605966497627262,0.04156329198346,0.0348220331101777,-0.0634897189788286,354,725,919,1998
792,XEL,0.0518225380929306,0.0442945898300443,0.0319538179545342,-0.0154209359542486,418,712,870,2000
793,CNP,0.0508705245135352,0.0490920755348525,0.0296790955449742,-0.0290688711505915,427,686,887,2000
794,REG,0.0309006971277016,0.0273015930027279,0.038692134353363,0.0384651408601426,659,785,559,2003
795,TSLA,0.0190179606436877,0.1141774752793116,0.0,0.0055244519317652,795,385,826,2006
796,EDR,0.0502611168903218,0.017045014494479,0.007682627329315,0.0220067552271966,432,831,744,2007
797,VFC,0.0133485668160016,0.172116692047907,0.0791168015276891,-0.10322851147159,836,225,948,2009
798,RPM,0.0470514237489383,9.047091937315578e-05,0.0210258061191518,0.0317158310916017,467,894,649,2010
799,UMC,0.0189950906670449,0.117104717978679,0.0140197578241264,-0.0025112062735976,796,367,849,2012
800,CMS,0.052454218762123,0.0403304813532754,0.034240127016087,-0.0156712153009724,406,736,871,2013
801,STAG,0.0272554083234134,0.0411401106036103,0.0378161105492533,0.0374213668149211,707,728,579,2014
802,FE,0.0524607520263084,0.0522348493580138,0.0431301645515748,-0.0937343200905638,405,668,943,2016
803,DD,0.0122216162136872,0.0484289501889772,0.0188091540309938,0.0454193396877455,841,691,487,2019
804,VEEV,0.0157888609400309,0.09072921450107,0.0,0.0265841103642572,819,497,704,2020
805,ANSS,0.0158810742776516,0.0973229372568714,0.0,0.021955090424643,818,458,745,2021
806,PRGO,-0.0029168888784768,0.0164700524786398,0.0343825405596843,0.0697756567938016,888,832,302,2022
807,LNT,0.0541648367735324,0.0479069294858768,0.0351339481774264,-0.0760465062524559,393,696,934,2023
808,PNW,0.061543203361399,0.037876508728766,0.0474234962214338,-0.0783679269164518,345,746,935,2026
809,NDAQ,0.0360750949999475,0.0677951538064959,0.0150227732719328,0.0016351317847001,592,600,840,2032
810,HEI,0.0185719553879264,0.0957681040277218,0.0012594634708162,0.0183743157968721,800,467,767,2034
811,RTX,0.0266286303699404,0.0309361642978767,0.026995347032312,0.0393136931001593,715,770,550,2035
812,FR,0.0394490948602016,0.0673047374409139,0.0243123191454741,-0.0252387734211631,547,603,886,2036
813,H,0.0160878362688094,0.0434359805510534,0.0034369468392456,0.0438027905682584,816,718,502,2036
814,HAE,0.0273431283779345,0.1004391074752744,0.0,-0.029864200261502,706,445,891,2042
815,KKR,0.051929196879028,0.0373604076377046,0.0085573109208874,-0.0222924438793436,415,747,881,2043
816,ELP,0.0193898518170983,0.0741131930044353,0.0064412599987816,0.0283299606095637,789,570,688,2047
817,AEP,0.0523924853044546,0.0417882877166264,0.0417697256147647,-0.0591832689166709,408,724,916,2048
818,ZBRA,0.0210778730367583,0.1051156271899089,0.0,-0.0064800217781926,774,419,860,2053
819,KNX,0.0233682298353631,0.0308170456724462,0.0098088905832562,0.0411829417227562,751,773,529,2053
820,FRT,0.0282821797152344,0.0499429760248649,0.0428668027961007,0.0292040939220416,692,681,681,2054
821,WPP,0.002753038917442,0.0947725627696675,0.0105433410715081,0.0254606225969958,877,472,711,2060
822,UNF,0.0331739528313197,0.0580189912391553,0.0070716318225607,0.0140059907920953,630,638,793,2061
823,X,0.0818501038991043,-0.0161182815245712,0.0,-0.0435314519061158,226,936,902,2064
824,POR,0.0538126955666646,0.0458597464342313,0.0422476864317235,-0.2213873177260152,394,705,966,2065
825,PUK,0.0552852055197451,-0.0034095467308463,0.017323347761331,0.0195009543279524,387,922,758,2067
826,LXP,0.0082879535781957,0.000735113399007,0.0527681080770412,0.0665137535853282,858,889,321,2068
827,ASH,0.0411176611904717,0.0313696881269378,0.017555855339752,0.0168628610500249,522,768,778,2068
828,HXL,0.0169411387586649,0.0827249673403519,0.0067636334495331,0.0238650478823576,812,532,727,2071
829,NWSA,0.013256463638143,0.0171181899374813,0.0154807025036032,0.0527589458887168,837,829,407,2073
830,IDA,0.052380475053638,0.0399749191580243,0.0327975833865397,-0.0690083855767047,409,740,924,2073
831,EFX,0.0179422564685815,0.0909852840853717,0.0063108835332366,0.0169617333753049,805,493,777,2075
832,TEVA,-0.0478499207351939,0.0138639856557377,0.0,0.0720744781020273,936,845,296,2077
833,PLD,0.0242162046674972,0.0345438189175843,0.0255569476379325,0.0370555788911457,740,758,580,2078
834,SPGI,0.0187221634368154,0.073810223266745,0.0081775786222495,0.025431057493953,798,572,712,2082
835,NWS,0.013108572055973,0.0171181899374813,0.0153079968975792,0.0521703572428995,838,829,417,2084
836,RNG,-0.0512807398925674,-0.1359703497573468,0.0,0.1069931486647393,937,972,175,2084
837,NGG,0.0388236077420324,0.0483923079684564,0.0080017362628506,0.0028531393146318,558,692,836,2086
838,TD,0.076464157783595,0.0084104796385001,0.0413099349925283,-0.4761883081559333,246,867,974,2087
839,RBA,0.0184900090970793,0.0655125989576479,0.0294049345640719,0.0293879756889,801,608,679,2088
840,SUI,-0.0120782832830374,0.0350445415342714,0.0288860148395534,0.0489861700018372,902,757,445,2104
841,EIX,0.0513866169089361,0.0359075997813012,0.0445569812572154,-0.0747607710110819,423,753,929,2105
842,BSX,0.0189647530599861,0.0775750753236433,0.0003333415478214,0.0202743091407133,797,555,754,2106
843,KRG,0.0094726543535695,0.0194163006378786,0.0419897571166501,0.0502710005243225,852,820,435,2107
844,PCG,0.0606224767506352,0.0246438588721582,0.0,-0.1334715611792576,352,802,957,2111
845,PHG,-0.0238216447839388,-0.0054448179536953,0.0001022388188151,0.0762701588361303,917,927,269,2113
846,D,0.0507239740732826,0.0398197644164813,0.0568037282375326,-0.0931805000152629,430,742,942,2114
847,PANW,0.0058017198319013,0.057262404636584,0.0,0.0347179559283575,869,643,609,2121
848,DNB,-0.0093313203358818,0.0266015938716253,0.0170941847004134,0.0501905910832115,900,789,437,2126
849,MMM,-0.1381688547846324,-0.2587081597369838,0.0654005830152849,0.1000464974244693,959,976,194,2129
850,AWK,0.0370572900207936,0.0534337584822538,0.020883981240532,-0.0337598192986044,579,660,895,2134
851,XYL,0.0245391432844009,0.0528510821888257,0.0120479537636057,0.0228064944153874,737,664,737,2138
852,AMT,0.0147425279893677,0.0583021285066087,0.0293131111703918,0.0290646360138259,825,636,682,2143
853,CHT,0.003974706210265,0.1025557491545403,0.0039228687625311,0.0046125974082291,875,437,831,2143
854,TRNO,0.029058154573574,0.0400219041695212,0.0260642189870998,0.0242933746767405,681,739,724,2144
855,VTR,-0.0020459738089705,0.0282508745107125,0.0361306900457608,0.0466953212123852,887,782,476,2145
856,LYG,0.0447308603410272,0.0088386941289463,0.0135257601507391,0.0111007904326175,481,865,805,2151
857,NEP,0.071798951448113,-0.0013435700575815,0.2660151151152589,-0.1931391793954241,275,917,963,2155
858,CTVA,0.0216333757955784,0.0288765458618467,0.0129211591486516,0.03455453494423,767,780,612,2159
859,EC,0.011096517510387,0.0961688975161493,0.0029351842737485,-0.0044808742823659,846,464,851,2161
860,NOW,0.0120024338414695,0.0760327279984035,0.0,0.0187490358794532,843,560,762,2165
861,BDX,0.0200506710560615,0.0457530505645982,0.0150515145259114,0.0285762596250473,781,706,686,2173
862,AEG,-0.0144997627599039,-0.001305653043574,0.0400161050468858,0.0605911873989283,906,916,357,2179
863,MS,0.059857322591907,0.0119493152438243,0.0379616760313811,-0.2433815731402862,360,852,968,2180
864,PFSI,0.0327531236070452,0.0737017876041036,0.0093842354345315,-0.3664368913925612,636,574,971,2181
865,PPL,0.0370487643245793,0.0454089592155114,0.0352463920060862,-0.0316416473691001,580,708,894,2182
866,FMX,0.0083023280220791,0.0921769116644612,0.00237584926181,0.0024912418767708,857,487,839,2183
867,KRC,0.045470522968154,-0.0001944471204649,0.0547233365926262,0.0125908878814103,475,909,800,2184
868,DV,0.011579452597249,0.07582886464178,0.0,0.0166454023482577,844,561,782,2187
869,NMR,0.0591392406021915,0.0074357210627924,0.0214517600163403,-0.1306651932409442,364,872,956,2192
870,WD,0.0295774246774859,0.0523887121335899,0.0233727693577428,-0.0046061734510361,675,666,853,2194
871,WRK,-0.1799978605469577,-0.0671053040494044,0.0307055173874222,0.0748590253263211,964,956,277,2197
872,BFAM,0.0136457908238167,0.047610712839837,0.0,0.0303570723472323,834,698,666,2198
873,IFF,-0.1242290172830895,0.0305290227773695,0.0400051338307337,0.0453326940261098,956,774,488,2218
874,EL,0.0143132753694055,0.0878602620087336,0.0131608148277337,-0.0221670805422802,828,513,880,2221
875,GLW,0.0225005421817393,0.0368057565857491,0.0383012671561793,0.0238172692629426,757,749,728,2234
876,CAE,0.0229105006907363,0.0578768712300666,0.0,-0.001738605575543,753,639,848,2240
877,TYL,0.0094427347861828,0.0594573564320743,0.0,0.018634659645819,853,632,765,2250
878,AU,-0.0305951449965292,0.0956958393113343,0.0139305553813984,-0.0079417184884607,923,468,861,2252
879,SCHW,0.0403773332313341,0.0189735315349582,0.0181367299061607,-0.0388234394124847,533,822,897,2252
880,AR,0.0357270326048783,0.0291827423359474,0.0,-0.0215452895301991,597,778,879,2254
881,SWX,0.0336478604416024,0.048066533602342,0.0389295547636495,-0.081017199246059,624,694,937,2255
882,GMED,0.0203891001221137,0.0283658901991931,0.0,0.0274168374474151,778,781,699,2258
883,XRAY,-0.0174948443223928,0.0496215306980656,0.0153742571317997,0.0302183674659513,909,683,667,2259
884,MRK,0.0013196726604391,0.0368234524147639,0.0269177067314224,0.0330568962586159,879,748,636,2263
885,FAF,0.0322566630541584,0.0176799567021468,0.0322269059849203,0.0135245879687407,644,828,796,2268
886,COO,0.0190641337677519,0.0498695029888025,0.0001943997325059,0.0139319808295943,793,682,794,2269
887,DIS,0.015888293284125,0.0194336161430864,0.0,0.0330522396823961,817,819,637,2273
888,CUZ,0.0224574180549758,0.0265204533069329,0.0526084433319485,0.0240490868490558,759,790,726,2275
889,MAC,-0.0824031195304747,0.0255885264539705,0.0478937219638017,0.040890817335395,947,795,536,2278
890,GOL,-0.0683485059782147,-0.1036552142495524,0.0,0.057404239282772,943,967,370,2280
891,DNP,-0.0569175431627175,-0.0490478467113992,0.0854965200734807,0.0533158238834794,939,949,401,2289
892,XPO,0.0186015566255004,0.0742121314808539,0.0,-0.0837562152820153,799,569,938,2306
893,AJG,0.0200613689588482,-0.0965057831454277,0.0097999632170299,0.0380348656867034,780,964,569,2313
894,AMRC,0.0378314002196365,0.030095597739221,0.0,-0.3765323473308908,571,775,972,2318
895,PFE,0.0130430524756039,0.023698008471968,0.0569179359329448,0.0295022890587871,839,805,677,2321
896,NCLH,0.0195377654749285,0.0691906499109689,0.0,-0.0875492422906439,785,596,940,2321
897,STX,-0.0413052457662123,-0.0688960515713134,0.0454435785178366,0.048879175519185,931,958,446,2335
898,KMX,0.0383391908386099,-0.0048665318045148,0.0,-0.000535240078777,564,925,847,2336
899,EQIX,0.0128544018529242,0.0501157842213198,0.0182258653058872,0.0074554570491265,840,680,819,2339
900,FLR,0.014126457322781,0.0385826771653543,0.0049357501489234,0.0180410177857203,832,744,769,2345
901,HR,-0.0431335793195082,0.0041247054669117,0.0723307190110051,0.0411697038506615,933,883,530,2346
902,IRM,0.0090179576213143,0.0604935917132433,0.0361067796354775,-0.0113330206588519,855,629,866,2350
903,REXR,0.0209120267609828,0.0279356645856667,0.0276454224440806,0.0141440143355491,775,784,792,2351
904,WELL,0.0073147513114258,0.0260276064798662,0.0271125470565624,0.0268574618431993,863,792,701,2356
905,WDAY,0.0178847773658525,0.0160568570676493,0.0,0.0247485948922115,806,835,719,2360
906,LAZ,-0.02580537312163,-0.0456881261990455,0.055884895369388,0.044031453167971,918,948,500,2366
907,CCJ,0.0145919164930303,0.0281251368646578,0.0021059685103119,0.0199645038368741,827,783,756,2366
908,ORA,0.0276212354617877,0.0367249399359959,0.0063085277368814,-0.0686055721947452,705,750,923,2378
909,CALX,0.010172873987283,0.0339223280117418,0.0,0.0133196136271344,849,761,797,2407
910,STE,0.0056119613159971,0.0269262183364549,0.0096214489167789,0.0207100930269077,870,787,752,2409
911,BCH,0.000668312310945,0.0478608826994383,0.0004216654731535,-5.491779247008024e-05,880,697,843,2420
912,DLTR,-0.0327915749562885,0.0403248147378627,0.0,0.0189477760339371,924,737,761,2422
913,CDAY,0.0051510924451897,0.0362078346028291,0.0,0.009879193722435,871,752,809,2432
914,MC,-0.0064239904317538,-0.0697955187789935,0.0473752389103868,0.0368734449976828,894,959,582,2435
915,IX,0.02116041029197,0.0250563842478783,0.0082363453627519,-0.0129396402930144,771,798,867,2436
916,BIO,-0.0675754567002412,0.0325906222776293,0.0,0.0231424234859581,942,763,735,2440
917,TAL,-0.0003977014359372,-0.0222776892091516,0.0,0.0340792174765694,883,940,617,2440
918,ARES,0.0216157490814906,0.0226511686126152,0.0469689994704562,-0.0136916848687176,768,811,869,2448
919,HUN,0.0226555844221098,0.0138248847926267,0.0379088491815501,-0.0047105670580624,756,846,854,2456
920,PNM,0.0246095059223709,0.0336142995141237,0.0352947212991421,-0.1461430715212756,735,762,959,2456
921,LUV,0.0270606857701529,0.0092443564029548,0.024907469913173,-0.0226378640098698,709,864,883,2456
922,AUY,-0.261708570233604,0.053687562856185,0.0214933367842704,0.004369936710938,973,659,832,2464
923,DLR,0.0236111629679043,0.0185111211244498,0.0378401511113235,-0.0470516694532123,748,823,905,2476
924,AAP,0.0081979304128236,0.0148668486575421,0.0577020161389307,0.0123965610587591,859,841,802,2502
925,YPF,-0.1948403713179253,-0.0620432513049962,0.0,0.0356415313386448,970,951,595,2516
926,PENN,-0.1238110976182282,0.0249481961274032,0.0,0.0186980024974467,954,799,763,2516
927,RKT,-0.008328623793096,-0.0022519476254158,0.0,0.0268385258017437,896,920,702,2518
928,BA,-0.0140714999892215,-0.0187689692849338,0.0,0.0280733390874073,905,939,690,2534
929,ARE,0.0047834560764205,0.0312920284754312,0.0391155617674149,-0.0395895734223406,873,769,898,2540
930,ES,-0.0204967372240355,0.0486968480834752,0.0429416470522568,-0.1247067766096819,913,690,952,2555
931,HDB,0.0192074265952894,0.0189987368003447,0.0025198585656339,-0.0965984031219516,792,821,944,2557
932,OFC,-0.0270521412504934,-0.0176264729723225,4.197612738102126e-07,0.0267737732478613,920,937,703,2560
933,CWT,0.0175725248917078,0.0145055138561775,0.0199844267979207,-0.0561693871295308,808,844,914,2566
934,TV,-0.000548577358494,0.0158288373714217,6.691217022963452e-05,-0.0005344197922927,884,836,846,2566
935,AMD,0.003589445751748,0.0065527158637819,0.0,0.004711672936428,876,873,829,2578
936,CVT,-0.0384403731892883,-0.0406671794855289,0.0,0.0253686527880201,930,945,715,2590
937,FL,-0.1187117828998914,0.0398063474986551,0.0406497923263264,-0.0543196339935866,953,743,913,2609
938,MBLY,-0.000773140088976,-0.0021310946076848,0.0,0.0084759061606259,886,919,814,2619
939,NEM,-0.0724238192489928,0.0131291912418195,0.0406504181821994,0.0027866364407585,944,848,837,2629
940,UGI,-0.3112606304208982,-0.1100022853660394,0.0638270800064158,0.0275616936391341,975,968,695,2638
941,NRG,-0.0171366520750619,0.0232192526303059,0.0323221011910821,-0.0715158301944416,908,810,925,2643
942,TTM,-0.0764647887017587,0.012611158036458,1.0411038202837614e-05,-0.0060260858314058,946,850,859,2655
943,ILMN,-0.0527729191742515,-0.0081957616204191,0.0,0.0127727737191771,938,928,799,2665
944,HUBS,-0.006088460922513,-0.098364887513622,0.0,0.0086586724360288,893,966,813,2672
945,INTC,0.0080219427920065,0.0001895804157315,0.0146665241810042,-0.0678184257709068,861,893,922,2676
946,MXL,-0.0381233945985341,-0.044539975388287,0.0,0.0122807708713311,928,947,804,2679
947,SNOW,-0.0130293827845126,-0.1993340316629926,0.0,0.0123212650018531,904,973,803,2680
948,AES,0.0193349251645215,-0.0053895289152503,0.0344767340283035,-0.3641799157494224,790,926,970,2686
949,WK,-0.0232169748876075,-0.1287202462007734,0.0,0.0124739012068168,916,970,801,2687
950,LUMN,-5.717031199437558,0.0403490355596378,0.0061067530776668,-0.5218498084551666,980,734,975,2689
951,BEP,-0.0067469334493962,0.0138000076668452,0.1311835337100432,-0.1273821053532194,895,847,954,2696
952,GWRE,-0.0160475527561572,-0.0903466461021124,0.0,0.0030082257046274,907,960,835,2702
953,MPW,-0.1893597756723873,0.0049744545443641,0.2094072562896341,-0.0080198089280522,968,881,862,2711
954,MANU,-0.009099910070897,-0.0141326854377719,0.0,-0.0241180300145991,899,931,884,2714
955,TSN,-0.0369862380372636,-0.0132764183920408,0.0382419436496398,-0.0106734977051979,927,930,864,2721
956,GME,0.0014908359206011,-0.0156077565820589,0.0,-0.0530915597993201,878,934,910,2722
957,NEWR,-0.0351284643148866,-0.4301764196358282,0.0,0.0066352914695669,925,979,822,2726
958,ENV,-0.088523550288856,-0.1290330519373163,0.0,0.0091095559094166,949,971,810,2730
959,LNC,-0.1644394633722437,0.0235447016865139,0.0846250961769392,-0.4535205412686614,962,806,973,2741
960,WBA,-0.1409766348620937,-0.0954600307935583,0.0759351419598095,0.0064538004920633,960,963,823,2746
961,CTLT,-0.0295610690913539,-0.0147708894878706,0.0,-0.0410287252043791,922,933,900,2755
962,HCP,-0.0450005540457791,-0.2032281139230895,0.0,-0.0045879002774241,935,974,852,2761
963,HL,-0.0290976124270932,-0.0156550712001917,0.005393608324587,-0.0509353243854653,921,935,907,2763
964,TTWO,-0.0589586848863523,-0.0944340368843928,0.0,-0.0106468470707016,940,961,863,2764
965,S,-0.0428511019461759,-0.2146949761456444,0.0,-0.0110247397273868,932,975,865,2772
966,W,-0.1049219483067474,-0.56855151045701,0.0,-0.0002843413233245,950,980,844,2774
967,RIG,-0.1956200787401575,-0.0045076099061356,0.0,-0.0539288057742782,971,924,911,2806
968,KMPR,-0.0873199620911857,-0.0638979400231954,0.0257049943531935,-0.0603313225767839,948,953,917,2818
969,TEO,-0.2842120131096284,-0.0648327914552615,0.0,-0.0302826449852364,974,954,892,2820
970,AA,-0.1075677461996034,-0.031901509705248,0.0118968935888962,-0.0727032385988103,951,944,926,2821
971,MU,-0.0763038034692394,-0.0965724755837213,0.0065930253640488,-0.0800189209362828,945,965,936,2846
972,SPR,-0.1818907427589065,-0.0267267140872932,0.0,-0.1103387855295021,965,942,949,2856
973,WDC,-0.1414389632009975,-0.0676493814161621,0.0,-0.1007317352222813,961,957,946,2864
974,BAK,-0.1342455948756865,-0.0623522238910285,0.0002052236654574,-0.1990962731602505,958,952,965,2875
975,MRNA,-0.1240856122285133,-0.275063266497956,0.0,-0.1006846556584776,955,977,945,2877
976,CEA,-0.3354717798420933,-0.0523955268384762,0.0,-0.1291733027621429,976,950,955,2881
977,KEP,-0.8010410416763826,-0.0253157364889634,0.0075282974070141,-2.0603174193197447,977,941,978,2896
978,NIO,-0.1932175677050099,-0.3802156801451961,0.0,-0.1436531229006565,969,978,958,2905
979,LPL,-1.1253666198746497,-0.1147541837967621,0.0,-1.0083417336205311,979,969,977,2925
