,ticker,eps,roce,divYield,fcfYield,eps_rank,roce_rank,fcfYield_rank,overall_rank
0,PBF,0.57541184,0.497484548,0.014721326,0.82781458,6,21,9,36
1,DQ,0.634915201,0.44335949,0.0,0.415233335,4,33,21,58
2,PBR,0.527250274,0.366559486,0.542769914,0.577825874,8,52,15,75
3,AMG,1.735059935,0.265616079,0.001999925,1.306451008,1,121,6,128
4,RRC,0.196368659,0.523872006,0.006411598,0.228558403,70,17,62,149
5,SWN,0.284601461,0.778613023,0.0,0.15992478,27,3,121,151
6,ERF,0.221426368,0.89771845,0.010073994,0.174610886,51,2,101,154
7,NUE,0.219991823,0.373606235,0.015430527,0.234937417,53,49,56,158
8,BTU,0.34549882,0.294452377,0.0,0.252884573,16,95,48,159
9,AR,0.199446755,0.359487423,0.013144486,0.303357392,67,57,36,160
10,LPX,0.23518711,0.620655412,0.014942827,0.158090783,39,10,124,173
11,MLI,0.197288137,0.463094424,0.016718587,0.205675751,69,26,79,174
12,CIVI,0.251683068,0.301313526,0.108273649,0.228162494,31,88,63,182
13,CVI,0.204465865,0.359328358,0.153349399,0.22002305,63,58,69,190
14,CF,0.193174129,0.438139308,0.017666253,0.195887573,73,34,85,192
15,CHK,0.415826671,0.296145409,0.102103307,0.193928889,12,93,87,192
16,AN,0.228008985,0.304253081,0.0,0.221668965,45,82,67,194
17,APA,0.232549736,0.390675398,0.014066549,0.16421728,40,44,112,196
18,SM,0.260930618,0.308645801,0.004608018,0.189246692,29,78,90,197
19,MPC,0.241730877,0.282611184,0.021298828,0.232155564,36,105,58,199
20,X,0.407952204,0.213497645,0.0,0.280588362,13,177,38,228
21,CPG,0.289509786,0.239178408,0.039150373,0.227329782,25,143,65,233
22,ICL,0.229432082,0.384514436,0.123908202,0.13581019,44,47,157,248
23,CRC,0.146868396,0.361210543,0.016536709,0.190032008,115,55,89,259
24,SQM,0.171288828,0.712109629,0.098151339,0.13171641,89,5,165,259
25,CTRA,0.207846313,0.274721797,0.101852363,0.191535619,60,116,88,264
26,OLN,0.172976009,0.274418461,0.015147948,0.219658282,88,117,70,275
27,TMHC,0.301687504,0.186697536,0.0,0.308676923,20,234,35,289
28,OXY,0.214324875,0.225297601,0.020294358,0.213570693,56,163,74,293
29,TX,0.294627118,0.176731184,0.08835083,0.362115537,23,253,27,303
30,MTDR,0.17958165,0.353364137,0.0052129,0.132334694,80,62,163,305
31,EQT,0.141465298,0.319187393,0.016265955,0.162815637,121,74,114,309
32,EC,0.32024605,0.241922689,0.128046653,0.137623549,18,141,153,312
33,GPI,0.27054777,0.227559892,0.008532245,0.15494845,28,160,129,317
34,GGB,0.219691652,0.287836111,0.113286399,0.128234241,54,99,166,319
35,PSX,0.22464305,0.210476772,0.0365371,0.175634838,47,185,100,332
36,MOS,0.23174962,0.209996527,0.012788015,0.173902773,41,188,104,333
37,E,0.297022318,0.285394955,0.064358044,0.107691177,22,102,211,335
38,HRB,0.11245636,0.367564482,0.036136532,0.152760094,166,51,131,348
39,PXD,0.143121415,0.322983706,0.114369427,0.135513814,119,71,158,348
40,MTH,0.293271421,0.252802701,0.0,0.111817355,24,130,203,357
41,NVR,0.113847204,0.449262032,0.301158389,0.122166695,164,30,179,373
42,UMC,0.176627857,0.245690075,0.07584877,0.127564974,84,136,168,388
43,FANG,0.181637437,0.26570857,0.065101243,0.116784672,79,120,190,389
44,MT,0.321056428,0.142372036,0.011458905,0.232457003,17,323,57,397
45,MTG,0.217642507,0.18824356,0.027904098,0.162665043,55,229,115,399
46,DDS,0.114003828,0.450823966,0.03468959,0.10589723,163,27,213,403
47,ABG,0.249494968,0.182112192,0.0,0.147125229,32,237,139,408
48,COP,0.119548257,0.346916599,0.036645253,0.116188362,153,64,193,410
49,SU,0.152349591,0.200727536,0.043571614,0.177240463,110,206,98,414
50,CNQ,0.128184488,0.218695826,0.057734003,0.167459081,136,169,110,415
51,DVN,0.148785055,0.391249515,0.083581829,0.084224956,114,43,267,424
52,CVE,0.125792754,0.22930948,0.018079052,0.149098543,142,156,137,435
53,ESNT,0.199454652,0.192662973,0.022102955,0.140311349,66,221,149,436
54,OC,0.150607162,0.198196115,0.016504894,0.159466406,111,209,123,443
55,WSM,0.127925495,0.495089978,0.024651005,0.079246269,137,22,284,443
56,CHRW,0.081692141,0.481352823,0.024782097,0.132169735,265,24,164,453
57,NNI,0.11936995,0.20070473,0.010727697,0.18304543,154,207,96,457
58,HPQ,0.124926491,0.276126558,0.039664065,0.113402472,146,115,200,461
59,WLK,0.171237973,0.167104975,0.012879047,0.174286268,90,272,102,464
60,TOL,0.176369753,0.178293779,0.011707929,0.153411764,85,250,130,465
61,XOM,0.120217588,0.238609169,0.03221978,0.125932992,151,144,172,467
62,EXPD,0.080129815,0.51588673,0.012620957,0.120593335,270,19,183,472
63,YPF,0.449540933,0.106703528,0.0,0.318087803,11,432,34,477
64,CIG,0.170873178,0.133895352,0.087399209,0.263951457,92,344,44,480
65,TKC,0.141399408,0.19639523,0.015966699,0.14156653,122,213,146,481
66,VALE,0.238719147,0.23571634,0.083897303,0.076731155,38,150,298,486
67,ACT,0.179281897,0.171922223,0.063848825,0.144392864,81,266,142,489
68,DHI,0.129610713,0.227387682,0.009318578,0.113491648,133,161,199,493
69,MUR,0.14450178,0.175303827,0.019198934,0.157483547,117,257,125,499
70,MUSA,0.102406574,0.296237381,0.004550389,0.104917658,198,92,215,505
71,LYB,0.14297916,0.172301976,0.119554444,0.155759626,120,263,127,510
72,TNET,0.083110924,0.342955326,0.0,0.118462331,259,66,186,511
73,MRNA,0.118156944,0.449964175,0.0,0.064730562,157,29,335,521
74,PAG,0.161399842,0.158251343,0.018022982,0.137599213,99,290,154,543
75,PFE,0.109175473,0.258144814,0.031261101,0.090588637,178,125,248,551
76,PHM,0.244608944,0.293601429,0.013468685,0.051944367,35,96,423,554
77,CVX,0.105660298,0.224562754,0.032772121,0.112021068,190,165,201,556
78,CLF,0.159668177,0.127515454,0.0,0.177010414,100,362,99,561
79,AB,0.078386735,0.448232405,0.103220662,0.08586073,276,31,258,565
80,MRO,0.194791012,0.107916525,0.011864347,0.214528972,72,427,72,571
81,STM,0.134202824,0.277801605,0.006581309,0.06367106,127,113,340,580
82,RHI,0.07905037,0.607008807,0.022743116,0.074810321,272,11,303,586
83,EVR,0.109066182,0.187649473,0.029126658,0.116314602,179,231,191,601
84,DOW,0.126117532,0.139430102,0.055214266,0.149100539,141,330,136,607
85,IBP,0.090919782,0.238071476,0.025502773,0.094512983,229,146,234,609
86,RIO,0.107691198,0.234117523,0.101682341,0.081366683,183,154,274,611
87,SIG,0.106364355,0.138348238,0.019623899,0.186074091,188,334,92,614
88,ASX,0.149395839,0.16537715,0.072852326,0.094964784,113,276,233,622
89,BBWI,0.078240757,0.334386391,0.018190976,0.079805572,278,67,282,627
90,CBT,0.116287022,0.18907261,0.022996085,0.091723022,159,225,243,627
91,BYD,0.107684565,0.171393048,0.008111496,0.119066293,184,267,184,635
92,MO,0.06916466,0.301079822,0.079184176,0.096607335,327,89,229,645
93,MCK,0.07086177,0.305019843,0.005812258,0.091582866,324,81,244,649
94,WES,0.114773024,0.153156161,0.069381824,0.114499082,162,300,198,660
95,LAZ,0.107793788,0.104821865,0.054838047,0.236523903,182,435,55,672
96,SSD,0.087761075,0.212270103,0.011533922,0.087393997,237,181,255,673
97,VIPS,0.098335489,0.167727965,0.0,0.115793897,211,271,196,678
98,KBH,0.299521729,0.188530021,0.019237379,0.050680585,21,228,436,685
99,ALSN,0.111848791,0.145072775,0.016851042,0.103212632,167,314,218,699
100,ITUB,0.120016312,0.080460864,0.027096808,0.490825581,152,537,17,706
101,WMS,0.07315415,0.285177592,0.005714577,0.078031853,313,103,291,707
102,MAS,0.078287543,0.393268648,0.0239315,0.057138776,277,42,388,707
103,MSM,0.060367316,0.255308762,0.031080375,0.106773922,378,127,212,717
104,TPR,0.092509132,0.201087423,0.027999826,0.078178124,227,203,290,720
105,WY,0.081742599,0.197435897,0.070307331,0.089960339,264,211,249,724
106,DKS,0.106393402,0.230369484,0.016633219,0.056892643,187,155,389,731
107,SYF,0.191056043,0.055962915,0.030153407,0.424048128,76,637,20,733
108,BBD,0.127271583,0.086289367,0.0,0.196236156,139,512,83,734
109,BBDO,0.127271583,0.086289367,0.0,0.196236156,139,512,83,734
110,MPLX,0.118908359,0.110660173,0.091864546,0.127018487,156,414,169,739
111,EXP,0.085467863,0.18893639,0.0069435,0.079920433,245,226,280,751
112,HP,0.100505525,0.141782855,0.046642343,0.101459876,204,325,223,752
113,OGN,0.129218442,0.17505626,0.040865156,0.060734077,134,258,364,756
114,ASR,0.073355857,0.224895199,0.03312071,0.078470924,309,164,288,761
115,AMAT,0.062290352,0.327696194,0.008858386,0.068995468,371,70,321,762
116,GFI,0.077102204,0.21870374,0.0,0.072753683,285,168,312,765
117,VSH,0.138633643,0.196052424,0.018488473,0.051398001,125,215,430,770
118,GSK,0.084169995,0.172300193,0.059300421,0.088001347,253,264,254,771
119,WSO,0.067777509,0.322105813,0.037481148,0.060675587,335,73,365,773
120,CTSH,0.077301091,0.204619097,0.019038347,0.075478271,282,193,299,774
121,PFSI,0.158151085,0.049898788,0.018166652,1.978987402,103,668,4,775
122,UPS,0.076619262,0.247131209,0.033930629,0.061936336,288,134,354,776
123,HCA,0.084781035,0.213889411,0.009810742,0.062004489,250,176,352,778
124,GEF,0.097782073,0.1205815,0.03171384,0.118661485,214,382,185,781
125,PAGP,0.481900752,0.032984473,0.06712633,0.807587761,9,763,10,782
126,WU,0.170788395,0.121103052,0.068307856,0.07003337,93,380,317,790
127,DVA,0.110631162,0.093585039,0.0,0.138418891,171,470,152,793
128,TROW,0.063207068,0.212115526,0.044929397,0.0860856,358,183,257,798
129,DFS,0.146235193,0.057791655,0.023406954,0.229874265,116,627,59,802
130,AEL,0.285224769,0.033580254,0.017338592,0.467835116,26,760,18,804
131,PM,0.05767631,0.356558451,0.049797451,0.061998209,397,59,353,809
132,CSL,0.07569632,0.207646982,0.011010374,0.06696339,294,190,326,810
133,BSMX,0.166214373,0.055787405,0.112236764,0.203611979,97,640,80,817
134,ACI,0.139292045,0.130055132,0.389971709,0.064423146,123,357,338,818
135,CSCO,0.0591592,0.213075713,0.029558494,0.089289915,389,179,251,819
136,WF,0.372306406,0.021626208,0.077620638,2.165865332,14,805,3,822
137,NVO,0.052137549,0.621765835,0.023759323,0.060221334,444,9,371,824
138,NLY,0.198971286,0.038039739,0.175205789,0.502598938,68,742,16,826
139,RDN,0.206817747,0.075092298,0.037702912,0.103174756,61,550,219,830
140,AYI,0.067450711,0.168284099,0.003275063,0.09969449,338,269,225,832
141,M,0.185644462,0.144106622,0.027286739,0.050472581,78,317,439,834
142,MXL,0.047195163,0.214846371,0.0,0.126929096,498,174,170,842
143,WD,0.084282491,0.06891134,0.031591153,0.615192414,252,580,12,844
144,TEX,0.100897585,0.198159943,0.01197318,0.050986913,202,210,433,845
145,TSM,0.085659946,0.278886788,0.024035827,0.043900805,244,109,494,847
146,SUN,0.131584167,0.087942478,0.099449929,0.103882237,129,504,216,849
147,NTAP,0.093352961,0.160289718,0.031655007,0.063603117,225,286,341,852
148,IP,0.111551074,0.102217529,0.049916139,0.092192809,168,447,240,855
149,MAN,0.086058401,0.138216984,0.032208588,0.080049508,241,335,279,855
150,CMC,0.130458324,0.082554034,0.011370644,0.111897419,131,525,202,858
151,MMP,0.098573575,0.114032826,0.082747018,0.091877724,210,407,242,859
152,RDY,0.058081102,0.406030447,0.006415943,0.051555628,394,39,429,862
153,SAN,0.206335158,0.027787158,0.039698841,0.362316375,62,780,26,868
154,SHG,0.245027262,0.020593394,0.081334641,0.350989307,34,812,29,875
155,TLK,0.075342368,0.193262827,0.040436641,0.061346326,296,219,360,875
156,THC,0.191678621,0.102865961,0.0,0.061528837,75,443,358,876
157,MFG,0.583531265,0.011936418,0.220015784,9.121836298,5,872,2,879
158,PSA,0.133953555,0.133464361,0.079594265,0.054115752,128,346,405,879
159,LKQ,0.077635602,0.161871608,0.019189305,0.069459877,281,281,319,881
160,EPD,0.104851334,0.088945794,0.078208782,0.116024017,191,497,194,882
161,COF,0.1873937,0.029387186,0.029993176,0.327811669,77,774,31,882
162,LRCX,0.053677695,0.35452199,0.010803613,0.055658231,426,61,399,886
163,EOG,0.1031081,0.400747392,0.018684107,0.028597581,197,40,649,886
164,LYG,0.174427459,0.026202722,0.047129603,0.580125471,86,786,14,886
165,HUN,0.08328083,0.103083295,0.030958743,0.116231072,256,442,192,890
166,SWKS,0.062537997,0.152544441,0.025783879,0.103103699,367,303,220,890
167,WAL,0.17716414,0.028268226,0.027848936,0.352602384,83,779,28,890
168,MMM,0.08511269,0.177055128,0.049635564,0.056604285,247,252,392,891
169,CE,0.170926602,0.06206089,0.026803168,0.115154353,91,603,197,891
170,DE,0.096812686,0.245497675,0.013589583,0.03924504,216,138,538,892
171,RKT,0.829262414,0.008248278,0.0,12.69571939,3,888,1,892
172,BBY,0.074105161,0.263042204,0.041204349,0.046687818,300,123,472,895
173,HMC,0.116160287,0.046468057,0.035665891,0.250030303,160,690,49,899
174,NXPI,0.067343666,0.190173295,0.01969325,0.06446821,339,223,337,899
175,PBA,0.117529171,0.088178328,0.065311566,0.091934633,158,501,241,900
176,QCOM,0.058629768,0.188061431,0.028066407,0.079845766,390,230,281,901
177,AZO,0.055676954,0.464808105,0.051884468,0.047214624,410,25,467,902
178,TS,0.123026868,0.200739096,0.025597286,0.037095303,148,205,554,907
179,PII,0.100746331,0.278441145,0.025044663,0.033726813,203,112,594,909
180,ABC,0.060215119,0.180878951,0.013883448,0.07821954,380,243,289,912
181,JWN,0.083077827,0.080799305,0.040352087,0.160391069,260,535,120,915
182,HOG,0.11591971,0.114251444,0.014568765,0.062038734,161,403,351,915
183,TEF,0.104782096,0.046867417,0.07278995,0.276101605,192,685,39,916
184,HDB,1.329161067,-0.00066128,0.231774465,1.163188334,2,908,7,917
185,CHTR,0.092303292,0.090307871,0.0,0.111421304,228,487,205,920
186,SEE,0.067550744,0.228604612,0.016283082,0.051666151,337,158,428,923
187,NSP,0.041421624,0.364837853,0.017689239,0.073296067,561,53,310,924
188,AGCO,0.085982645,0.210349585,0.03907687,0.043484253,242,186,498,926
189,BCS,0.225194144,0.010233871,0.075140691,1.082094328,46,878,8,932
190,AIT,0.062036441,0.21477693,0.009562235,0.056803387,372,175,391,938
191,CRH,0.088954417,0.107275683,0.030391654,0.080569369,233,431,277,941
192,BC,0.120724188,0.196175022,0.0193658,0.035272148,150,214,578,942
193,ABM,0.096786369,0.11020507,0.022145707,0.073446719,217,418,308,943
194,PAA,0.125792114,0.035452934,0.094859627,0.23690646,143,751,54,948
195,SNA,0.075002048,0.201159768,0.025757531,0.048619294,297,202,453,952
196,VZ,0.12838943,0.092461814,0.065263822,0.062823601,135,475,343,953
197,GIL,0.107339642,0.215606989,0.024532482,0.03348472,186,172,597,955
198,MCHP,0.048526959,0.235139642,0.015078337,0.067981549,482,151,323,956
199,BBVA,0.178183649,0.013953756,0.060643501,0.590503944,82,861,13,956
200,LNC,0.258460596,-0.00758096,0.059000578,0.767578485,30,915,11,956
201,HBAN,0.156070211,0.020967054,0.070433831,0.265905144,107,809,43,959
202,ABEV,0.062970357,0.181567807,0.053320468,0.061451183,359,241,359,959
203,VLO,0.230055259,0.360515613,0.031171609,-0.02035534,42,56,869,967
204,OMC,0.078499572,0.174339105,0.034649526,0.050581988,274,259,437,970
205,ALLY,0.220134167,0.006970484,0.063445904,0.348695603,52,891,30,973
206,FNF,0.109806196,0.028954207,0.047266928,0.407616838,175,776,22,973
207,FOX,0.073375458,0.114069491,0.017707233,0.085456647,307,405,261,973
208,FOXA,0.073375458,0.114069491,0.017707233,0.085456647,307,405,261,973
209,TXN,0.057371222,0.418627694,0.028177408,0.038839838,399,38,539,976
210,SBS,0.079888804,0.09140602,0.0,0.099665133,271,481,226,978
211,POOL,0.062819301,0.354976238,0.01264205,0.037033375,362,60,556,978
212,LOW,0.047384842,0.419845435,0.017446338,0.049762549,496,37,446,979
213,EME,0.054915342,0.203846869,0.003676194,0.060665117,418,195,367,980
214,BERY,0.081905578,0.077715356,0.017080474,0.124539516,262,543,175,980
215,BKNG,0.038056958,0.302125896,0.0,0.076985068,599,86,297,982
216,BDC,0.080782425,0.14407976,0.00283874,0.055893572,268,318,396,982
217,NYCB,0.156287975,0.018880216,0.084155064,0.245973228,106,826,51,983
218,THO,0.060178371,0.107641151,0.015430685,0.124359886,381,428,176,985
219,C,0.168598841,0.019226104,0.056820478,0.220751477,95,822,68,985
220,CIB,0.203965368,0.049092188,0.069476898,0.090966584,65,674,247,986
221,PKG,0.084903262,0.137255727,0.034652205,0.055305018,249,338,401,988
222,KB,0.229712746,-0.001443785,0.075149603,0.269283356,43,909,41,993
223,UNM,0.159634532,0.029716534,0.030877414,0.15991391,101,773,122,996
224,PFG,0.224618685,0.021310318,0.029984326,0.142690471,48,806,144,998
225,GOOG,0.051741036,0.25287535,0.0,0.051773821,451,128,426,1005
226,MFC,0.155712379,0.01189482,0.060416316,0.384457614,108,873,24,1005
227,GOOGL,0.051741036,0.25287535,0.0,0.051773821,451,128,426,1005
228,ULTA,0.047797874,0.44423196,0.0,0.045004079,490,32,484,1006
229,GWW,0.05463897,0.397095733,0.013068144,0.038038895,419,41,546,1006
230,SNV,0.138850116,0.021023274,0.042010522,0.212769333,124,808,77,1009
231,RLI,0.097962417,0.16324423,0.061262801,0.041064688,212,279,521,1012
232,UL,0.063595907,0.205271596,0.036025475,0.047060306,355,191,469,1015
233,LEG,0.070522103,0.114983404,0.052174519,0.077647157,325,401,293,1019
234,GIB,0.051746783,0.209820956,3.01e-05,0.057267427,450,189,387,1026
235,CHH,0.053201375,0.287227754,0.008416226,0.043803136,432,101,495,1028
236,HD,0.053261172,0.450717165,0.024253216,0.035795991,430,28,571,1029
237,KEY,0.119050551,0.017481171,0.053035561,0.270829135,155,836,40,1031
238,PCAR,0.087340479,0.138659021,0.029137661,0.047460717,238,332,465,1035
239,FITB,0.108258439,0.020041747,0.041028444,0.263608857,181,816,45,1042
240,DCI,0.04688545,0.238419145,0.014948984,0.05571894,504,145,398,1047
241,JBL,0.05449009,0.228414326,0.002997621,0.046896117,420,159,470,1049
242,SCCO,0.056514045,0.276516828,0.057955544,0.039710836,404,114,532,1050
243,ADM,0.085451658,0.155920602,0.017700701,0.042509247,246,296,509,1051
244,VRTX,0.044918261,0.274002405,0.0,0.053074401,525,118,411,1054
245,ORLY,0.039988479,0.530985798,0.0,0.04757625,581,16,464,1061
246,VLY,0.103610772,0.019340075,0.039915167,0.260183794,194,821,47,1062
247,SIVB,0.123165154,0.018441473,0.012007129,0.195134267,147,830,86,1063
248,BXMT,0.068832676,0.08181218,0.116654169,0.109854838,328,529,209,1066
249,ASGN,0.062436015,0.130256378,0.0,0.062948359,368,356,342,1066
250,BWA,0.099589877,0.061216492,0.016985138,0.089251098,209,606,252,1067
251,UBS,0.125308543,0.015671089,0.027397385,0.213594481,144,852,73,1069
252,KEYS,0.048653849,0.204703045,0.0,0.055788519,480,192,397,1069
253,SNY,0.059171188,0.116458439,0.036700225,0.078542708,388,396,286,1070
254,AXP,0.067717944,0.057561335,0.01410415,0.173251232,336,628,106,1070
255,MPW,0.135346589,0.038681939,0.104747002,0.110816325,126,740,207,1073
256,FLT,0.068726628,0.179713096,0.0,0.043452105,329,245,499,1073
257,CSX,0.062955924,0.15270911,0.012875287,0.052679873,360,302,413,1075
258,REGN,0.052973707,0.186825361,0.0,0.054028688,436,233,406,1075
259,WPP,0.076519957,0.122204027,0.040955606,0.053531466,289,378,410,1077
260,ORAN,0.087240725,0.0596924,0.075654702,0.099924372,239,615,224,1078
261,SF,0.104219627,0.027246363,0.026918885,0.169213055,193,781,108,1082
262,ARW,0.210451463,0.220672832,0.0,-0.016506075,57,166,860,1083
263,VAC,0.064920304,0.094602717,0.018207111,0.084046966,349,466,268,1083
264,SYY,0.047019831,0.212772935,0.026456365,0.055099052,502,180,402,1084
265,VTRS,0.15407682,0.009677419,0.043111267,0.186024819,109,882,93,1084
266,VIV,0.063768569,0.068054245,0.089123714,0.141239656,354,583,148,1085
267,IGT,0.060733287,0.070999647,0.035172875,0.148774706,376,571,138,1085
268,STT,0.097762284,0.016069534,0.034255566,0.395419187,215,848,23,1086
269,BNS,0.109397572,0.007564292,0.080047724,0.461831963,177,890,19,1086
270,LH,0.065385604,0.103878992,0.009978321,0.075348589,347,438,301,1086
271,ASB,0.106302553,0.017586651,0.039091496,0.227590223,189,834,64,1087
272,BP,-0.01227594,0.236718808,0.039424131,0.261105713,892,149,46,1087
273,ORI,0.09421456,0.037313614,0.079569027,0.160675355,223,746,119,1088
274,WIT,0.056211344,0.153739418,0.016251269,0.057334085,406,298,386,1090
275,HSBC,0.129629214,0.013885624,0.056346468,0.178045139,132,862,97,1091
276,AMCR,0.071532711,0.140370474,0.04934938,0.050168457,322,329,441,1092
277,AIG,0.208692122,0.030272533,0.020532088,0.085438669,59,770,263,1092
278,CFG,0.110627628,0.016332201,0.047602433,0.213090264,172,845,76,1093
279,QSR,0.074646073,0.092001939,0.048907785,0.070012174,299,478,318,1095
280,HPE,0.101358352,0.059227127,0.030983121,0.080085612,201,618,278,1097
281,TFC,0.109538218,0.01877093,0.052301874,0.184027705,176,827,95,1098
282,OTIS,0.038096454,0.68313172,0.01413795,0.043934059,598,7,493,1098
283,ABBV,0.041354061,0.165804863,0.035089459,0.084720621,562,273,265,1100
284,TRGP,0.07155876,0.104830446,0.022727613,0.062640102,321,434,345,1100
285,BAM,0.168598192,0.267837864,0.280322007,-0.034071802,96,119,886,1101
286,LII,0.058204948,0.675172343,0.01662664,0.023558309,393,8,702,1103
287,BCO,0.067152585,0.069463971,0.014800335,0.117024991,340,576,189,1105
288,CPB,0.062626914,0.133387556,0.032627309,0.056422616,365,347,393,1105
289,ZION,0.122947271,0.01514465,0.036463965,0.173508828,149,854,105,1108
290,CM,0.111449861,0.007827563,0.050448075,0.24855885,169,889,50,1108
291,SAIC,0.052122932,0.113425402,0.014420678,0.088087756,446,410,253,1109
292,KOF,0.068529062,0.103201294,0.041270812,0.063927815,332,441,339,1112
293,FNB,0.096144152,0.016950606,0.039192554,0.245884012,220,841,52,1113
294,USB,0.08851576,0.016322529,0.046727204,0.320920916,234,846,33,1113
295,CARR,0.101580184,0.120325122,0.014630536,0.039953723,200,383,531,1114
296,RBA,0.049895875,0.158612034,0.017984755,0.061050359,465,289,362,1116
297,PAYX,0.041168718,0.428833579,0.031062251,0.041144925,564,35,520,1119
298,NFG,0.100049077,0.10103723,0.036945897,0.047669263,208,450,462,1120
299,JPM,0.094637804,0.013978911,0.034066193,0.269070678,221,860,42,1123
300,DGX,0.052129714,0.126528442,0.016807149,0.072408503,445,365,313,1123
301,OKE,0.058576535,0.131633963,0.056854191,0.057953329,391,351,382,1124
302,PAC,0.064507378,0.257797861,0.051362661,0.028713256,351,126,648,1125
303,OGS,0.055115407,0.05312862,0.033295132,0.238951245,417,655,53,1125
304,XPO,0.048062481,0.126837463,0.0,0.081236042,488,364,275,1127
305,AON,0.040746219,0.295934828,0.00728679,0.047576601,572,94,463,1129
306,AVY,0.050886532,0.210340342,0.01605705,0.044528236,459,187,486,1132
307,MRK,0.05168276,0.173219816,0.024960363,0.052351977,454,260,418,1132
308,FIX,0.059478538,0.119894776,0.004855317,0.061225794,387,384,361,1132
309,RF,0.111366861,0.02056436,0.037800244,0.139593027,170,813,150,1133
310,CDW,0.046160506,0.212013098,0.011704764,0.050037243,511,184,442,1137
311,EPR,0.062321165,0.055655237,0.093947664,0.156207296,370,643,126,1139
312,ADP,0.037524557,0.545030109,0.020935447,0.039988068,602,14,529,1145
313,HIG,0.073691866,0.042656702,0.021397032,0.155625852,303,714,128,1145
314,AVGO,0.040335846,0.247601442,0.021897993,0.05050717,578,133,438,1149
315,LMT,0.044680923,0.225664315,0.023509711,0.047798922,528,162,460,1150
316,BK,0.069691573,0.022293827,0.037269959,0.371670331,326,801,25,1152
317,TGS,0.102107157,0.134174738,0.0,0.031931268,199,343,610,1152
318,WRB,0.06859673,0.054552734,0.011681881,0.124964618,331,651,174,1156
319,DECK,0.043376206,0.317050567,0.0,0.038304814,538,75,543,1156
320,NEP,0.208795331,0.005752946,0.118460152,0.109147247,58,894,210,1162
321,GILD,0.042620433,0.141140679,0.03442491,0.077444445,543,327,295,1165
322,ALB,0.080431698,0.194255801,0.007261372,0.025442422,269,218,680,1167
323,TEL,0.049085178,0.133572961,0.018631808,0.061677711,475,345,355,1175
324,TER,0.051701001,0.301975434,0.00503721,0.029963705,453,87,636,1176
325,POST,0.058568541,0.055241943,0.0,0.145847912,392,647,141,1180
326,UNP,0.054272258,0.16547915,0.024499294,0.044531481,424,275,485,1184
327,MAR,0.048819961,0.201934081,0.006645974,0.042049763,476,199,511,1186
328,BHP,0.042691135,0.278798342,0.043837628,0.039542412,542,110,535,1187
329,ARMK,0.103266789,0.072874422,0.01755775,0.05120584,195,562,432,1189
330,SKM,0.053199784,0.069301407,0.052711167,0.123197616,433,579,177,1189
331,DAR,0.073205392,0.12651552,0.0,0.041772196,311,366,513,1190
332,WTS,0.050884418,0.202937766,0.007991787,0.039635218,460,197,534,1191
333,BSBR,0.130513571,0.088532358,0.067535843,0.03638833,130,499,564,1193
334,AAPL,0.035983116,0.551446146,0.005573961,0.036943581,623,13,559,1195
335,TXT,0.057145219,0.088964588,0.001128303,0.075397177,400,496,300,1196
336,INFY,0.041353766,0.362799962,0.023541543,0.035152782,563,54,579,1196
337,GPC,0.048182823,0.186904157,0.020203484,0.045927394,486,232,479,1197
338,SPG,0.055419524,0.086644463,0.06715177,0.080727531,411,510,276,1197
339,CLH,0.066539874,0.124226042,0.0,0.045118813,344,374,483,1201
340,MTB,0.084129801,0.015398954,0.037214981,0.184143311,254,853,94,1201
341,BMY,0.040843505,0.137835313,0.029914462,0.077129477,570,337,296,1203
342,NOK,0.174196563,0.076833836,0.014468562,0.035782023,87,545,572,1204
343,CRI,0.086322265,0.198439265,0.040776929,0.01657032,240,208,757,1205
344,KMB,0.042225184,0.252068447,0.034015945,0.040544037,549,131,525,1205
345,IHG,0.035512911,0.23502994,0.022065355,0.051801499,630,152,425,1207
346,RH,0.072342981,0.163261454,0.0,0.031480928,316,278,618,1212
347,IPG,0.071927744,0.155859983,0.035066692,0.03302695,318,297,602,1217
348,AFL,0.096740296,0.039059505,0.021437019,0.084937893,218,737,264,1219
349,NEU,0.089538436,0.179098012,0.026990167,0.018945295,232,247,740,1219
350,V,0.035998435,0.311568078,0.00781741,0.041048178,622,76,522,1220
351,URI,0.081465894,0.148679731,0.0,0.028754945,266,308,646,1220
352,ODFL,0.043198037,0.42717804,0.004218427,0.028746245,539,36,647,1222
353,ALLE,0.049444665,0.178367198,0.015535125,0.042697304,471,249,507,1227
354,TRV,0.063958404,0.03319833,0.019556599,0.163699307,353,761,113,1227
355,PNC,0.089575415,0.017078112,0.039916738,0.134681922,231,840,160,1231
356,BX,0.054393382,0.061348122,0.118631502,0.11102404,421,605,206,1232
357,RY,0.09635808,0.009858765,0.035984318,0.151414282,219,881,133,1233
358,WBS,0.081275206,0.014709097,0.032986772,0.164899798,267,855,111,1233
359,DRI,0.049943968,0.144723691,0.029999951,0.048412943,464,315,456,1235
360,DPZ,0.036546782,0.720650338,0.012729874,0.03136048,609,4,622,1235
361,CNS,0.054311093,0.328986719,0.03408756,0.018244364,422,69,746,1237
362,PRI,0.068285791,0.036007723,0.015547806,0.135812962,333,749,156,1238
363,FRO,0.195707183,0.100992915,0.013824838,0.021913236,71,451,717,1239
364,MC,0.059578952,0.331594292,0.069210972,0.010714265,383,68,788,1239
365,IVZ,0.11058434,0.045300312,0.068654294,0.060450851,173,698,369,1240
366,AFG,0.076866925,0.043459491,0.103830267,0.091332972,286,710,246,1242
367,HII,0.062592781,0.097086159,0.020756155,0.052106598,366,456,422,1244
368,SON,0.078405508,0.127066274,0.03144931,0.031921319,275,363,611,1249
369,LDOS,0.047533035,0.119245945,0.013808867,0.059468338,493,387,374,1254
370,VRSN,0.030396568,1.529764801,0.0,0.036256637,688,1,568,1257
371,KNX,0.090700938,0.040993138,0.009207852,0.074704435,230,723,305,1258
372,SBUX,0.039610992,0.292076696,0.023354591,0.035295031,583,98,577,1258
373,HUM,0.042571458,0.153379449,0.00594726,0.052599873,544,299,415,1258
374,FHN,0.068662979,0.01898047,0.027160023,0.174175091,330,825,103,1258
375,ITW,0.043776634,0.345739828,0.022249034,0.027933936,534,65,660,1259
376,HST,0.055182947,0.071520856,0.013076528,0.079505289,415,567,283,1265
377,RGA,0.077153491,0.012052933,0.025225623,0.162182298,283,869,116,1268
378,RZA,0.077153491,0.012052933,0.025225623,0.162182298,283,869,116,1268
379,PKX,0.150094743,0.064479445,0.058165116,0.036582481,112,596,561,1269
380,CNA,0.077852538,-0.009380025,0.085515875,0.21335427,280,918,75,1273
381,TPX,0.075895393,0.201444385,0.011741552,0.012041336,291,200,782,1273
382,WFC,0.078597222,0.009569527,0.031559331,0.161272771,273,883,118,1274
383,LAD,0.22381643,0.164105035,0.008086733,-0.163380626,50,277,948,1275
384,GL,0.062659206,0.040845453,0.006823014,0.118106077,364,724,187,1275
385,ACN,0.033655725,0.265068547,0.013848098,0.044061357,661,122,492,1275
386,FAST,0.040029882,0.386719166,0.026196757,0.028255521,579,46,654,1279
387,FCX,0.063333212,0.157258425,0.015815041,0.030497827,357,293,629,1279
388,KLAC,0.0500691,0.386726386,0.002653431,0.013014123,463,45,774,1282
389,AMGN,0.046369322,0.107921673,0.029695616,0.062172541,508,426,348,1282
390,OHI,0.067070352,0.043025641,0.099427669,0.098301888,342,712,228,1282
391,APH,0.041905803,0.204409451,0.010516654,0.039449567,553,194,536,1283
392,BCE,0.052882148,0.093536122,0.063576585,0.059538513,439,471,373,1283
393,CAT,0.051450024,0.156788066,0.018723051,0.039648363,455,295,533,1283
394,CI,0.059546173,0.071363131,0.012359314,0.065734759,385,568,331,1284
395,UNH,0.040500935,0.18173045,0.012059697,0.047111524,576,240,468,1284
396,CVS,0.035259397,0.102504746,0.023776169,0.1100067,632,445,208,1285
397,FFIV,0.040911414,0.125165274,0.0,0.062071822,568,370,350,1288
398,SLF,0.088143695,0.013230159,0.045375266,0.1170633,235,866,188,1289
399,YUM,0.034831976,0.523080603,0.017061096,0.03017895,638,18,633,1289
400,NSC,0.056516298,0.132713324,0.020169578,0.03930216,403,349,537,1289
401,FBHS,0.052109017,0.1827966,0.009647319,0.03201156,447,236,609,1292
402,HES,0.051195243,0.212196,0.010708857,0.028073325,456,182,656,1294
403,PENN,0.046390288,0.059595923,0.0,0.126534159,507,617,171,1295
404,L,0.071447362,0.009324143,0.00430661,0.187372824,323,884,91,1298
405,MOH,0.041494828,0.214874519,0.0,0.035731658,559,173,573,1305
406,BXP,0.055299487,0.043381813,0.06492677,0.121547031,413,711,181,1305
407,CB,0.057373682,0.040726435,0.014848261,0.121410184,398,726,182,1306
408,AWI,0.061682098,0.140910602,0.013436909,0.032710664,373,328,605,1306
409,NRG,0.156620788,0.124845335,0.042586488,-0.001667543,105,371,831,1307
410,CMA,0.127622065,0.020463532,0.041690614,0.061648886,138,814,356,1308
411,PG,0.040002636,0.213158111,0.024567237,0.037635729,580,178,551,1309
412,LEN,0.108672063,0.147002138,0.0,0.00260059,180,311,820,1311
413,ENLC,0.085072763,0.008308041,0.037617555,0.121789807,248,887,180,1315
414,DOV,0.055142446,0.169800369,0.014883258,0.030266504,416,268,632,1316
415,PNR,0.064875112,0.110560137,0.01869763,0.037516674,350,415,552,1317
416,GD,0.048727869,0.116184748,0.01967801,0.049805919,477,398,445,1320
417,BEN,0.073416554,0.037827858,0.050505067,0.082323343,306,743,272,1321
418,FN,0.052273998,0.16805329,0.0,0.031847512,441,270,613,1324
419,K,0.042052672,0.134601136,0.034912479,0.05094506,551,341,434,1326
420,BUD,0.049387509,0.081300403,0.020205109,0.067333816,472,532,325,1329
421,KR,0.062342079,0.125456093,0.018947102,0.034254805,369,368,592,1329
422,CMCSA,0.036387642,0.096269203,0.032125477,0.085690526,614,457,259,1330
423,CCZ,0.036387642,0.096269203,0.032125477,0.085690526,614,457,259,1330
424,HI,0.192906904,0.026804802,0.020756878,0.046626787,74,784,473,1331
425,A,0.040801848,0.147379913,0.00871975,0.048501552,571,310,454,1335
426,ENS,0.049583891,0.096041063,0.00804878,0.053917828,467,461,407,1335
427,HSIC,0.049505637,0.11702961,0.0,0.046561064,470,395,475,1340
428,IT,0.029972321,0.297149267,0.0,0.036858402,692,91,560,1343
429,ITT,0.054259921,0.180360721,0.012995769,0.025710628,425,244,677,1346
430,NTRS,0.072477556,0.014592674,0.04322071,0.122810397,314,857,178,1349
431,EMN,0.071861475,0.10984583,0.034526131,0.031807538,319,420,614,1353
432,VOYA,0.065102288,0.004853875,0.015190534,0.17258489,348,898,107,1353
433,TT,0.045666556,0.19515442,0.016124337,0.031515513,520,217,617,1354
434,MA,0.02950066,0.499490897,0.00565355,0.029999765,699,20,635,1354
435,NOC,0.057930552,0.19715245,0.012447496,0.017346036,395,212,750,1357
436,EXPE,0.025647626,0.080126124,0.004881792,0.202412229,738,538,81,1357
437,EXR,0.043624201,0.095635187,0.040817403,0.06159816,536,464,357,1357
438,CHE,0.032758155,0.300047082,0.002889291,0.033143577,668,90,599,1357
439,G,0.041423693,0.144068859,0.010764529,0.045628959,560,319,480,1359
440,HLT,0.036116147,0.172487644,0.00353967,0.045440157,620,262,482,1364
441,BIIB,0.075724822,0.109025295,0.0,0.028359839,293,423,651,1367
442,WMB,0.051117513,0.069310796,0.051666359,0.065013294,457,578,333,1368
443,WWE,0.038338428,0.306900661,0.006997351,0.024637732,596,80,692,1368
444,FDX,0.071739587,0.066778145,0.021258181,0.047699962,320,589,461,1370
445,HSY,0.034357645,0.218113735,0.01618916,0.037773718,650,170,550,1370
446,AVT,0.165999028,0.144243023,0.022897257,-0.195620423,98,316,956,1370
447,GIS,0.051805199,0.111097173,0.025721854,0.041723367,449,412,514,1375
448,RE,0.046209111,0.018595487,0.01973756,0.286001116,510,829,37,1376
449,ALV,0.063417169,0.161717791,0.033582614,0.019190065,356,282,739,1377
450,ROK,0.042312598,0.161385006,0.016541987,0.037027335,547,283,557,1387
451,JNJ,0.038687495,0.181773272,0.025190754,0.037057277,593,239,555,1387
452,RL,0.066176628,0.132968278,0.025105845,0.024498139,345,348,695,1388
453,TJX,0.036163432,0.281423188,0.013843006,0.027158758,619,106,668,1393
454,BABA,0.039533616,0.07337246,0.012378867,0.089840485,584,559,250,1393
455,NDAQ,0.037180471,0.1299759,0.012657885,0.051358624,604,358,431,1393
456,VRSK,0.034241846,0.303000926,0.007007033,0.028153769,653,85,655,1393
457,ZBRA,0.034586752,0.258995574,0.0,0.030851682,643,124,627,1394
458,TSCO,0.043466311,0.234706429,0.016353206,0.023300353,537,153,706,1396
459,BOH,0.073516818,0.013316083,0.039210663,0.099040507,305,865,227,1397
460,CNI,0.046329723,0.146091414,0.018140829,0.035457898,509,313,575,1397
461,EMR,0.239519092,0.075091478,0.021706927,0.00496469,37,551,811,1399
462,BRO,0.042491096,0.103861617,0.00755833,0.052421286,546,439,417,1402
463,CAJ,0.083278526,0.094740544,0.040733123,0.025286583,257,465,686,1408
464,PB,0.07786526,0.021090274,0.02867195,0.068897148,279,807,322,1408
465,CLX,0.007580539,0.30387289,0.029660766,0.047314773,860,83,466,1409
466,KMI,0.062690927,0.028742003,0.061608352,0.082324898,363,777,271,1411
467,CMI,0.059904123,0.118338807,0.023811262,0.029130503,382,392,641,1415
468,FTNT,0.021489318,0.307848616,0.0,0.036331059,777,79,565,1421
469,BG,0.107646841,0.165554072,0.023334626,-0.408121937,185,274,963,1422
470,CR,0.07247528,0.190915008,0.01869248,-0.03706724,315,222,888,1425
471,HAL,0.044191564,0.151144612,0.012228582,0.034605481,531,306,589,1426
472,CNHI,0.093307777,0.138152181,0.019452533,-0.020326288,226,336,868,1430
473,JCI,0.050551509,0.089543616,0.02679312,0.045985743,461,493,478,1432
474,TREX,0.039043605,0.38366148,0.0,0.00845727,589,48,796,1433
475,WAT,0.0344412,0.349957687,0.0,0.02083757,647,63,725,1435
476,AKAM,0.039047356,0.090356217,0.0,0.060872542,588,485,363,1436
477,CL,0.026810839,0.368873383,0.025398952,0.027937345,729,50,659,1438
478,HTZ,0.353003098,0.099860302,0.0,-1.407211961,15,453,971,1439
479,ATHM,0.073842062,0.001611784,0.016010864,0.09293094,301,903,238,1442
480,GGG,0.040536492,0.280875319,0.012506917,0.015508401,575,108,760,1443
481,TDC,0.009499924,0.116256158,0.0,0.116014223,852,397,195,1444
482,OUT,0.055371732,0.052901589,0.077048698,0.05896584,412,656,376,1444
483,CX,0.093703336,0.003588345,0.0,0.069317085,224,901,320,1445
484,MSI,0.031575466,0.201235764,0.012278061,0.036301362,679,201,566,1446
485,DHR,0.042252771,0.114374482,0.004794391,0.043178827,548,402,501,1451
486,CACI,0.048662906,0.101215712,0.0,0.041023765,479,449,524,1452
487,STWD,0.168607637,0.023325668,0.114431472,0.036472919,94,797,562,1453
488,MMC,0.036936333,0.162849098,0.013781491,0.036270268,606,280,567,1453
489,PYPL,0.029432564,0.114142075,0.0,0.062138116,700,404,349,1453
490,CHT,0.041834453,0.10234824,0.040996273,0.048768492,556,446,452,1454
491,NVS,0.03515106,0.103573319,0.037935853,0.058450325,635,440,380,1455
492,LYV,0.026099458,0.089747553,0.0,0.094320474,734,489,235,1458
493,MTD,0.026837332,0.484308199,0.0,0.022694826,727,23,710,1460
494,TPL,0.0246581,0.685228829,0.013660392,0.023548447,753,6,703,1462
495,CFR,0.068053051,0.019506766,0.025434556,0.07286265,334,819,311,1464
496,HRL,0.045299712,0.096259889,0.033846517,0.044390032,523,459,487,1469
497,SRC,0.053143924,0.040304288,0.06678728,0.074039018,434,729,307,1470
498,EDR,0.085976259,0.017702909,0.0,0.055970628,243,833,395,1471
499,AMX,0.064265907,0.151317184,0.001278857,0.003424883,352,304,815,1471
500,AXS,0.048527078,0.014023562,0.039066296,0.150577229,481,859,135,1475
501,RCI,0.052462201,0.0817681,0.031539776,0.042812903,440,530,505,1475
502,JHX,0.053131792,0.196044212,0.013448985,0.00080943,435,216,825,1476
503,AAP,0.05331103,0.107421933,0.035715815,0.031470134,429,429,619,1477
504,ABT,0.035651958,0.141851431,0.017016058,0.040130951,628,324,527,1479
505,VMW,0.025375708,0.107290672,0.043451555,0.074350439,744,430,306,1480
506,FMS,0.074981721,-0.008821764,0.044070534,0.084229095,298,917,266,1481
507,FMC,0.046846139,0.143711763,0.017014721,0.027993192,505,320,658,1483
508,HHC,0.047803957,0.040791981,0.0,0.083739109,489,725,269,1483
509,ROST,0.036847014,0.203505812,0.010510253,0.025229359,607,196,687,1490
510,UAL,0.06037189,0.006903686,0.0,0.102148911,377,892,222,1491
511,CNC,0.025481534,0.075114655,0.0,0.111444614,741,549,204,1494
512,SLB,0.045456131,0.153003182,0.011202208,0.026486353,521,301,674,1496
513,BIP,0.100371341,0.055548675,0.103510227,0.028979944,207,646,643,1496
514,SJR,0.04542356,0.091719298,0.035197313,0.043699367,522,479,496,1497
515,CPA,0.10312339,0.057418073,0.0,0.026741554,196,630,671,1497
516,BR,0.032347335,0.160468862,0.016979016,0.038374629,672,284,542,1498
517,WST,0.033460803,0.236942346,0.003089656,0.025094175,663,148,688,1499
518,MET,0.043679779,0.004659406,0.030673905,0.227155493,535,899,66,1500
519,ST,0.049558023,0.067151161,0.008146603,0.049533139,468,585,447,1500
520,CME,0.044611198,0.082654118,0.043657967,0.049175101,529,523,448,1500
521,LUMN,-0.294339177,0.086786993,0.148310438,0.326853388,963,506,32,1501
522,MSCI,0.023177814,0.322294481,0.009928351,0.02722197,762,72,667,1501
523,WEX,0.027724389,0.089747366,0.0,0.077516201,719,490,294,1503
524,GS,0.094617922,0.031319375,0.030937145,0.041675241,222,768,515,1505
525,RHP,0.028644642,0.089843225,0.001300182,0.073372235,709,488,309,1506
526,BMO,0.05788554,0.00502224,0.035845272,0.104949865,396,897,214,1507
527,ANET,0.036365364,0.27857346,0.0,0.012050632,616,111,781,1508
528,J,0.038524625,0.096050059,0.007430915,0.048448328,594,460,455,1509
529,INGR,0.075891189,0.134178553,0.02791932,-0.022829057,292,342,876,1510
530,ESI,0.041988449,0.071348672,0.017584906,0.056859358,552,569,390,1511
531,CCK,0.073169009,0.128845597,0.010668384,-0.003623225,312,361,838,1511
532,CW,0.045919565,0.094532372,0.004489649,0.040024317,516,467,528,1511
533,SID,0.110373903,0.117742279,0.191283949,-0.169735483,174,393,950,1517
534,LEA,0.044725737,0.070894609,0.025317742,0.052300587,526,572,419,1517
535,MSFT,0.028425442,0.287573865,0.007777999,0.023363458,713,100,705,1518
536,VMI,0.035599015,0.157373239,0.006501149,0.033060881,629,292,600,1521
537,FICO,0.019785872,0.53232339,0.018754818,0.021412657,787,15,720,1522
538,KMX,0.04421578,0.044030824,0.0,0.078498465,530,706,287,1523
539,CTAS,0.028089001,0.246390317,0.009375093,0.026394818,715,135,675,1525
540,IBN,0.04087533,0.042929729,0.002254939,0.091568611,569,713,245,1527
541,APO,0.053469873,0.011076198,0.025792259,0.096157267,428,876,230,1534
542,MCD,0.031827528,0.200949961,0.021475621,0.028272989,677,204,653,1534
543,UHS,0.065582951,0.086664509,0.005673782,0.02543509,346,509,681,1536
544,KO,0.034659857,0.149358562,0.027663956,0.034630798,642,307,588,1537
545,ADSK,0.017708613,0.181868334,0.0,0.043572225,803,238,497,1538
546,EW,0.032953263,0.240505633,0.0,0.020643696,667,142,730,1539
547,OFC,0.059517945,0.012077906,0.042531,0.078924767,386,868,285,1539
548,FDS,0.028085383,0.181038613,0.008315273,0.035083901,716,242,581,1539
549,GNRC,0.062880449,0.135569388,4.86e-05,-0.004355492,361,339,841,1541
550,AU,0.036396047,0.045612089,0.024876759,0.095095394,613,696,232,1541
551,TSLA,0.032636206,0.245483471,0.0,0.019587429,670,139,734,1543
552,PH,0.041601648,0.072617688,0.014061789,0.051912443,558,563,424,1545
553,CBOE,0.017619545,0.175688647,0.01570014,0.044333775,804,255,488,1547
554,EBAY,-0.055055561,0.141745582,0.021132001,0.078002581,929,326,292,1547
555,AEM,0.052898892,0.058894193,0.048010166,0.044071216,437,621,491,1549
556,SCI,0.051845529,0.064998373,0.014676352,0.041819921,448,593,512,1553
557,COST,0.026046546,0.229137839,0.005178676,0.027921798,735,157,661,1553
558,ADBE,0.019524509,0.308900037,0.0,0.024970365,790,77,689,1556
559,EDU,0.028890584,0.045888426,0.0,0.134883274,706,693,159,1558
560,ZTS,0.030764316,0.245620003,0.008891673,0.019296823,684,137,738,1559
561,ROL,0.020490652,0.303018467,0.011763979,0.024198714,782,84,696,1562
562,MMS,0.035443276,0.090350477,0.014912543,0.048993223,631,486,449,1566
563,NKE,0.031043081,0.178815208,0.012319266,0.029830748,681,248,638,1567
564,JLL,0.084758333,0.089664931,0.0,-0.000764055,251,491,830,1572
565,CDNS,0.019486909,0.283341184,0.0,0.025655289,791,104,678,1573
566,MKTX,0.02394614,0.280877047,0.010138524,0.022714974,758,107,709,1574
567,ADI,0.041101681,0.083852115,0.020821371,0.044097488,566,521,490,1577
568,WTM,-0.047733659,0.122509876,0.000750529,0.081632562,927,377,273,1577
569,HON,0.033472659,0.16045067,0.018327056,0.030385571,662,285,630,1577
570,CPRT,0.029366562,0.23803728,0.0,0.020109485,701,147,733,1581
571,AJG,0.029157254,0.102815544,0.011239491,0.050838087,703,444,435,1582
572,IDXX,0.019905971,0.594829652,0.0,0.011553506,786,12,784,1582
573,AVB,0.050118663,0.041523984,0.039240099,0.054988322,462,718,403,1583
574,FR,0.04185371,0.045909291,0.024379429,0.064490058,555,692,336,1583
575,FAF,0.046961099,0.016817127,0.038747371,0.092850842,503,843,239,1585
576,TRQ,0.158565065,0.077785186,0.0,-0.12712756,102,542,942,1586
577,BAK,-0.041738787,0.066894241,0.068717822,0.208897538,920,588,78,1586
578,ATO,0.056249781,0.05042185,0.027325715,0.041512583,405,664,517,1586
579,WHR,-0.188678911,0.110515501,0.049319555,0.103697525,955,416,217,1588
580,PEP,0.035738524,0.176019082,0.024756248,0.022477967,625,254,712,1591
581,FCN,0.044017619,0.122932171,0.0,0.025320308,532,375,684,1591
582,WNS,0.030589245,0.139346993,0.0,0.035648836,686,331,574,1591
583,RSG,0.036434704,0.093197883,0.014521468,0.042518585,612,472,508,1592
584,PDI,0.035733333,0.020032248,0.153051757,0.133155494,626,817,162,1605
585,MPWR,0.026924629,0.293394264,0.008487306,0.011554954,725,97,783,1605
586,INCY,0.019104543,0.125301094,0.0,0.05003028,792,369,444,1605
587,JBHT,0.053588771,0.111276443,0.009217027,0.013051576,427,411,773,1611
588,IEX,0.033955119,0.151238854,0.010263483,0.028314253,656,305,652,1613
589,FL,0.083261712,0.092266158,0.036518295,-0.027266994,258,476,883,1617
590,GM,0.204362083,0.059671187,0.008167077,-0.105822283,64,616,937,1617
591,CBU,0.055284414,0.018657856,0.027450118,0.059281108,414,828,375,1617
592,TTC,0.039065388,0.159772972,0.016813402,0.018638112,587,287,744,1618
593,DG,0.047045774,0.143488513,0.009614167,0.008255889,501,321,797,1619
594,FTV,0.032980038,0.075010446,0.004345225,0.052727884,666,552,412,1630
595,CAH,0.010574178,0.074863557,0.021269898,0.095532228,846,553,231,1630
596,GLW,0.049761177,0.059118566,0.035241198,0.038228381,466,620,545,1631
597,FLO,0.037639151,0.110317405,0.030735218,0.031611455,601,417,616,1634
598,WPC,0.039210741,0.049611723,0.054663519,0.058842716,586,671,378,1635
599,EA,0.024037417,0.130921958,0.006294087,0.040252183,756,354,526,1636
600,OGE,0.084117233,0.088312776,0.041610042,-0.026257415,255,500,882,1637
601,SHW,0.032991383,0.179122603,0.010101069,0.020829271,665,246,726,1637
602,FISV,0.038972686,0.06514431,0.053314018,0.048353858,590,591,457,1638
603,UAA,0.100442163,0.081084409,0.0,-0.051344394,205,533,902,1640
604,UA,0.100442163,0.081084409,0.0,-0.051344394,205,533,902,1640
605,ADT,0.025097197,0.036813042,0.018423954,0.141588812,749,747,145,1641
606,HIW,0.019914271,0.042059341,0.072305466,0.143400904,785,716,143,1644
607,ABB,0.042787838,0.147530837,0.02935505,0.009076208,541,309,795,1645
608,PBH,-0.026341729,0.108194327,0.0,0.071028512,905,425,316,1646
609,KT,0.143786018,0.055812719,0.054302798,-0.044425338,118,639,892,1649
610,WM,0.034558335,0.124754384,0.01663062,0.030095708,644,373,634,1651
611,BLK,0.048416387,0.054885072,0.027957705,0.041356832,484,649,518,1651
612,JKHY,0.030049579,0.202471929,0.012067253,0.014307821,689,198,766,1653
613,AER,-0.09817252,0.068646643,0.0,0.152166159,942,581,132,1655
614,WMT,0.029803378,0.135285664,0.015600844,0.031242514,694,340,623,1657
615,CRL,0.043915179,0.099977961,0.0,0.026635543,533,452,673,1658
616,TU,0.048453545,0.064547143,0.035642608,0.034922555,483,595,582,1660
617,PEAK,0.037048502,0.048778462,0.047975259,0.058613742,605,676,379,1660
618,AME,0.036050185,0.109732217,0.006285438,0.031412362,621,421,621,1663
619,DLTR,0.048130978,0.118971745,0.0,0.010756025,487,389,787,1663
620,OSK,0.030013518,0.070239982,0.016793072,0.05550516,691,573,400,1664
621,HOLX,0.026626218,0.084266263,0.0,0.052610138,731,520,414,1665
622,T,-0.052104944,0.088012,0.074731255,0.093969304,928,502,236,1666
623,COTY,0.048705173,0.05478196,0.001312989,0.038613369,478,650,541,1669
624,BCH,0.158099717,0.049682287,0.06055378,-0.046183801,104,670,895,1669
625,BRX,0.023790536,0.055779683,0.042595481,0.083296438,759,641,270,1670
626,SEM,0.052267163,0.061946882,0.021232775,0.031050168,442,604,625,1671
627,WAB,0.034808177,0.067180544,0.006103804,0.048885418,640,584,450,1674
628,FUL,0.041893492,0.091393937,0.009109261,0.029402325,554,482,640,1676
629,REG,0.032322267,0.050053206,0.040494052,0.062470326,673,667,346,1686
630,VC,0.033729354,0.143462898,0.0,0.023392939,660,322,704,1686
631,NNN,0.023364909,0.060650559,0.047620566,0.072375406,760,613,314,1687
632,MAIN,0.087789165,0.082590289,0.070554429,-0.089725856,236,524,929,1689
633,RJF,0.081754217,0.092049515,0.0,-0.173333984,263,477,951,1691
634,NYT,0.031903465,0.157707198,0.010418319,0.020863422,676,291,724,1691
635,TEVA,-0.232436384,0.085963672,0.0,0.102931879,958,514,221,1693
636,RMD,0.027989492,0.188859995,0.008054109,0.017441246,718,227,749,1694
637,DISH,0.309457842,0.043915079,0.0,-1.051536439,19,707,969,1695
638,CUBE,0.022001575,0.065383337,0.042758307,0.065331161,773,590,332,1695
639,CMG,0.023266863,0.193219389,0.0,0.021841352,761,220,719,1700
640,ENB,0.028015543,0.060863616,0.068159026,0.059790747,717,611,372,1700
641,H,0.04610819,0.040221607,0.0,0.04793225,514,730,458,1702
642,KBR,0.02588838,0.091588785,0.008992806,0.044282756,737,480,489,1706
643,FNV,0.02680602,0.124790925,0.007560476,0.032828383,730,372,604,1706
644,GHC,0.023018733,0.082229825,0.010539086,0.052475806,763,527,416,1706
645,LNT,0.049522859,0.052134831,0.030897644,0.035084708,469,658,580,1707
646,CAG,0.040971236,0.06242938,0.037387152,0.037950537,567,599,547,1713
647,IQV,0.02838384,0.091047118,0.0,0.041261935,714,483,519,1716
648,TDG,0.026914364,0.146369554,0.00078794,0.025628778,726,312,679,1717
649,MNST,0.022282257,0.217349252,0.0,0.01263208,769,171,779,1719
650,TMO,0.032195231,0.104682199,0.002107745,0.032014567,674,437,608,1719
651,STR,0.465213494,0.037708111,0.337300116,-0.99378758,10,744,968,1722
652,PAYC,0.015653909,0.248236616,0.0,0.012700801,814,132,778,1724
653,ORCL,0.028978667,0.122827825,0.012500735,0.028866201,705,376,644,1725
654,TAP,-0.016689504,0.081928075,0.029468384,0.075223577,896,528,302,1726
655,MTN,0.028715415,0.104855888,0.033663091,0.034766204,708,433,586,1727
656,FSS,0.042825105,0.119660664,0.007754047,0.006686977,540,385,803,1728
657,MCO,0.026815921,0.157257391,0.010051091,0.023244368,728,294,707,1729
658,BSAC,0.125235167,0.049727329,0.073498973,-0.074653359,145,669,916,1730
659,LLY,0.018929883,0.220307496,0.010718082,0.013945208,795,167,768,1730
660,AOS,0.027237564,0.097201952,0.020477286,0.037106414,722,455,553,1730
661,BMI,0.02087368,0.177164196,0.007810365,0.024032858,781,251,699,1731
662,HAE,0.027461434,0.092710734,0.0,0.038756696,720,474,540,1734
663,BAH,0.022186906,0.096022046,0.01924284,0.042995044,771,462,502,1735
664,AA,0.007168833,0.129467697,0.008748407,0.041554932,862,359,516,1737
665,LHX,0.025338398,0.085483638,0.02061429,0.045475506,745,517,481,1743
666,STN,0.034345457,0.090409861,0.010873744,0.031898169,651,484,612,1747
667,MGA,0.036286356,0.101661604,0.031505384,0.025375932,617,448,682,1747
668,HWM,0.028604071,0.10475322,0.002683538,0.032934324,710,436,603,1749
669,ESS,0.029618721,0.04831078,0.041051505,0.058934666,695,679,377,1751
670,ABMD,0.00906817,0.242806215,0.0,0.016582984,857,140,756,1753
671,STOR,0.028880643,0.044142421,0.042834828,0.062784845,707,703,344,1754
672,EPAM,0.022337221,0.175666561,0.0,0.02036982,768,256,731,1755
673,STZ,-0.000893855,0.13104545,0.013644637,0.039968082,874,352,530,1756
674,SSL,0.060312332,0.062362351,0.0,0.012802357,379,601,777,1757
675,MLM,0.04116733,0.089068497,0.007556209,0.024193168,565,495,697,1757
676,THG,0.024113276,0.013365497,0.022637377,0.146446576,755,863,140,1758
677,INTU,0.01658,0.130929554,0.006182726,0.033285184,808,353,598,1759
678,NFLX,0.034254837,0.138522023,0.0,0.012342687,652,333,780,1765
679,NJR,0.067150525,0.0710186,0.038296174,-0.015708298,341,570,858,1769
680,ATR,0.033267194,0.115410972,0.01382764,0.022661337,664,399,711,1774
681,BAP,0.112741787,0.043480462,0.029113741,-0.049428377,165,709,900,1774
682,ETN,0.03934418,0.072482987,0.020758769,0.030922416,585,564,626,1775
683,TRI,0.034186753,0.109036861,0.015163917,0.023914422,654,422,700,1776
684,JBT,0.044721066,0.085791431,0.004482372,0.018716468,527,515,742,1784
685,SXT,0.046124815,0.115095343,0.022561994,-0.022017546,512,400,872,1784
686,SNPS,0.017219674,0.172742825,0.0,0.021161855,805,261,722,1788
687,TRMB,0.035777888,0.087981539,0.0,0.027686691,624,503,665,1792
688,AIZ,0.040678243,0.015862685,0.022089198,0.060384984,573,851,370,1794
689,ICE,0.025214564,0.055726526,0.014874151,0.053567869,747,642,409,1798
690,VEEV,0.018979777,0.120893179,0.0,0.030276245,794,381,631,1806
691,EGP,0.029518925,0.049489537,0.030748312,0.050180841,698,672,440,1810
692,ENPH,0.011080286,0.183258308,0.0,0.019473889,844,235,736,1815
693,ALGN,0.021926444,0.159767632,0.0,0.016787596,774,288,753,1815
694,SNX,0.066858885,0.06077754,0.011799599,-0.017107499,343,612,861,1816
695,MDT,0.031071895,0.06697437,0.029897811,0.037868356,680,587,549,1816
696,ADC,0.027321854,0.033007564,0.040819052,0.064904303,721,762,334,1817
697,PPG,0.034371081,0.113961181,0.019095045,0.014907535,649,408,762,1819
698,SKX,0.057137932,0.074416806,0.0,-0.018482963,401,556,863,1820
699,TDY,0.042135549,0.075756395,0.0,0.021062431,550,548,723,1821
700,SAM,0.016572557,0.132603538,0.0,0.026945342,809,350,669,1828
701,MDU,0.059551241,0.070161045,0.028668049,-0.023753734,384,574,878,1836
702,DB,0.245612064,0.012821305,0.018048597,-0.108913947,33,867,939,1839
703,PLD,0.03799129,0.031492168,0.029031183,0.046589928,600,766,474,1840
704,LIN,0.025441111,0.084980769,0.014380025,0.034913278,742,519,583,1844
705,AIN,0.030044714,0.126505742,0.008303224,0.009997753,690,367,791,1848
706,SAP,0.01515802,0.085398845,0.025337063,0.042201908,821,518,510,1849
707,ACM,0.004807086,0.060213092,0.008356887,0.060464759,868,614,368,1850
708,CP,0.037450214,0.068253607,0.007528377,0.02752596,603,582,666,1851
709,SBAC,0.015248091,0.093586375,0.010137196,0.036457534,819,469,563,1851
710,VAL,0.034755985,0.13035358,0.0,-0.015654962,641,355,857,1853
711,SMFG,0.553914841,0.01186363,0.207311999,-4.25781041,7,874,973,1854
712,DLB,0.025217868,0.085725736,0.010218327,0.034232133,746,516,593,1855
713,PWR,0.024022499,0.08670169,0.002008017,0.034309612,757,507,591,1855
714,ANSS,0.024902225,0.094463206,0.0,0.028845184,750,468,645,1863
715,NI,0.07203466,0.057338026,0.039112464,-0.071102984,317,632,915,1864
716,ATI,0.034382675,0.082517161,0.008930565,0.024690385,648,526,691,1865
717,CHD,0.021138735,0.083470636,0.013023381,0.036077319,779,522,570,1871
718,DEO,0.012042859,0.189166994,0.005679559,0.00594725,840,224,809,1873
719,SJM,-0.005515944,0.089659892,0.025990792,0.043317986,881,492,500,1873
720,TR,0.025916679,0.119265166,0.008405677,0.016619206,736,386,754,1876
721,CS,-1.000265352,0.003799,0.038334834,1.695221131,971,900,5,1876
722,O,0.022404936,0.027129551,0.046732726,0.066071431,767,782,329,1878
723,IPGP,0.022871293,0.118813076,0.0,0.021331196,766,391,721,1878
724,IR,0.028554665,0.062427913,0.001529967,0.03615728,712,600,569,1881
725,MAC,-0.026878276,0.019071967,0.076955322,0.139394995,906,824,151,1881
726,RTX,0.034900871,0.060985386,0.021006335,0.029501544,637,607,639,1883
727,PKI,0.032703896,0.059130452,0.001995733,0.033550829,669,619,596,1884
728,MKL,-0.00565648,0.016039782,0.002012127,0.137200797,882,849,155,1886
729,CPT,0.054291991,0.029984123,0.032961793,0.024527348,423,771,694,1888
730,CIEN,0.041701152,0.076570723,0.081549189,0.010168079,557,546,789,1892
731,LXP,0.040571938,-0.035721531,0.050797736,0.057660339,574,934,384,1892
732,MDLZ,0.029582867,0.06492743,0.021612805,0.032685965,696,594,606,1896
733,AXTA,0.033931329,0.07469905,0.0,0.025306821,657,555,685,1897
734,GMED,0.025485562,0.118915115,0.0,0.013994015,740,390,767,1897
735,WTW,0.036834282,0.069334903,0.013470614,0.022195484,608,577,715,1900
736,WCN,0.024492737,0.079515631,0.007122561,0.032527992,754,539,607,1900
737,CUZ,0.073661919,0.025717791,0.050647229,0.006038683,304,789,808,1901
738,TGT,0.035701228,0.113728388,0.023578221,-0.019391674,627,409,865,1901
739,SR,0.073221229,0.048912154,0.055715464,-0.074837146,310,675,917,1902
740,R,0.224136618,-0.030978436,0.031797928,-0.082984838,49,932,924,1905
741,TECH,0.022233157,0.119092512,0.00391917,0.01684647,770,388,752,1910
742,AEG,-0.085288416,-0.004058917,0.013895771,0.229072205,937,912,61,1910
743,JNPR,0.045753404,0.071621733,0.026266922,-0.000728557,518,566,829,1913
744,DEI,-0.019465835,0.025772719,0.071413433,0.093898295,898,788,237,1923
745,EFX,0.02926481,0.11077659,0.0080329,0.005573849,702,413,810,1925
746,SYK,0.025501233,0.092900821,0.011366326,0.022018876,739,473,716,1928
747,BAC,0.097860598,0.016890151,0.030487231,-0.022492154,213,842,874,1929
748,HE,0.052898765,0.024059335,0.033764026,0.024038739,438,794,698,1930
749,TFX,0.031018572,0.07873937,0.005448723,0.022460723,682,540,713,1935
750,STAG,0.018044469,0.034868305,0.046198003,0.058040941,800,755,381,1936
751,MKC,0.029852999,0.089099819,0.01736464,0.017049477,693,494,751,1938
752,PTC,0.014587682,0.081763889,0.0,0.034829295,825,531,585,1941
753,VNO,-0.095872602,-0.011371494,0.1174385,0.200194558,941,920,82,1943
754,QRVO,0.010167019,0.029850688,0.0,0.067444812,849,772,324,1945
755,PSO,0.035198626,0.046364414,0.022690024,0.031126058,633,691,624,1948
756,PGR,0.009518153,0.016667572,0.003440519,0.086498439,850,844,256,1950
757,DOC,0.011528937,0.026258912,0.063868457,0.066648064,843,785,327,1955
758,APTV,0.034444602,0.074137121,0.002497135,0.016607927,646,557,755,1958
759,GPN,0.001990468,0.044998931,0.009462393,0.056244446,871,700,394,1965
760,CCI,0.028585335,0.067007461,0.044405398,0.026759287,711,586,670,1967
761,IRM,0.03842049,0.073815277,0.049968206,0.003042841,595,558,816,1969
762,KIM,-0.000947312,0.031730569,0.041784528,0.066052138,875,765,330,1970
763,FRC,0.075468825,0.014708239,0.015773664,0.002492964,295,856,821,1972
764,TRNO,0.046118652,0.041321065,0.025016668,0.017840368,513,721,747,1981
765,UGI,-0.31126063,-0.11106879,0.06382708,0.229404473,965,958,60,1983
766,APD,0.036511215,0.088754639,0.023755623,-0.022541334,611,498,875,1984
767,PRU,-0.036509133,-0.001559288,0.047181433,0.133936065,914,910,161,1985
768,XYL,0.017815388,0.097767997,0.01088997,0.019471466,802,454,737,1993
769,DXC,-0.09889235,-0.061831488,0.0,0.167732607,943,942,109,1994
770,LW,0.012615404,0.129159764,0.008690751,0.008037689,838,360,798,1996
771,ARE,0.022152234,0.019091734,0.03217743,0.054963197,772,823,404,1999
772,EVRG,0.052231043,0.048745773,0.037110618,-0.025300171,443,677,880,2000
773,WEC,0.047656722,0.051640988,0.031039598,-0.009245262,492,661,849,2002
774,POR,0.053254587,0.044293205,0.036112552,-0.021027562,431,702,870,2003
775,TEO,-0.491679368,-0.179262728,0.002938504,0.218891045,970,964,71,2005
776,HEI,0.018571955,0.095768104,0.001259463,0.018374316,798,463,745,2006
777,ALL,-0.037090697,-0.015065952,0.028035564,0.127832381,915,925,167,2007
778,CINF,-0.029890159,-0.021558984,0.026015509,0.125280359,911,927,173,2011
779,ZBH,0.008658883,0.056880018,0.007528813,0.04104176,858,634,523,2015
780,BFAM,0.021904042,0.052309071,0.0,0.03489338,775,657,584,2016
781,ED,0.049283674,0.045453758,0.032331277,-0.006917528,474,697,845,2016
782,RPM,0.047051424,9.05e-05,0.021025806,0.031715831,500,904,615,2019
783,NWE,0.060996271,0.039286611,0.046684479,-0.069295097,374,734,912,2020
784,SMG,-0.130869683,-0.066060606,0.051335621,0.150873704,945,944,134,2023
785,SPGI,0.030600376,0.055857309,0.009647409,0.023685143,685,638,701,2024
786,VMC,0.024714862,0.071652357,0.009128526,0.02299736,752,565,708,2025
787,AMH,0.016637559,0.029238998,0.025607577,0.050033977,807,775,443,2025
788,FLS,0.047081284,0.055594065,0.026086848,-0.029018184,499,645,884,2028
789,RNR,-0.146270411,-0.028932792,0.012620473,0.141549289,951,931,147,2029
790,BKH,0.056640437,0.025918376,0.03435317,-0.004288365,402,787,840,2029
791,NVDA,0.009165708,0.122013923,0.000835154,0.007990617,855,379,799,2033
792,VFC,0.013348567,0.172116692,0.079116802,-0.103228511,833,265,935,2033
793,IDA,0.047402516,0.046775177,0.028239769,-0.014881398,495,687,855,2037
794,XRAY,-0.138453287,0.047273289,0.015156991,0.053632431,947,683,408,2038
795,CNP,0.056033516,0.046839949,0.02592279,-0.138307894,409,686,944,2039
796,UNF,0.034474142,0.058018991,0.006799937,0.013467875,645,624,771,2040
797,ISRG,0.013966451,0.109002394,0.0,0.010122852,828,424,790,2042
798,HXL,0.025428131,0.069870389,0.006784862,0.01948886,743,575,735,2053
799,ES,0.048320126,0.04734175,0.029839112,-0.03578962,485,682,887,2054
800,AZN,0.015663945,0.053526143,0.020789981,0.034476878,813,654,590,2057
801,ASH,0.042529134,0.031369688,0.018158507,0.017441724,545,767,748,2060
802,PNW,0.05618429,0.034917312,0.044017932,-0.054145004,407,754,905,2066
803,NWL,0.036230845,0.086606441,0.070806473,-0.107405143,618,511,938,2067
804,DLR,0.01316136,0.015901295,0.050525988,0.057796829,834,850,383,2067
805,FIS,-0.40769715,0.035129851,0.027768695,0.062198949,968,752,347,2067
806,ELS,0.015186827,0.086668654,0.02591042,0.0188759,820,508,741,2069
807,DNB,0.000304138,0.017910697,0.008154706,0.060675575,873,831,366,2070
808,MS,0.076713435,0.011377927,0.037567256,-0.065904415,287,875,909,2071
809,HAS,0.025205212,0.057372435,0.047722694,0.024610691,748,631,693,2072
810,MGM,0.015067298,-0.044057246,0.000295033,0.072256427,822,939,315,2076
811,ING,0.082893713,0.014335602,0.069785044,-0.255923621,261,858,959,2078
812,DXCM,0.007737724,0.110122734,0.0,0.006909978,859,419,802,2080
813,SUI,0.014079099,0.036241487,0.025260929,0.042755082,827,748,506,2081
814,GE,-0.011103461,0.013326352,0.008913457,0.066146496,890,864,328,2082
815,AEP,0.047473844,0.044139566,0.033852275,-0.030543592,494,704,885,2083
816,SO,0.046049182,0.045062811,0.03786845,-0.021116188,515,699,871,2085
817,PANW,0.00580172,0.057262405,0.0,0.034717956,865,633,587,2085
818,XEL,0.045267074,0.04405734,0.02638841,-0.018409306,524,705,862,2091
819,DTE,0.047254711,0.046600906,0.029888714,-0.061130055,497,688,907,2092
820,NWSA,0.013117675,0.01711819,0.015318627,0.052206587,835,838,420,2093
821,NWS,0.013117675,0.01711819,0.015318627,0.052206587,835,838,420,2093
822,EXC,0.050909354,0.039120583,0.031296349,-0.053419631,458,736,904,2098
823,ECL,0.026297335,0.0457172,0.014520503,0.025909512,733,695,676,2104
824,BKR,-0.01983112,0.05128538,0.025492253,0.038289844,899,662,544,2105
825,SCHW,0.045767596,0.025002058,0.013444192,0.006919617,517,792,801,2110
826,AEE,0.046742541,0.043864729,0.026548371,-0.048613984,506,708,899,2113
827,PVH,0.034959637,0.065138654,0.001761938,-0.043769326,636,592,891,2119
828,NMR,0.060967007,0.028670441,0.03762521,-0.752947728,375,778,967,2120
829,DUK,0.049317611,0.038817226,0.04008711,-0.068598263,473,739,911,2123
830,BDX,0.020050671,0.045753051,0.015051515,0.02857626,783,694,650,2127
831,UDR,0.006977186,0.023628961,0.039171019,0.046880968,863,796,471,2130
832,DD,0.03101246,0.060928845,0.01905761,-0.004530567,683,609,842,2134
833,FRT,0.03260085,0.046536099,0.044443651,0.012806197,671,689,776,2136
834,ROP,0.021539247,0.063287986,0.005732289,0.014517575,776,598,764,2138
835,TD,0.076340741,0.00841048,0.041243259,-0.475419715,290,886,964,2140
836,INTC,0.073811111,-0.012871129,0.055233994,-0.088575175,302,921,926,2149
837,KGC,0.005842767,0.02077782,0.029404773,0.046245688,864,810,476,2150
838,CRM,0.001248303,0.04009156,0.0,0.03788719,872,731,548,2151
839,GLOB,0.021200348,0.060886047,0.0,0.014479815,778,610,765,2153
840,CTVA,0.02707192,0.05860576,0.009865791,0.006301833,723,623,807,2153
841,PCG,0.056146007,0.025569729,0.0,-0.181468599,408,791,955,2154
842,BURL,0.015634245,0.076533985,0.0,0.009870263,815,547,793,2155
843,NCR,0.018749139,0.055612419,0.00499977,0.021873995,796,644,718,2158
844,RBC,0.02489578,0.039025131,0.003420837,0.026679545,751,738,672,2161
845,AWR,0.022921565,0.077318341,0.01647747,-0.014163268,764,544,854,2162
846,TYL,0.012262023,0.056415135,0.0,0.024734883,839,635,690,2164
847,ETR,0.047700273,0.039267511,0.03739005,-0.117529168,491,735,941,2167
848,FTI,-0.006661307,0.041669829,0.0,0.035441804,885,717,576,2178
849,KRC,0.038790897,0.032439987,0.054806491,0.001245542,592,764,824,2180
850,PNM,0.040471765,0.047061034,0.028520245,-0.082170834,577,684,923,2184
851,WELL,0.004661108,0.020053327,0.037348776,0.042850782,869,815,504,2188
852,ARES,0.036539835,0.049264722,0.06962761,-0.064095124,610,673,908,2191
853,WRK,-0.179644807,-0.067105304,0.030645291,0.074712194,954,946,304,2204
854,EL,0.014313275,0.087860262,0.013160815,-0.022167081,826,505,873,2204
855,KEX,0.031653354,-3.24e-05,0.0,0.031454308,678,906,620,2204
856,DV,0.012022734,0.060967775,0.0,0.015249599,841,608,761,2210
857,NOW,0.00416441,0.04867014,0.0,0.027843885,870,678,663,2211
858,NU,-0.019155678,0.041503281,0.0,0.033688312,897,719,595,2211
859,ALE,0.03884243,0.021894476,0.043161543,0.000236664,591,804,826,2221
860,KRG,-0.002635575,0.009254169,0.038951173,0.047867761,877,885,459,2221
861,PRGO,-0.028548965,0.017448024,0.031057086,0.045996766,907,837,477,2221
862,SJI,0.034820965,0.054953652,0.052705591,-0.102344173,639,648,934,2221
863,CAE,0.022910501,0.057876871,0.0,-0.001738606,765,626,832,2223
864,TRP,0.013931142,0.074701614,0.061423671,-0.006555831,829,554,844,2227
865,PPL,0.035151822,0.040354793,0.036593232,-0.019761275,634,728,866,2228
866,AMRC,0.032045834,0.06441061,0.0,-0.224896423,675,597,957,2229
867,CALX,0.009471033,0.073129065,0.0,0.003029068,853,560,817,2230
868,DIS,0.015888293,0.019433616,0.0,0.03305224,812,820,601,2233
869,PEG,0.033789475,0.048004187,0.035362603,-0.045391293,658,681,894,2233
870,SNN,0.018594273,0.054538844,0.027266042,0.009172063,797,652,794,2243
871,FE,0.016953583,0.06223013,0.037206016,-0.003048304,806,602,837,2245
872,BSX,0.010545521,0.057522587,0.000830951,0.013808892,847,629,770,2246
873,TM,0.009509413,0.072885925,0.002824057,-0.002912412,851,561,835,2247
874,VTR,-0.002273985,0.019734699,0.040018428,0.037005875,876,818,558,2252
875,NE,0.01786417,0.050083564,0.0,0.011278616,801,666,786,2253
876,NEM,-0.013501686,0.041090111,0.046588823,0.029057977,893,722,642,2257
877,AWK,0.029559733,0.05096893,0.016834628,-0.047295573,697,663,897,2257
878,AMT,0.018059385,0.039948983,0.026901918,0.018640296,799,732,743,2274
879,PUK,0.02654775,0.010114442,0.012608851,0.027771394,732,879,664,2275
880,GOL,-0.068362527,-0.103655214,0.0,0.057416015,933,957,385,2275
881,AMD,0.012968967,0.020649883,0.0,0.030604797,837,811,628,2276
882,FMX,0.009094439,0.050240494,0.006430797,0.014743887,856,665,763,2284
883,F,-0.046098329,0.077984882,0.043035104,-0.000278475,926,541,828,2295
884,FLR,0.014893886,0.057878704,0.007957008,-0.008977137,823,625,848,2296
885,LUV,0.026995474,0.04069465,0.0,-0.007813161,724,727,846,2297
886,SWX,-0.399947836,0.117238993,0.039579424,-0.111410202,967,394,940,2301
887,RYN,0.030547613,0.04488238,0.047261806,-0.07532796,687,701,918,2306
888,ELP,0.010539782,0.023215447,0.020546465,0.027916769,848,799,662,2309
889,KWR,-0.00598003,0.058633407,0.01010933,0.004451356,883,622,812,2317
890,STX,-0.041305246,-0.068896052,0.045443579,0.048879176,918,948,451,2317
891,CMS,0.045731782,0.010004409,0.029832202,-0.088840953,519,880,928,2327
892,NGG,0.013401013,0.048212811,0.00793494,0.002829322,832,680,819,2331
893,CWT,0.029147549,0.035898858,0.016450085,-0.025496629,704,750,881,2335
894,EBR,0.039745458,0.023305989,0.0,-0.364968491,582,798,962,2342
895,EQIX,0.011742911,0.042164557,0.019197241,0.011423357,842,715,785,2342
896,PHI,0.03817881,0.017798812,0.091887674,-0.070462389,597,832,914,2343
897,REXR,0.013813222,0.024020376,0.0239272,0.020677801,830,795,729,2354
898,AES,-0.022963657,0.080540914,0.022328717,-0.097145794,903,536,931,2370
899,STE,0.005611961,0.026926218,0.009621449,0.020710093,866,783,727,2376
900,CZR,-0.058860532,0.05635309,0.0,0.001347951,931,636,823,2390
901,IX,0.021132084,0.033924569,0.00822532,-0.012922319,780,759,853,2392
902,EIX,0.033994493,0.021907407,0.047402515,-0.10569647,655,802,936,2393
903,HASI,0.016366606,0.034545565,0.052133212,9.07e-05,810,757,827,2394
904,ETSY,-0.045720325,-0.328753009,0.0,0.042992797,924,970,503,2397
905,NEE,0.019540891,0.030860557,0.02017901,-0.008909587,789,769,847,2405
906,AGI,0.009345838,0.041405378,0.008842019,-0.003829023,854,720,839,2413
907,TMUS,0.014802796,0.03506506,0.0,-0.00297199,824,753,836,2413
908,AUY,-0.26170857,0.053687563,0.021493337,0.004369937,961,653,813,2427
909,SWH,0.015300259,0.051996392,0.042369949,-0.178778542,817,659,953,2429
910,SWK,0.015300259,0.051996392,0.042369949,-0.178778542,817,659,953,2429
911,MTZ,0.00521754,0.022849629,0.0,0.013913597,867,800,769,2436
912,NOV,0.019025175,0.034294622,0.009573959,-0.048238023,793,758,898,2449
913,WDAY,-0.007932828,-0.025084465,0.0,0.028053043,887,930,657,2474
914,SRE,0.016099602,0.038674918,0.030153511,-0.086225949,811,741,925,2477
915,AMZN,-0.003214286,0.039859152,0.0,-0.019948174,879,733,867,2479
916,CCJ,0.007182235,0.016149997,0.00416999,0.012949831,861,847,775,2483
917,BEP,0.0197776,0.025670663,0.131134089,-0.068505021,788,790,910,2488
918,AGO,0.033749285,0.012052485,0.017418986,-0.674713536,659,871,966,2496
919,ALK,0.010664408,0.034599243,0.0,-0.046518884,845,756,896,2497
920,HR,-0.021797281,0.005910976,0.289407754,0.022456353,901,893,714,2508
921,BIO,-0.289639864,0.037316753,5.444138924,0.00641074,962,745,806,2513
922,CVT,-0.038440373,-0.040667179,0.0,0.025368653,917,938,683,2538
923,D,0.020012402,0.017578448,0.044474242,-0.078338286,784,835,920,2539
924,MBLY,-0.00293913,-0.000531314,0.012079107,0.015591726,878,907,758,2543
925,RNG,-0.260767099,-0.25739584,0.0,0.029919377,960,968,637,2565
926,BAX,-0.094243112,-0.023320024,0.022305371,0.02070935,939,929,728,2596
927,HUBS,-0.00811317,-0.061186651,0.0,0.013053361,888,941,772,2601
928,BA,-0.044589556,-0.075178541,0.0,0.020207814,922,949,732,2603
929,CDAY,-0.007481307,-0.010136832,0.0,0.003883349,886,919,814,2619
930,COUP,-0.037241024,-0.092940938,0.0,0.015561773,916,952,759,2627
931,KSS,-0.005028051,0.02190561,0.063247592,-0.143961046,880,803,945,2628
932,HL,-0.01205228,0.010295026,0.004173184,-0.019196906,891,877,864,2632
933,ORA,0.013580145,0.005642424,0.005598425,-0.05826792,831,896,906,2633
934,SNOW,-0.015994626,-0.147023158,0.0,0.0099434,894,961,792,2647
935,AAL,0.015352277,-0.003470615,0.429017574,-0.088608025,816,911,927,2654
936,AL,-0.022623223,0.024896966,0.029135467,-0.52637933,902,793,965,2660
937,GWRE,-0.016047553,-0.090346646,0.0,0.003008226,895,951,818,2664
938,ENV,-0.025098302,-0.036986143,0.0,-0.002139874,904,935,833,2672
939,TWTR,-0.006502209,-0.038750598,0.0,-0.011126049,884,937,852,2673
940,TSN,-0.036254872,-0.013276418,0.037485747,-0.01046244,913,922,850,2685
941,GME,-0.045135846,-0.174096827,0.0,0.007539459,923,963,800,2686
942,NEWR,-0.035128464,-0.43017642,0.0,0.006635291,912,971,804,2687
943,WK,-0.020453367,-0.215091596,0.0,0.001735276,900,965,822,2687
944,MANU,-0.009167261,-0.014132685,0.0,-0.024296534,889,923,879,2691
945,GPS,-0.04169763,-0.008487085,0.045413261,-0.016101065,919,916,859,2694
946,WBA,-0.140976635,-0.095460031,0.075935142,0.0064538,949,954,805,2708
947,TAL,-0.028933945,-0.023025061,0.0,-0.022965162,908,928,877,2713
948,CTLT,-0.029561069,-0.014770889,0.0,-0.041028725,910,924,889,2723
949,TTM,-0.077412565,-0.101220175,1.04e-05,-0.00602957,936,956,843,2735
950,TTWO,-0.058958685,-0.094434037,0.0,-0.010646847,932,953,851,2736
951,LVS,-0.041959969,-0.037271875,0.0,-0.042885757,921,936,890,2747
952,HCP,-0.045820091,-0.238307932,0.0,-0.01561202,925,967,856,2748
953,KKR,-0.029418469,0.005739273,0.014754561,-0.154182335,909,895,946,2750
954,WYNN,-0.075702347,-0.021294629,0.000154208,-0.045224535,934,926,893,2753
955,ILMN,-0.138728761,-0.44086929,0.0,-0.002331046,948,972,834,2754
956,KMPR,-0.095261937,0.003387287,0.025207093,-0.076253828,940,902,919,2761
957,PHG,-0.130723182,-0.005098005,0.033286743,-0.079096412,944,913,921,2778
958,RIG,-0.213789969,5.3e-05,0.0,-0.092607893,957,905,930,2792
959,SE,-0.057471989,-0.112501569,0.0,-0.069974047,930,959,913,2802
960,S,-0.090332519,-0.225452696,0.0,-0.05059559,938,966,901,2805
961,MU,-0.076303803,-0.096572476,0.006593025,-0.080018921,935,955,922,2812
962,WDC,-0.141438963,-0.067649381,0.0,-0.100731735,950,947,933,2830
963,TV,-0.244532022,-0.005607294,0.020952843,-0.244777694,959,914,958,2831
964,RCL,-0.166779323,-0.033644267,0.0,-0.176975691,952,933,952,2837
965,ZNH,-0.197684061,-0.046786133,0.0,-0.154296769,956,940,947,2843
966,SPR,-0.175895303,-0.062604748,0.001356519,-0.16672265,953,943,949,2845
967,NIO,-0.131147633,-0.310257459,0.0,-0.098460959,946,969,932,2847
968,CEA,-0.30845019,-0.066624281,0.0,-0.129173303,964,945,943,2852
969,NCLH,-0.441786383,-0.114920762,0.0,-0.306311732,969,960,960,2889
970,LPL,-1.417657726,-0.080366042,0.103179491,-1.286013596,972,950,970,2892
971,W,-0.38177573,-0.871352785,0.0,-0.324695813,966,973,961,2900
972,KEP,-1.733864796,-0.171610531,0.003961064,-2.548362299,973,962,972,2907
