,ticker,eps,roce,divYield,fcfYield,eps_rank,roce_rank,fcfYield_rank,overall_rank
0,PBF,0.5754118400863563,0.4974845479373293,0.0147213262758467,0.8278145795903097,5,18,6,29
1,DQ,0.6349152005089814,0.4433594900547494,0.0,0.4152333354494722,3,29,19,51
2,PBR,0.5272502737700023,0.3665594855305466,0.542769914299835,0.577825874123715,7,43,12,62
3,RRC,0.1963686588365591,0.5238720058055897,0.0064115975900411,0.2285584033084919,59,15,54,128
4,AR,0.199446755158136,0.3594874233683028,0.0131444855893516,0.3033573916137333,56,48,32,136
5,SWN,0.2846014613185282,0.7786130227633669,0.0,0.1599247800486484,22,3,112,137
6,BTU,0.3454988197476907,0.2944523774003111,0.0,0.2528845728690598,12,83,43,138
7,ERF,0.2214263677564971,0.8977184499175503,0.010073993734638,0.1746108863310239,45,2,92,139
8,MLI,0.1972881369478014,0.4630944235374615,0.0167185869641737,0.2056757507638032,58,23,70,151
9,LPX,0.2351871101871102,0.6206554121151936,0.0149428274428274,0.1580907830907831,33,8,115,156
10,CIVI,0.2516830680840447,0.3013135256905452,0.1082736493508601,0.2281624940726682,26,79,55,160
11,CVI,0.2044658646778869,0.3593283582089552,0.1533493985084151,0.2200230500338131,53,49,60,162
12,CF,0.1931741292153643,0.4381393083292742,0.0176662532994326,0.1958875733495909,63,30,76,169
13,CHK,0.4158266714470446,0.2961454089627076,0.1021033074946957,0.1939288893174831,10,82,78,170
14,AN,0.2280089852822136,0.3042530808536219,0.0,0.2216689648550982,39,74,58,171
15,MPC,0.2417308772966582,0.2826111842481827,0.0212988283316634,0.2321555635431739,30,92,51,173
16,SM,0.2609306178228707,0.3086458014774922,0.0046080177401432,0.1892466915989595,24,70,81,175
17,APA,0.232549736219944,0.3906753982992865,0.0140665489722385,0.1642172804327851,34,38,105,177
18,CPG,0.2895097857886157,0.2391784077406213,0.039150372811916,0.2273297819108666,20,125,56,201
19,CRC,0.1468683958271437,0.3612105434428896,0.0165367086904608,0.1900320083412279,101,46,80,227
20,ICL,0.2294320822504259,0.384514435695538,0.1239082019008784,0.1358101904196592,38,40,149,227
21,CTRA,0.2078463133739515,0.2747217973735562,0.1018523631588958,0.191535618671297,51,101,79,231
22,SQM,0.171288827561745,0.7121096293633749,0.098151339493063,0.131716409552654,78,5,157,240
23,OLN,0.1729760086225979,0.2744184611587585,0.0151479480005621,0.219658282107979,77,102,61,240
24,TMHC,0.3016875043001502,0.1884288021434935,0.0,0.3086769229146875,17,199,31,247
25,OXY,0.2143248754425207,0.2252976006908036,0.0202943580073532,0.2135706932192744,48,143,66,257
26,TX,0.2946271181763261,0.1767311841698157,0.0883508302465812,0.3621155368636375,19,218,24,261
27,MTDR,0.1795816501223414,0.3533641369757797,0.0052129003152776,0.1323346939112602,71,53,155,279
28,EQT,0.1414652981114088,0.3191873926018283,0.0162659551087277,0.1628156372846387,107,66,107,280
29,EC,0.3202460500036099,0.2419226885907976,0.1280466529934208,0.1376235494776933,15,123,144,282
30,GPI,0.2705477701319582,0.2275598924125852,0.0085322450460777,0.1549484501194874,23,141,119,283
31,GGB,0.2196916524995,0.287836110508422,0.1132863990790766,0.1282342414874994,47,86,159,292
32,PSX,0.2246430501406043,0.2104767724142486,0.036537099864124,0.1756348375509677,41,161,91,293
33,MOS,0.2317496203699559,0.2099965270386843,0.0127880149456124,0.1739027727935208,35,164,95,294
34,E,0.2970223184621491,0.2853949545678869,0.064358043944164,0.1076911768889551,18,89,199,306
35,HRB,0.1124563599069562,0.3675644816252913,0.0361365321228918,0.1527600937502218,153,42,121,316
36,PXD,0.143121415123254,0.3229837064012809,0.1143694265656698,0.1355138140899339,104,63,150,317
37,MT,0.3210564282040928,0.1423720356484497,0.0114589049842785,0.2324570032202284,14,280,50,344
38,NVR,0.1138472040765532,0.449262032169735,0.3011583893883452,0.1221666945302542,150,27,171,348
39,UMC,0.1766278574527443,0.2456900751621969,0.0758487699108145,0.1275649738975467,74,119,161,354
40,FANG,0.1816374372453111,0.2657085697954517,0.0651012428977722,0.1167846723738662,70,105,183,358
41,ABG,0.2494949684472547,0.182112192329708,0.0,0.1471252290622987,27,205,129,361
42,SU,0.1523495909521858,0.2007275362722825,0.043571613761361,0.1772404627580789,96,181,89,366
43,CNQ,0.1281844880310227,0.218695826110148,0.0577340027467146,0.167459080642521,120,148,103,371
44,DDS,0.1140038282577591,0.4508239655102945,0.034689590182066,0.1058972303309512,149,24,201,374
45,COP,0.1195482570875285,0.3469165987503396,0.0366452526811128,0.116188362281803,136,55,186,377
46,ESNT,0.199454652378438,0.1926629731532605,0.0221029553202078,0.1403113491842769,55,192,139,386
47,DVN,0.1487850550050185,0.3912495149398525,0.0835818289047311,0.0842249563245366,100,37,251,388
48,CVE,0.1257927538936233,0.2293094800200635,0.0180790516061068,0.1490985431808915,125,137,126,388
49,OC,0.1506071616678681,0.1981961147086031,0.0165048944293554,0.1594664064718604,97,184,114,395
50,WSM,0.1279254953668984,0.4950899782426612,0.0246510046870288,0.0792462685125052,121,19,265,405
51,NNI,0.1193699501928086,0.2007047300853373,0.0107276968693971,0.1830454304279535,137,182,87,406
52,WLK,0.1712379733376522,0.1671049747972824,0.0128790465038109,0.17428626836814,79,236,93,408
53,TOL,0.1763697532681411,0.178293778710022,0.0117079290118141,0.1534117644518214,75,216,120,411
54,YPF,0.4495409333224562,0.1067035277476482,0.0,0.3180878033547314,9,374,30,413
55,CIG,0.1708731784781373,0.1338953515753779,0.0873992088354695,0.2639514567840436,81,298,38,417
56,CHRW,0.081692141439462,0.4813528228012791,0.0247820967025647,0.1321697347784341,245,21,156,422
57,HPQ,0.1249264913075971,0.2761265580057526,0.0396640652757188,0.1134024723423544,129,100,193,422
58,XOM,0.1202175883810509,0.2386091686609648,0.0322197802803107,0.1259329922061279,134,126,164,424
59,TKC,0.1413994075738785,0.1963952302279749,0.0159666988880847,0.1415665304912604,108,186,136,430
60,ACT,0.1792818965636818,0.1719222231573156,0.0638488247544991,0.1443928635072548,72,230,133,435
61,EXPD,0.0801298148821636,0.5158867304663894,0.0126209569124418,0.1205933350929556,250,17,175,442
62,VALE,0.2387191474691037,0.2357163404243661,0.0838973031050932,0.0767311545436405,32,132,280,444
63,LYB,0.1429791597377757,0.1723019760175646,0.1195544442320505,0.1557596255875975,105,227,117,449
64,DHI,0.1296107125847148,0.2273876822374293,0.0093185778987092,0.1134916484703589,118,142,192,452
65,TNET,0.0831109238188884,0.3429553264604811,0.0,0.1184623308517113,237,57,178,472
66,PAG,0.1613998418983407,0.1582513428708185,0.0180229823453147,0.137599213038694,87,252,145,484
67,MRNA,0.1181569438470499,0.449964174826845,0.0,0.0647305620381889,140,26,323,489
68,CLF,0.1596681772352647,0.1275154544258845,0.0,0.1770104137140014,88,312,90,490
69,MRO,0.1947910122175813,0.107916524895089,0.0118643473665193,0.2145289719273362,62,369,64,495
70,PFE,0.1091754725322696,0.2581448138881007,0.031261101292789,0.0905886371760649,164,111,233,508
71,STM,0.1342028240053397,0.2778016052937933,0.0065813089727346,0.0636710599201831,112,98,328,538
72,SIG,0.1063643550937429,0.1383482377695949,0.0196238988028009,0.1860740908064151,174,288,83,545
73,EVR,0.109066181996439,0.187649473235217,0.029126658109462,0.1163146016171164,165,201,184,550
74,ASX,0.1493958385158743,0.1653771500824039,0.0728523257900202,0.0949647835829098,99,239,220,558
75,IBP,0.0909197817414002,0.2380714756859845,0.0255027733386831,0.0945129825612463,209,128,222,559
76,RIO,0.1076911978313316,0.2341175226976427,0.1016823411407428,0.081366682805895,169,135,258,562
77,CBT,0.1162870216763545,0.1890726096333572,0.0229960851854364,0.091723021591911,143,196,228,567
78,BYD,0.1076845645979513,0.1713930479914997,0.0081114960346814,0.1190662927348173,170,231,176,577
79,BBWI,0.0772290226667181,0.3339003645200486,0.0179557477700119,0.0787736031200525,259,58,267,584
80,LAZ,0.1077937880588949,0.1048218650109811,0.0548380473436278,0.2365239031988002,168,378,49,595
81,WES,0.114773024173609,0.1531561605672038,0.0693818242177151,0.1144990821693379,147,262,191,600
82,MCK,0.0708617696871064,0.3050198426512567,0.0058122575136615,0.0915828658231395,305,73,229,607
83,VIPS,0.098335489367255,0.1677279651978016,0.0,0.115793897328059,192,235,189,616
84,ITUB,0.1200163117758161,0.0804608639843467,0.0270968078502667,0.4908255810288924,135,470,14,619
85,ALSN,0.1118487912377865,0.1450727749940348,0.0168510419943934,0.1032126322156599,154,271,205,630
86,SYF,0.1910560432749539,0.0559629149262896,0.0301534073603707,0.4240481278788269,66,558,17,641
87,BBDO,0.1272715827895164,0.0862893667560436,0.0,0.1962361558989167,123,448,74,645
88,BBD,0.1272715827895164,0.0862893667560436,0.0,0.1962361558989167,123,448,74,645
89,WMS,0.0731541503434888,0.2851775922433407,0.0057145774156775,0.0780318534890375,291,90,273,654
90,TPR,0.0925091323117795,0.2010874226026105,0.0279998260512042,0.0781781235668991,208,178,272,658
91,MPLX,0.1189083585581456,0.1106601731601731,0.0918645457724822,0.1270184874760314,139,359,162,660
92,WY,0.081742599164208,0.1974358974358974,0.0703073313024065,0.0899603391865672,244,185,234,663
93,MAS,0.0782875434686019,0.3932686476652516,0.02393150025462,0.0571387758017284,255,36,377,668
94,MSM,0.0603673162644108,0.2553087616073907,0.031080374828951,0.1067739222733389,360,113,200,673
95,HP,0.1005055254284397,0.1417828552683871,0.0466423430792714,0.1014598764439108,185,281,208,674
96,EXP,0.0854678625296141,0.1889363902600859,0.006943499964056,0.0799204327124809,224,197,262,683
97,DKS,0.1063934020355165,0.2303694839192221,0.0166332186128336,0.0568926431745591,173,136,378,687
98,OGN,0.1292184420797272,0.1750562596233566,0.0408651561647992,0.0607340769207878,119,221,351,691
99,ASR,0.0733558566940827,0.2248951994098496,0.0331207097621339,0.0784709239124971,287,144,269,700
100,GSK,0.0841699953917922,0.1723001928433683,0.0593004214637967,0.0880013465333816,231,228,241,700
101,GEF,0.0977820728329442,0.1205814995519267,0.0317138404371882,0.1186614853782862,195,329,177,701
102,DFS,0.1462351929375593,0.057791655270915,0.0234069536965173,0.229874265036637,102,548,52,702
103,AEL,0.285224769267949,0.0335802542221109,0.0173385921909495,0.467835115551224,21,671,15,707
104,GFI,0.0771022041007352,0.2187037404428709,0.0,0.0727536831662212,262,147,298,707
105,DVA,0.1106311622941815,0.0935850391078592,0.0,0.1384188905605402,157,411,141,709
106,CTSH,0.0773010914644067,0.2046190968631506,0.0190383474174346,0.0754782709669927,258,169,282,709
107,BSMX,0.1662143730347077,0.0557874049963975,0.1122367639037054,0.2036119791749009,85,561,71,717
108,AMAT,0.0622903515370889,0.3276961938605129,0.0088583857568059,0.068995468140702,352,62,307,721
109,HCA,0.0847810351539174,0.2138894113221741,0.0098107417961205,0.0620044891157571,228,154,339,721
110,UPS,0.0766192619816124,0.2471312094217122,0.033930629180288,0.0619363362139203,266,117,341,724
111,WF,0.3723064061301304,0.0216262084276835,0.0776206382539313,2.1658653324969097,11,711,3,725
112,NLY,0.1989712863555795,0.038039739055992,0.1752057889524744,0.5025989379735892,57,658,13,728
113,WSO,0.0677775089578074,0.322105812777047,0.0374811483672527,0.0606755874546807,319,65,353,737
114,TROW,0.0632070679612911,0.2121155255303558,0.0449293966623876,0.0860856003596299,341,159,243,743
115,WD,0.0842824908805257,0.0689113404818137,0.0315911525190334,0.615192414459145,230,509,9,748
116,CSL,0.0756963201266193,0.2076469822254053,0.0110103738365991,0.066963389687769,272,166,314,752
117,GM,0.204551985840153,0.0520549325659644,0.0121849466719787,0.1487910573512987,52,580,127,759
118,SUN,0.1315841672941126,0.0879424778761061,0.0994499285443925,0.1038822373374573,115,440,204,759
119,CSCO,0.0591592001608597,0.2130757126858795,0.0295584935712152,0.0892899146485599,369,156,237,762
120,T,0.1174016686646571,0.0647874740470818,0.0673041133212831,0.1692612417240381,142,520,100,762
121,M,0.1856444623061301,0.144106622240733,0.0272867391494991,0.0504725810857787,69,274,421,764
122,PM,0.0576763101950272,0.3565584510117921,0.0497974508447781,0.0619982087706493,376,50,340,766
123,AYI,0.0674507106076621,0.1682840993921296,0.0032750634052275,0.0996944896091283,322,233,213,768
124,CMC,0.1304583237437719,0.0825540344205211,0.0113706440728381,0.1118974194484038,116,459,194,769
125,MMP,0.0985735745589631,0.11403282632981,0.0827470183966595,0.0918777238749116,191,353,227,771
126,SHG,0.245027262083573,0.0205933943116249,0.0813346407483794,0.3509893068500989,29,717,26,772
127,MFG,0.5835312650622966,0.0119364178458961,0.2200157835463505,9.121836297766873,4,771,2,777
128,COF,0.1873936999052847,0.029387186016951,0.0299931764250578,0.3278116693315952,68,683,28,779
129,LYG,0.1744274591476374,0.0262027223931155,0.0471296029021368,0.5801254713838625,76,694,11,781
130,NTAP,0.0933529613918824,0.1602897181546213,0.0316550073165566,0.063603116552711,205,247,329,781
131,WAL,0.1771641404900072,0.0282682261208577,0.0278489361103179,0.3526023842174616,73,687,25,785
132,RKT,0.8292624143545245,0.0082482775574281,0.0,12.695719391189762,2,786,1,789
133,TSM,0.0856599457797836,0.2788867881793112,0.0240358266226475,0.0439008047421772,223,95,475,793
134,THC,0.1916786211351506,0.1028659611992945,0.0,0.0615288373843833,65,387,345,797
135,EPD,0.1048513335208649,0.0889457944594667,0.0782087815606451,0.1160240166009571,176,434,187,797
136,CE,0.1709266018421232,0.0620608899297423,0.026803168293089,0.1151543526666047,80,528,190,798
137,HMC,0.1161602869763751,0.0464680566778781,0.0356658913227316,0.2500303033365636,144,611,44,799
138,PBA,0.1175291712961167,0.0881783275000849,0.065311565738771,0.0919346328145995,141,437,226,804
139,LKQ,0.0776356019978768,0.1618716084775263,0.0191893045843316,0.0694598771573694,257,243,305,805
140,HUN,0.0832808302012499,0.1030832949838932,0.0309587434008994,0.1162310717156575,234,386,185,805
141,PSA,0.1339535552143632,0.1334643609699872,0.0795942653215824,0.0541157518220131,113,300,395,808
142,TLK,0.0753423682935339,0.1932628268979121,0.0404366410176568,0.0613463257442076,274,190,347,811
143,JWN,0.0830778266298004,0.0807993049522154,0.0403520872201887,0.1603910693710024,238,468,110,816
144,TEF,0.1047820962457991,0.046867416976728,0.0727899495054109,0.2761016051747834,177,606,34,817
145,SWKS,0.0625379965417022,0.1525444412805597,0.0257838789160538,0.1031036994266586,349,264,206,819
146,RDY,0.0580811018794038,0.406030447433897,0.0064159431645897,0.0515556276505461,374,33,415,822
147,BCS,0.225194143545,0.0102338708025836,0.0751406909466953,1.0820943284209388,40,777,5,822
148,HOG,0.1159197102532582,0.1142514439467698,0.0145687645687645,0.0620387339640398,145,348,338,831
149,DE,0.0968126856425625,0.2454976754518191,0.0135895831607256,0.0392450400878418,198,121,515,834
150,QCOM,0.0586297675295668,0.1880614314691393,0.0280664069672788,0.0798457660949534,371,200,263,834
151,PAA,0.1257921142779508,0.0354529339575473,0.0948596271604219,0.2369064601589566,126,666,48,840
152,BBY,0.0741051606019156,0.263042203985932,0.0412043493410228,0.0466878178845049,279,107,454,840
153,NXPI,0.0673436660414001,0.1901732946008213,0.0196932500264589,0.0644682099025675,323,194,325,842
154,LRCX,0.0536776948296611,0.3545219903779786,0.0108036134624345,0.0556582309650518,403,52,389,844
155,ABC,0.0602151192205483,0.1808789511552734,0.0138834481593923,0.0782195398231298,362,211,271,844
156,EOG,0.1031080999193101,0.4007473924926097,0.018684107293021,0.0285975810061033,182,35,627,844
157,CRH,0.088954416727646,0.1072756825256894,0.030391654299274,0.0805693692492204,212,373,260,845
158,HBAN,0.1560702106738634,0.0209670544000914,0.0704338305543351,0.2659051444590891,93,715,37,845
159,TS,0.1230268684449547,0.2007390957065397,0.0255972864889219,0.0370953029866357,132,180,534,846
160,AMG,1.145797373049925,0.0,0.0,0.586492463989135,1,839,10,850
161,ABM,0.0967863690283619,0.1102050702405942,0.0221457071990879,0.0734467193541926,199,361,293,853
162,AZO,0.0556769540254107,0.4648081046590444,0.0,0.0472146240829108,390,22,449,861
163,ALLY,0.2201341672772317,0.0069704838615845,0.0634459035209757,0.3486956033592089,46,789,27,862
164,AGCO,0.0859826445733024,0.2103495852519241,0.0390768696054251,0.0434842533650278,221,162,479,862
165,FNF,0.1098061959305978,0.0289542070515521,0.0472669276497027,0.4076168382388478,161,685,20,866
166,C,0.168598841187058,0.0192261044131315,0.0568204784411486,0.2207514770059176,83,727,59,869
167,NYCB,0.3251799320470551,0.0,0.0,0.4214737366928342,13,839,18,870
168,NSP,0.0414216243281544,0.3648378532449033,0.0176892392001226,0.0732960665739154,531,44,296,871
169,SEE,0.0675507441299832,0.228604611773815,0.0162830821387368,0.0516661509212239,321,139,414,874
170,FOX,0.0733754575972469,0.1140694912445451,0.0177072331086172,0.0854566467415878,285,351,245,881
171,FOXA,0.0733754575972469,0.1140694912445451,0.0177072331086172,0.0854566467415878,285,351,245,881
172,CIB,0.203965368054831,0.0490921881535513,0.0694768977534844,0.0909665835016211,54,596,232,882
173,UNM,0.1596345316004156,0.0297165344044936,0.0308774143454768,0.1599139102510632,89,681,113,883
174,BERY,0.0819055783347506,0.0777153558052434,0.017080473642879,0.1245395164827243,241,476,167,884
175,CMCSA,0.0881991876377001,0.1037963074265514,0.0273172165506419,0.0742883851684579,214,382,290,886
176,SBS,0.0798888037564773,0.091406020479789,0.0,0.099665132620908,251,421,214,886
177,AIT,0.0620364411343361,0.2147769302420167,0.0095622345131806,0.0568033872617166,353,153,380,886
178,SNA,0.0750020484271205,0.2011597680463907,0.0257575313837133,0.0486192943078076,275,177,434,886
179,CCZ,0.0881991876377001,0.1037963074265514,0.0273172165506419,0.0742883851684579,214,382,290,886
180,PFG,0.224618684839522,0.0213103181661125,0.0299843256447803,0.1426904713776047,42,712,134,888
181,MFC,0.1557123787871804,0.0118948195457634,0.0604163162578131,0.3844576135028045,94,772,22,888
182,BWA,0.1131383733841976,0.0612164916131055,0.0192958454606523,0.1013930761472788,151,530,209,890
183,SNV,0.1388501159548383,0.0210232736798072,0.0420105223890686,0.2127693330642932,110,714,68,892
184,OMC,0.078499572351741,0.1743391047473995,0.0346495263908824,0.0505819880182164,253,223,419,895
185,ABEV,0.0629703569301743,0.1815678070492395,0.0533204684391421,0.0614511832951896,342,209,346,897
186,MCHP,0.0485269594508319,0.2351396424609672,0.015078337089942,0.0679815491292255,456,133,310,899
187,GIL,0.1073396418613265,0.2156069894991711,0.024532481688397,0.0334847196111115,172,151,577,900
188,THO,0.060178370920125,0.1076411509522851,0.0154306854627622,0.1243598863553163,363,370,168,901
189,BDC,0.0807824250017169,0.1440797602940173,0.0028387395159106,0.0558935724865902,248,275,385,908
190,PKG,0.0849032615365325,0.1372557271719764,0.0346522051114824,0.055305018293558,227,291,391,909
191,SNX,0.0686551594184035,0.085058196068629,0.0,0.1376984343507777,314,453,143,910
192,KEY,0.1190505507306422,0.0174811714119949,0.0530355609410373,0.2708291349693954,138,737,35,910
193,VZ,0.0729442970869386,0.0878140365468822,0.0692449522458669,0.1174997339333949,292,442,180,914
194,HTZ,0.1894178169596595,0.0,0.0,0.7607462323996715,67,839,8,914
195,LNC,0.2584605957678158,-0.0075809600350259,0.0590005778262318,0.7675784850748167,25,883,7,915
196,VLO,0.2300552587622755,0.3605156131522713,0.0311716094887816,-0.0203553403831992,36,47,837,920
197,EME,0.0549153422161235,0.203846868645314,0.0036761943672831,0.0606651173618039,398,170,355,923
198,BKNG,0.0380569575250861,0.3021258956593829,0.0,0.0769850684271364,567,78,279,924
199,LOW,0.0473848418415882,0.4198454353845518,0.0174463376051831,0.0497625494561343,468,32,427,927
200,FITB,0.1082584390814763,0.0200417474867816,0.0410284435930206,0.2636088565696129,167,721,39,927
201,LEG,0.0705221025784729,0.1149834044570886,0.0521745187572175,0.0776471568415658,308,346,275,929
202,POOL,0.0628193006035222,0.3549762382069146,0.012642050410181,0.0370333752438936,345,51,536,932
203,RLI,0.0979624174489933,0.1632442301799629,0.0612628011494989,0.0410646882710616,193,242,501,936
204,SIVB,0.1231651542960531,0.018441473093547,0.0120071292764692,0.1951342665850745,131,732,77,940
205,UBS,0.1253085430628606,0.0156710887594538,0.027397384955938,0.2135944807955747,127,754,65,946
206,VLY,0.1036107717165672,0.0193400749539156,0.0399151668324871,0.2601837942992282,179,726,42,947
207,KB,0.2297127464746476,-0.0014437853546133,0.0751496032739994,0.2692833560621289,37,878,36,951
208,UL,0.0635959072951845,0.205271595984273,0.036025475357348,0.0470603056469862,338,167,451,956
209,APTV,0.1146178382015037,0.137091100949701,7.880222633310672e-05,0.0390071020348878,148,292,518,958
210,ULTA,0.0477978744441338,0.4442319599982215,0.0,0.0450040789725508,463,28,468,959
211,SNY,0.0737086332445544,0.1037100478841437,0.0367002249866566,0.0733035923737803,281,384,295,960
212,VTRS,0.1540768203335741,0.0096774193548387,0.0431112665765451,0.1860248187766466,95,781,84,960
213,MPW,0.1353465890977681,0.0386819387016083,0.1047470018351594,0.1108163253469063,111,656,195,962
214,ADM,0.0854516582839377,0.160048337689346,0.0177007006445299,0.0425092465979312,225,248,491,964
215,GIB,0.0517467833879873,0.2098209562745994,3.0072631861728056e-05,0.0572674270541565,425,165,375,965
216,ORAN,0.0872407253033679,0.0596923995076402,0.0756547016726783,0.0999243722253859,218,537,211,966
217,AXP,0.0677179440385183,0.0575613348934127,0.0141041499095396,0.173251231860058,320,549,97,966
218,STT,0.097762283842771,0.0160695344327863,0.0342555659319298,0.39541918699203,196,750,21,967
219,BNS,0.1093975720036612,0.0075642917700254,0.0800477240760933,0.4618319632143768,163,788,16,967
220,HSBC,0.1296292140448577,0.0138856241330749,0.0563464684685162,0.1780451393903302,117,762,88,967
221,SF,0.1042196273293552,0.0272463627108234,0.0269188851898497,0.1692130554118927,178,689,101,968
222,BXMT,0.0688326758410393,0.0818121799971233,0.1166541692149845,0.1098548378416374,311,462,198,971
223,CFG,0.1106276278988187,0.0163322012966965,0.0476024332299789,0.2130902644476523,158,747,67,972
224,CHH,0.0532013750272676,0.2872277538488498,0.00841622585686,0.0438031360249435,409,88,476,973
225,AIG,0.2086921223367566,0.0302725328033148,0.0205320879410724,0.0854386686133451,50,679,247,976
226,TFC,0.1095382177406851,0.0187709299723785,0.0523018742534996,0.184027705427921,162,729,86,977
227,HD,0.0532611717370596,0.450717165088591,0.0242532164080653,0.0357959912475438,407,25,550,982
228,HPE,0.1013583520783717,0.0592271271015848,0.0309831209563022,0.0800856115187135,184,539,261,984
229,ZION,0.1229472712743729,0.0151446500985478,0.0364639646888713,0.1735088282593134,133,756,96,985
230,VIV,0.0637685687954977,0.0680542452254862,0.0891237140217399,0.1412396559484691,337,511,138,986
231,CM,0.1114498613332592,0.0078275630578805,0.05044807537027,0.2485588499004019,155,787,45,987
232,IGT,0.0607332867128895,0.0709996467679265,0.0351728746790475,0.1487747059405674,359,501,128,988
233,USB,0.0885157601361182,0.0163225288188579,0.0467272038486804,0.3209209164488723,213,748,29,990
234,FNB,0.0961441518316224,0.0169506056241588,0.0391925539623656,0.2458840117303722,202,742,46,990
235,VAC,0.0649203043493293,0.094602716672677,0.0182071108515116,0.0840469662539476,333,406,252,991
236,SCCO,0.0565140453306257,0.2765168280169807,0.0579555443834024,0.0397108357183931,383,99,510,992
237,JBL,0.0544900899979109,0.2284143260514192,0.0029976210879046,0.0468961165752192,400,140,452,992
238,DCI,0.0468854497514208,0.2384191450275557,0.0149489839787139,0.0557189402842972,478,127,388,993
239,WPP,0.0765199571759914,0.122204027280416,0.0409556061990732,0.0535314655738296,267,326,400,993
240,NVS,0.0707964743054875,0.1328121813608864,0.0345877724637247,0.0558028775586351,306,303,386,995
241,LH,0.0653856043299368,0.1038789923052598,0.0099783206670343,0.0753485894631591,331,381,284,996
242,QSR,0.0746460733495889,0.0920019389238972,0.0489077849004391,0.070012174059331,277,418,304,999
243,VRTX,0.0449182613393121,0.2740024045342646,0.0,0.0530744007853908,494,103,403,1000
244,FLT,0.0687266277023902,0.1797130957889866,0.0,0.0434521046037296,312,213,480,1005
245,KEYS,0.0486538488094306,0.2047030449201085,0.0,0.0557885191646451,454,168,387,1009
246,ORLY,0.0399884788419017,0.5309857980411067,0.0,0.0475762496795446,550,14,446,1010
247,CSX,0.0629559242038478,0.152709109809589,0.0128752874271911,0.0526798732056201,343,263,404,1010
248,TRGP,0.0715587598875889,0.1048304463024379,0.0227276128225157,0.0626401022353508,302,377,331,1010
249,AMCR,0.0715327111989646,0.140370473796891,0.0493493799588277,0.0501684568046174,303,285,423,1011
250,BCO,0.0671525847643932,0.069463971010475,0.0148003352118475,0.1170249909170815,324,505,182,1011
251,RF,0.1113668607939043,0.0205643602628527,0.0378002440645679,0.139593027293562,156,718,140,1014
252,SAIC,0.0521229322832763,0.1134254018564636,0.0144206779317064,0.0880877555587369,420,355,240,1015
253,ABBV,0.0413540610956289,0.1658048633164633,0.0350894589036331,0.084720621278034,532,237,249,1018
254,WIT,0.056211344353206,0.1537394184803137,0.0162512691947674,0.0573340854778643,386,260,374,1020
255,OGS,0.0551154068030639,0.0531286203064015,0.0332951321937099,0.2389512452425175,397,576,47,1020
256,BKR,0.0563949492416432,0.0967270601987142,0.0228133968625484,0.0888735638589354,384,399,239,1022
257,ARW,0.2104514634059768,0.2206728316551054,0.0,-0.0165060752129486,49,145,828,1022
258,SYY,0.0470198313418756,0.2127729345707693,0.0264563650450691,0.055099052211219,476,157,392,1025
259,NFG,0.1000490774344038,0.1010372295873613,0.0369458974636245,0.0476692629305477,189,393,444,1026
260,KOF,0.0685290623043594,0.1032012943336544,0.0412708122935206,0.0639278149772095,316,385,327,1028
261,CPB,0.0626269143909058,0.1333875559170394,0.032627308546311,0.0564226163451867,348,301,381,1030
262,EPR,0.0623211646846775,0.0556552371055675,0.0939476642964332,0.1562072960741821,351,564,116,1031
263,BP,-0.0122759398889101,0.2367188078391555,0.0394241311981358,0.2611057133482776,860,131,41,1032
264,HIG,0.073691865847186,0.0426567016851159,0.0213970321220204,0.1556258522271427,282,633,118,1033
265,CHTR,0.0785767710195841,0.0937385709700774,0.0,0.057212579820711,252,409,376,1037
266,BK,0.0696915728020585,0.022293826566374,0.0372699588712135,0.3716703311270298,310,707,23,1040
267,BAM,0.1685981922767917,0.2678378643635293,0.2803220074200026,-0.0340718017812628,84,104,853,1041
268,RBA,0.0498958746858104,0.1586120341107802,0.0179847548635706,0.061050359339432,441,251,349,1041
269,WU,0.1416310100417743,0.0,0.0789604193363885,0.1719934406290045,106,839,99,1044
270,FIX,0.0594785380534374,0.1198947763893133,0.0048553168304507,0.0612257943218045,368,330,348,1046
271,OKE,0.0585765349745011,0.131633962908019,0.0568541908882464,0.0579533293288042,372,306,370,1048
272,HII,0.0657359003733335,0.0954417695221801,0.0193056976133138,0.0654463149091338,329,404,319,1052
273,WRB,0.0685967300195362,0.0545527344064537,0.0116818811369473,0.1249646178019174,315,572,166,1053
274,MRK,0.0516827599070785,0.1732198160643421,0.0249603631426706,0.0523519767169504,426,224,408,1058
275,PAGP,0.1103233010884335,0.0,0.0,0.2159825276593073,160,839,63,1062
276,PAYX,0.0411687178547008,0.4288335794136258,0.0310622509980565,0.0411449254922342,534,31,500,1065
277,AVY,0.0508865319729537,0.2103403420894247,0.0160570499119517,0.0445282359425199,433,163,469,1065
278,CDW,0.046160506189194,0.2120130980890474,0.0117047636151334,0.0500372431827414,485,160,424,1069
279,TGS,0.1021071569504884,0.1341747380532584,0.0,0.0319312683157867,183,297,590,1070
280,PAC,0.0645073778316681,0.2577978605392132,0.0513626605512919,0.0287132558431451,334,112,626,1072
281,MTB,0.0841298014559564,0.0153989536903,0.0372149812290135,0.1841433105081665,232,755,85,1072
282,POST,0.0585685405489464,0.0552419429225007,0.0,0.1458479122929787,373,568,131,1072
283,GILD,0.0426204326549364,0.1411406785535487,0.0344249095638413,0.0774444447022625,513,283,277,1073
284,OTIS,0.0381982613651102,0.6008796041781198,0.0146435724578907,0.0404532085153976,565,9,506,1080
285,AVGO,0.0403358456112712,0.2476014421901735,0.0218979931613526,0.0505071698383429,547,116,420,1083
286,SKM,0.0531997842263445,0.0693014072346581,0.0527111671813897,0.1231976160599934,410,507,169,1086
287,KBH,0.1401223808475298,0.114815867959763,0.0,0.0280647433364605,109,347,633,1089
288,ADP,0.0375245568915668,0.5450301094668064,0.0209354473912036,0.039988068246699,570,12,508,1090
289,TEL,0.0490851782036109,0.1335729607513479,0.0186318084804282,0.0616777108317624,449,299,342,1090
290,ARMK,0.1032667887041659,0.0728744221272136,0.0175577499755814,0.0512058402995078,180,494,416,1090
291,ALB,0.0804316980207824,0.1942558012039944,0.007261372135028,0.0254424220581987,249,189,654,1092
292,TXT,0.0571452191831762,0.0889645884496554,0.0011283028177862,0.0753971765297191,378,433,283,1094
293,SPG,0.055419523551414,0.0866444634233717,0.0671517703895385,0.0807275313139845,391,446,259,1096
294,DAR,0.0732053916893834,0.1265155195024494,0.0,0.0417721958640427,289,314,494,1097
295,DECK,0.0433762064710852,0.3170505672415744,0.0,0.0383048138523203,507,67,524,1098
296,AFL,0.0967402964288748,0.0390595053740359,0.021437019059273,0.0849378926771402,200,653,248,1101
297,PNC,0.0895754146106531,0.0170781121301791,0.0399167383101933,0.1346819220176398,211,741,152,1104
298,RY,0.0963580804192571,0.0098587652696299,0.0359843184767789,0.1514142822336115,201,780,123,1104
299,WBS,0.0812752061336412,0.0147090974165613,0.0329867716551548,0.1648997982343698,246,757,104,1107
300,BMY,0.0408435052080794,0.1378353129587615,0.0299144623256267,0.0771294768810073,540,290,278,1108
301,TRV,0.0639584040825356,0.0331983297790362,0.0195565985741461,0.1636993072823237,336,672,106,1114
302,CLH,0.0665398739981615,0.1242260421679685,0.0,0.0451188129063076,327,322,467,1116
303,MAR,0.0488199606806769,0.2019340810254062,0.0066459742911354,0.0420497625710156,450,174,492,1116
304,WTS,0.0508844177143326,0.2029377657518361,0.0079917872752132,0.0396352184104881,434,172,512,1118
305,BHP,0.0426911354627448,0.2787983417018224,0.0438376275303536,0.0395424122914736,511,96,513,1120
306,AFG,0.0768669246930116,0.0434594905741833,0.1038302668737451,0.0913329717677543,263,629,231,1123
307,GPC,0.0481828228941382,0.1869041574278183,0.0202034842121485,0.0459273944798007,460,202,462,1124
308,PRI,0.0682857908973931,0.0360077225511142,0.0155478061459676,0.1358129621282105,317,664,148,1129
309,CRI,0.0863222648688703,0.1984392646718646,0.040776928588682,0.0165703202989592,220,183,727,1130
310,INFY,0.041353765910408,0.3627999620601347,0.023541543357921,0.0351527818909674,533,45,555,1133
311,FHN,0.0686629792103757,0.0189804701296322,0.0271600228876597,0.1741750905969864,313,728,94,1135
312,RGA,0.0771534909777226,0.0120529327610872,0.0252256230469428,0.162182298418881,260,768,108,1136
313,RH,0.0723429805389043,0.1632614536243849,0.0,0.0314809284129377,295,241,600,1136
314,RZA,0.0771534909777226,0.0120529327610872,0.0252256230469428,0.162182298418881,260,768,108,1136
315,KNX,0.0907009375983429,0.0409931376675228,0.0092078517067392,0.0747044354154879,210,640,288,1138
316,IPG,0.0719277440568551,0.155859983299104,0.0350666922784646,0.0330269502828225,297,259,582,1138
317,AAPL,0.0359831158434342,0.551446146423833,0.0055739606737213,0.0369435806809892,590,11,539,1140
318,IHG,0.0355129106002723,0.2350299401197604,0.0220653551196358,0.0518014989289306,597,134,413,1144
319,FRO,0.1957071833559096,0.1009929145305266,0.0138248384318005,0.0219132362529632,60,394,692,1146
320,ALLE,0.0494446651581365,0.1783671979559557,0.0155351251446634,0.0426973036463821,444,215,488,1147
321,DRI,0.0499439675377944,0.1447236907070001,0.0299999511699675,0.0484129425628605,440,272,437,1149
322,GOOGL,0.041459125246447,0.2629406883816107,0.0,0.0390433214852204,528,108,516,1152
323,GOOG,0.041459125246447,0.2629406883816107,0.0,0.0390433214852204,528,108,516,1152
324,HST,0.0551829471616742,0.0715208564045773,0.0130765277634299,0.0795052888016539,396,497,264,1157
325,SON,0.0784055076131936,0.1270662737133617,0.0314493096299719,0.0319213190661398,254,313,591,1158
326,V,0.035998434852576,0.3115680776249611,0.0078174103590582,0.0410481776678247,589,68,502,1159
327,LDOS,0.0475330354596444,0.1192459447610697,0.0138088672357215,0.0594683377940369,465,333,361,1159
328,PKX,0.1500947427980795,0.0644794449818928,0.0581651160094788,0.036582480693004,98,522,541,1161
329,SLF,0.0881436952700277,0.0132301593632832,0.0453752664190438,0.117063299540693,216,765,181,1162
330,GL,0.0626592060340081,0.0408454527527464,0.0068230144333696,0.1181060774323329,347,641,179,1167
331,L,0.0714473616610873,0.0093241426651031,0.0043066097443936,0.1873728239609938,304,782,82,1168
332,OHI,0.0670703520748497,0.0430256414213851,0.0994276687483056,0.0983018881278052,326,631,216,1173
333,MC,0.0595789524713855,0.3315942918520791,0.0692109722842791,0.0107142647774708,365,59,753,1177
334,NEP,0.071798951448113,0.0,0.0,0.2624251675428532,300,839,40,1179
335,CNS,0.0543110933022935,0.328986719441537,0.0340875602962302,0.0182443638864716,401,61,719,1181
336,HUM,0.0425714576086217,0.1533794489314835,0.0059472599367711,0.0525998729611873,514,261,406,1181
337,CI,0.0595461725714014,0.0713631311765942,0.0123593135631103,0.0657347594928143,366,498,318,1182
338,PENN,0.0463902883257722,0.0595959225130633,0.0,0.1265341587922233,482,538,163,1183
339,ENLC,0.0850727629533348,0.0083080405370646,0.0376175548589341,0.1217898072397652,226,785,172,1183
340,CVS,0.03525939661693,0.1025047464661692,0.0237761693262388,0.1100067001850402,599,388,196,1183
341,DPZ,0.0365467821267958,0.7206503378378378,0.0127298742882267,0.0313604801810303,576,4,604,1184
342,CMA,0.1276220652602626,0.0204635318450027,0.0416906138469667,0.0616488864332806,122,719,343,1184
343,AMGN,0.0463693217396818,0.107921673342234,0.0296956156928731,0.0621725414351503,483,368,334,1185
344,BCE,0.0528821477021999,0.0935361216730038,0.0635765848246811,0.0595385128767098,415,412,360,1187
345,SBUX,0.0396109919201259,0.2920766957542711,0.0233545908961964,0.035295031253644,552,85,554,1191
346,TPX,0.0758953932645461,0.2014443852483277,0.0117415519533695,0.0120413362585619,269,175,747,1191
347,FFIV,0.0409114139192362,0.1251652738460495,0.0,0.0620718221278607,538,318,336,1192
348,CB,0.057373682122413,0.0407264345256095,0.0148482614188439,0.1214101840960454,377,643,174,1194
349,ITW,0.0437766335509082,0.3457398284984492,0.0222490339273238,0.0279339362407905,503,56,637,1196
350,CAT,0.0514500235726282,0.1567880663334127,0.0187230510838498,0.0396483626845294,427,258,511,1196
351,TEX,0.1337532185982042,0.0,0.0,0.0857518221939452,114,839,244,1197
352,BXP,0.0552994874471734,0.0433818128453463,0.0649267704609265,0.1215470308302715,394,630,173,1197
353,BEN,0.0734165542853379,0.0378278580228483,0.0505050673057155,0.0823233428716085,284,659,256,1199
354,NSC,0.0565162980559637,0.1327133237664201,0.0201695779300641,0.0393021595655234,382,304,514,1200
355,VRSN,0.0303965683005205,1.529764801297648,0.0,0.036256636899864,652,1,548,1201
356,LAD,0.2238164297361327,0.1641050353386764,0.008086732713088,-0.1633806264069036,44,240,917,1201
357,ACN,0.0336557245033651,0.2650685469580564,0.0138480978221482,0.0440613573578484,622,106,474,1202
358,UNH,0.0405009345610779,0.1817304496766112,0.0120596967671678,0.0471115244765143,545,208,450,1203
359,FCX,0.0633332115855217,0.15725842495754,0.0158150407246429,0.0304978268015632,340,256,612,1208
360,HI,0.1929069042183528,0.0268048018418023,0.0207568777050816,0.046626787275526,64,692,455,1211
361,NRG,0.1566207878500237,0.1248453353130413,0.042586487769212,-0.0016675431957823,92,319,803,1214
362,FBHS,0.0521090171333946,0.1827966002246399,0.0096473193294606,0.0320115595932104,421,204,589,1214
363,KLAC,0.0500691001583691,0.3867263855079352,0.0026534305193903,0.0130141225505422,439,39,740,1218
364,HES,0.0511952432860437,0.2121959997943339,0.0107088565578094,0.028073325040795,429,158,632,1219
365,BUD,0.0493875088407695,0.0813004032258064,0.0202051091621978,0.067333815873041,445,465,312,1222
366,NTRS,0.0724775557861254,0.0145926738636722,0.0432207101009028,0.1228103972968793,293,759,170,1222
367,LEN,0.108672063028391,0.1470021382924115,0.0,0.0026005895660793,166,269,788,1223
368,AWI,0.0616820983428478,0.1409106015287471,0.0134369085596543,0.0327106642764436,355,284,585,1224
369,VOYA,0.0651022884603257,0.0048538753042146,0.015190533974076,0.1725848901928636,332,796,98,1226
370,ACI,0.0826946610966348,0.0,0.0163807406151248,0.1368990142764759,240,839,147,1226
371,MOH,0.0414948281307271,0.2148745191427001,0.0,0.035731657557015,527,152,551,1230
372,K,0.0420526718954146,0.1346011360829834,0.0349124786465057,0.0509450598066325,520,295,417,1232
373,YUM,0.0348319758063668,0.5230806027266204,0.0170610960742128,0.0301789496043087,603,16,614,1233
374,KR,0.0623420785415732,0.1254560934079299,0.0189471023018506,0.0342548051879499,350,316,569,1235
375,PG,0.0400026360862708,0.2131581112691453,0.0245672368893981,0.0376357292762799,549,155,531,1235
376,MUR,0.0998989405833919,0.0,0.0258185907274592,0.1030973846533794,190,839,207,1236
377,HSIC,0.0495056368426728,0.1170296099013003,0.0,0.0465610636475695,443,342,457,1242
378,A,0.0408018484553538,0.1473799126637554,0.008719749871507,0.0485015521154771,541,268,435,1244
379,FN,0.0522739978731354,0.1680532901400288,0.0,0.0318475124933364,417,234,595,1246
380,FAST,0.0312136001790768,0.4021201599326599,0.0274787780624115,0.0340484977191506,643,34,571,1248
381,RE,0.0462091113221611,0.018595487423081,0.0197375601124808,0.2860011161396737,484,731,33,1248
382,EXPE,0.0256476258692213,0.0801261244551609,0.0048817924239711,0.2024122291610708,706,471,72,1249
383,EXR,0.043624201490717,0.095635187053657,0.0408174034338701,0.06159816035669,506,403,344,1253
384,EMN,0.0718614749998187,0.1098458304134548,0.034526131115928,0.0318075381146738,298,363,596,1257
385,WMB,0.0511175129053258,0.0693107962244218,0.0516663588223181,0.065013293621903,431,506,321,1258
386,FDX,0.0717395874648617,0.066778144840056,0.0212581808776793,0.0476999623601963,301,515,443,1259
387,BOH,0.0735168180518307,0.0133160832487646,0.0392106626333199,0.0990405065213585,283,764,215,1262
388,GRMN,0.0547884782800089,0.1576561825344905,0.0382161151271239,0.0305047543535811,399,254,611,1264
389,ITT,0.0542599212861523,0.1803607214428857,0.0129957686132228,0.0257106275522122,402,212,651,1265
390,BIIB,0.0757248224223214,0.1090252945073844,0.0,0.0283598394650664,271,366,629,1266
391,PII,0.0929155239332316,0.0,0.027220478670177,0.0948374043009834,207,839,221,1267
392,G,0.041423693211721,0.144068859125524,0.0107645293021154,0.0456289592566919,530,276,463,1269
393,GIS,0.0518051991896827,0.1110971734403746,0.025721853593582,0.0417233669868407,424,357,495,1276
394,PB,0.0778652601970377,0.0210902736388615,0.0286719496725664,0.0688971481970925,256,713,308,1277
395,HLT,0.0361161472272583,0.172487644151565,0.0035396702063368,0.0454401565512676,586,226,465,1277
396,IT,0.029972320630448,0.2971492673418804,0.0,0.0368584017892253,657,81,540,1278
397,TT,0.0456665560417173,0.1951544195953141,0.0161243370663666,0.0315155133696383,491,188,599,1278
398,BABA,0.0395336155487031,0.0733724600476861,0.0123788672953154,0.0898404848900911,553,490,236,1279
399,CNI,0.0514208891708034,0.1385022359387793,0.0189320287062638,0.0345365545399636,428,287,566,1281
400,AVT,0.1659990283121323,0.1442430225111728,0.0228972568267985,-0.1956204228973128,86,273,923,1282
401,CHE,0.032758154612776,0.3000470821719294,0.0028892906535809,0.0331435770885705,629,80,579,1288
402,MKC,0.0358727962827461,0.098633672695987,0.0048907000379072,0.0711076751692435,591,396,302,1289
403,EMR,0.2395190919039231,0.0750914779657421,0.0217069273092442,0.0049646895515299,31,483,777,1291
404,HSY,0.0343576445751764,0.2181137350477776,0.0161891598123675,0.0377737175098432,613,149,529,1291
405,ALV,0.063417168931644,0.1617177914110429,0.0335826142805869,0.0191900653031925,339,244,712,1295
406,ROK,0.0423125978730432,0.1613850057211084,0.016541987232477,0.0370273353594217,516,245,537,1298
407,RL,0.0661766279140283,0.1329682779456193,0.0251058452560777,0.0244981394707566,328,302,669,1299
408,CAJ,0.0832785261701361,0.0947405444835459,0.0407331229736624,0.0252865831201667,235,405,661,1301
409,JNJ,0.0386874948759177,0.1817732717212865,0.0251907538677036,0.0370572765978845,560,207,535,1302
410,WWE,0.0383384276009018,0.3069006608168129,0.0069973510498578,0.0246377318478188,564,72,667,1303
411,ATHM,0.0738420624167625,0.0016117841561097,0.0160108643671005,0.0929309402793653,280,800,224,1304
412,CX,0.0937033362185109,0.0035883450552605,0.0,0.0693170847249234,204,799,306,1309
413,ASB,0.0570344519063864,0.005023740209731,0.0403807510726177,0.1380191589072429,380,794,142,1316
414,MA,0.0278049991078556,0.5555682859761687,0.0053598202835866,0.0288332500797763,685,10,625,1320
415,TJX,0.0361634319720725,0.2814231877632454,0.0138430061208133,0.0271587580876599,585,93,644,1322
416,CMI,0.0599041233252954,0.1183388070770208,0.0238112624096362,0.0291305034859409,364,338,620,1322
417,VRSK,0.0342418463606413,0.3030009263448157,0.0070070326130592,0.0281537688443768,615,77,631,1323
418,JCI,0.0505515090349954,0.0895436164067013,0.0267931199860981,0.0459857426700175,435,431,461,1327
419,STWD,0.1686076371169504,0.0233256675964022,0.1144314721894261,0.0364729192676084,82,703,543,1328
420,ZBRA,0.0345867522336954,0.2589955743698287,0.0,0.0308516817980911,610,110,608,1328
421,AKAM,0.0390473555365769,0.0903562173292865,0.0,0.0608725420278674,556,424,350,1330
422,CNHI,0.093307776782413,0.1381521811744271,0.0194525330601087,-0.0203262875001609,206,289,836,1331
423,OUT,0.0553717318885017,0.0529015887025595,0.0770486979219314,0.0589658402463761,392,577,363,1332
424,BG,0.1076468412981661,0.1655540720961281,0.0233346258466211,-0.4081219374434821,171,238,930,1339
425,CFR,0.0680530508048132,0.019506766102312,0.0254345560078664,0.072862650083915,318,724,297,1339
426,EDR,0.0859762588546333,0.0177029094777815,0.0,0.0559706283985658,222,735,383,1340
427,AXS,0.048527078110891,0.0140235623400671,0.0390662958854463,0.1505772286620162,455,761,125,1341
428,CR,0.0724752796811511,0.1909150080504265,0.0186924795865414,-0.0370672399733115,294,193,856,1343
429,CHT,0.0418344530815198,0.1023482396431538,0.040996273253156,0.0487684921499314,523,389,433,1345
430,TDC,0.0094999240006079,0.1162561576354679,0.0,0.1160142234013643,814,343,188,1345
431,CLX,0.0075805389424963,0.3038728897715988,0.0296607664662777,0.0473147732652458,823,75,447,1345
432,LW,0.0627878320181225,0.1709628653383983,0.0090923800751786,0.0067025964003883,346,232,768,1346
433,PYPL,0.029432563536132,0.1141420752022846,0.0,0.0621381157416397,663,350,335,1348
434,SRC,0.0531439237503571,0.0403042881490174,0.0667872798739279,0.0740390180228019,411,645,292,1348
435,CACI,0.0486629059771564,0.1012157121742615,0.0,0.041023765089542,453,392,505,1350
436,LYV,0.026099457540066,0.0897475533636055,0.0,0.0943204735240493,702,427,223,1352
437,MDLZ,0.0502319187124178,0.1050441024857764,0.0218796016170241,0.0364862615854263,436,375,542,1353
438,NEU,0.0742462138227542,0.0,0.0,0.0888753512669492,278,839,238,1355
439,HHC,0.0478039569447979,0.0407919811740368,0.0,0.08373910944062,462,642,253,1357
440,TKR,0.0699470693755196,0.0,0.0,0.1009775094661301,309,839,210,1358
441,MET,0.0436797786056272,0.00465940569693,0.0306739051807142,0.2271554929927932,505,797,57,1359
442,TREX,0.0390436051660532,0.3836614803780403,0.0,0.0084572696034188,557,41,761,1359
443,FTNT,0.0214893177561472,0.3078486156972314,0.0,0.0363310593208443,744,71,546,1361
444,RCI,0.0524622010497214,0.0817680995965818,0.0315397756310825,0.0428129033566476,416,463,485,1364
445,MSI,0.0315754663491359,0.2012357644778289,0.0122780610161717,0.036301361532719,642,176,547,1365
446,WAT,0.0344412002547214,0.3499576874932885,0.0,0.0208375697170249,612,54,700,1366
447,VMW,0.0253757083291878,0.1072906717605858,0.0434515553581983,0.0743504391684728,711,372,289,1372
448,BMO,0.0578855398736505,0.0050222399997253,0.0358452724578413,0.1049498654204055,375,795,203,1373
449,UNP,0.0426313396791899,0.1464224679972914,0.021205399091091,0.0318983201581397,512,270,593,1375
450,GS,0.0946179215569117,0.0313193754467677,0.0309371447626808,0.041675241179494,203,677,496,1376
451,BIP,0.1003713411133167,0.055548674758484,0.1035102266899513,0.0289799435796267,188,567,622,1377
452,AAP,0.053311029957686,0.1074219328760894,0.0357158151932619,0.0314701339112244,406,371,601,1378
453,CPA,0.1031233904191847,0.0574180727415507,0.0,0.0267415536832616,181,551,646,1378
454,ODFL,0.0279471678743484,0.3302658052412216,0.0,0.0279471678743484,683,60,636,1379
455,FUL,0.0346865267798054,0.0881066219704254,0.0103875742178354,0.0620599810874576,607,438,337,1382
456,AMX,0.064265907233802,0.1513171838542804,0.0012788566716142,0.0034248825698532,335,265,783,1383
457,CME,0.0446111976863433,0.0826541183177027,0.0436579669665496,0.0491751005934597,497,457,429,1383
458,SJR,0.0454235595604345,0.091719298245614,0.0351973131672477,0.0436993668546065,492,419,477,1388
459,WEX,0.0277243890351209,0.0897473659840898,0.0,0.0775162014974759,686,428,276,1390
460,FMC,0.0468461385806097,0.1437117625513789,0.0170147210730659,0.0279931915673134,479,277,635,1391
461,JHX,0.0531317922692204,0.196044211751018,0.0134489849181464,0.0008094296478514,412,187,793,1392
462,KMX,0.0442157797035121,0.0440308235810913,0.0,0.0784984647311382,499,625,268,1392
463,TXN,0.042060328078312,0.2525492627807634,0.0294422296548184,0.008715726970452,519,114,760,1393
464,RHP,0.0286446416501878,0.0898432254253444,0.0013001820010531,0.0733722348676302,673,426,294,1393
465,NVO,0.0267251285917478,0.7082323535707135,0.0101451568415813,0.0223591374946577,697,6,690,1393
466,MTD,0.026837331934186,0.4843081993837923,0.0,0.0226948262258112,693,20,684,1397
467,APO,0.0534698725103667,0.0110761982728944,0.0257922586921721,0.0961572671444991,405,775,217,1397
468,J,0.0385246248587138,0.0960500593681853,0.0074309150426584,0.0484483277851733,561,400,436,1397
469,ESI,0.0419884491391358,0.0713486719452547,0.0175849060497235,0.0568593582092464,521,499,379,1399
470,OFC,0.059517945130501,0.0120779059201754,0.042530999576145,0.0789247667980696,367,767,266,1400
471,IBN,0.0408753295900033,0.0429297293002985,0.0022549385628874,0.0915686105359551,539,632,230,1401
472,BR,0.0323473346611847,0.1604688624601569,0.0169790164491788,0.0383746290200322,634,246,522,1402
473,CW,0.0459195650304506,0.0945323724046285,0.004489648857853,0.0400243170826619,489,407,507,1403
474,TPL,0.0246581003942758,0.6852288292152686,0.0136603916184552,0.0235484466544417,720,7,678,1405
475,LEA,0.0447257368010149,0.0708946085577338,0.0253177423759178,0.0523005869458313,495,502,409,1406
476,ROST,0.0368470143816158,0.2035058117831127,0.0105102527429606,0.0252293585493581,574,171,662,1407
477,CCK,0.0731690089572756,0.1288455974539492,0.0106683836994101,-0.0036232246526298,290,310,809,1409
478,INGR,0.0758911893105717,0.1341785525620707,0.0279193196447428,-0.0228290569470825,270,296,844,1410
479,FMS,0.0749817208163371,-0.0088217639225594,0.0440705342633388,0.0842290950031959,276,885,250,1411
480,IBM,0.0586821041328095,0.0,0.0470583229089552,0.1050677183033722,370,839,202,1411
481,HAL,0.0811721030128758,0.0,0.0177237040695286,0.0639714943759548,247,839,326,1412
482,MTH,0.115808833500041,0.0,0.0061974941706652,0.0497536474904067,146,839,428,1413
483,AU,0.0363960465850671,0.0456120892832385,0.024876759113699,0.0950953944444852,580,617,219,1416
484,SID,0.1103739027273615,0.1177422786916635,0.1912839494173923,-0.1697354833691109,159,340,918,1417
485,WST,0.0334608030592734,0.2369423461811608,0.0030896559916482,0.0250941745421483,624,130,663,1417
486,ANET,0.0363653635398765,0.2785734599395572,0.0,0.0120506316794185,581,97,746,1424
487,AEM,0.0528988915194968,0.0588941931364843,0.0480101663763028,0.0440712155118404,413,541,473,1427
488,UHS,0.0655829508623025,0.086664509456104,0.0056737815732927,0.0254350903419614,330,445,655,1430
489,HIW,0.0613777648451275,-0.0005550148857658,0.0881191797502167,0.1099450906422241,356,877,197,1430
490,VMI,0.0355990154587464,0.1573732393317406,0.0065011488151363,0.0330608811364465,596,255,580,1431
491,PH,0.0416016479607575,0.0726176882898823,0.0140617890580234,0.0519124428938698,526,495,412,1433
492,EDU,0.028890584051978,0.0458884263596588,0.0,0.1348832737123841,669,614,151,1434
493,SCI,0.0518455289912568,0.0649983734916071,0.0146763515491896,0.0418199214425299,423,519,493,1435
494,MSCI,0.0231778142561397,0.3222944813568586,0.0099283513310525,0.0272219704191748,729,64,643,1436
495,KO,0.0346598568390268,0.1493585618642095,0.0276639561607659,0.034630798061547,608,266,565,1439
496,TMUS,0.0437712560495216,0.0763892607387258,0.0039313608595638,0.0460921799304689,504,480,459,1443
497,MSFT,0.0284254419464972,0.2875738645407972,0.0077779985149548,0.0233634576604514,676,87,680,1443
498,CTAS,0.0280890012907362,0.2463903172835864,0.0093750930584522,0.0263948178277476,679,118,649,1446
499,FAF,0.0469610990682775,0.0168171266443126,0.0387473707141301,0.0928508422642749,477,745,225,1447
500,FDS,0.0280853827745307,0.1810386134813953,0.008315273272039,0.0350839006279602,680,210,557,1447
501,MCD,0.0318275281223497,0.2009499608650433,0.0214756212515909,0.0282729887284932,640,179,630,1449
502,GNRC,0.062880449164037,0.1355693875977936,4.863569842375622e-05,-0.0043554920607837,344,293,812,1449
503,MMS,0.0354432764526054,0.0903504768781742,0.0149125430055763,0.0489932231645751,598,425,430,1453
504,EBAY,-0.0550555611734699,0.1417455817600579,0.0211320011097541,0.0780025807834484,897,282,274,1453
505,EW,0.0329532632694859,0.2405056326597983,0.0,0.0206436961700032,627,124,704,1455
506,ADSK,0.0177086130562613,0.1818683339463037,0.0,0.0435722253206915,771,206,478,1455
507,FICO,0.0197858719780524,0.5323233904138231,0.0187548178051059,0.0214126565799533,751,13,695,1459
508,FR,0.0418537096031893,0.0459092905010995,0.024379428783861,0.0644900578048588,522,613,324,1459
509,JLL,0.0847583329682379,0.0896649314162948,0.0,-0.0007640552551758,229,429,802,1460
510,ADI,0.0411016812156859,0.0838521151706974,0.0208213711422613,0.0440974877323687,536,456,472,1464
511,AVB,0.0501186629687827,0.041523984408233,0.039240099158381,0.0549883219270004,438,636,393,1467
512,ATO,0.0562497812242701,0.0504218503772565,0.0273257145028893,0.041512582626855,385,586,497,1468
513,PDI,0.0357333332681289,0.020032247817643,0.153051756955856,0.1331554936765488,594,722,154,1470
514,BAK,-0.0417387867756786,0.0668942407065234,0.0687178223302066,0.2088975377163233,889,514,69,1472
515,WTM,-0.0477336588405943,0.1225098764394385,0.0007505292270533,0.0816325622625049,894,325,257,1476
516,TRQ,0.1585650654567641,0.0777851855153162,0.0,-0.1271275602617258,90,475,911,1476
517,NKE,0.0310430813311096,0.178815207780725,0.0123192662008269,0.0298307479773503,645,214,618,1477
518,COST,0.0260465458770796,0.2291378385247522,0.00517867592057,0.0279217978291325,703,138,638,1479
519,ZTS,0.0307643159788894,0.2456200034019391,0.0088916731613535,0.0192968226054907,648,120,711,1479
520,FCN,0.0440176191587979,0.122932170834284,0.0,0.0253203077334602,500,323,659,1482
521,RSG,0.0364347042988079,0.0931978833009905,0.0145214682567647,0.0425185847423572,579,413,490,1482
522,ADBE,0.0195245091400637,0.3089000371609067,0.0,0.0249703652266621,754,69,664,1487
523,CBU,0.0552844139233216,0.0186578558060635,0.0274501175719888,0.0592811077739253,395,730,362,1487
524,WNS,0.0305424289074743,0.1393654537791748,0.0,0.0355922018344522,651,286,552,1489
525,ROL,0.0204906518235228,0.3030184665197599,0.0117639786260686,0.0241987138328729,748,76,670,1494
526,CDNS,0.0194869090368369,0.2833411842322282,0.0,0.0256552891157367,755,91,652,1498
527,JBHT,0.0535887714303501,0.1112764430824847,0.0092170269881123,0.0130515764587911,404,356,739,1499
528,PEP,0.0357385239628608,0.1760190819852604,0.024756248024554,0.0224779672601427,593,219,687,1499
529,INCY,0.0191045425332776,0.1253010943518711,0.0,0.0500302801334974,757,317,426,1500
530,CPRT,0.0293665620552247,0.23803728036816,0.0,0.0201094853183299,664,129,707,1500
531,MKTX,0.0239461395143292,0.2808770469053566,0.010138523532623,0.0227149742989548,724,94,683,1501
532,FL,0.0832617124409088,0.0922661584881689,0.0365182949302231,-0.0272669935478999,236,416,850,1502
533,BC,0.0618977156444856,0.0,0.016490352407665,0.067124568416558,354,839,313,1506
534,CAH,0.0105741778576715,0.0748635567912676,0.0212698979895692,0.0955322275417224,808,484,218,1510
535,WPC,0.0392107414312933,0.049611723174609,0.0546635192429099,0.0588427156002151,554,593,365,1512
536,FISV,0.0389726855543089,0.0651443103238055,0.0533140176693529,0.0483538576897136,558,517,438,1513
537,ADT,0.0250971972378576,0.0368130423349986,0.0184239540416642,0.141588812162711,716,662,135,1513
538,DG,0.0470457735643754,0.1434885126268996,0.0096141669514409,0.008255889308854,475,278,762,1515
539,OGE,0.0841172334186888,0.0883127763555969,0.041610042008073,-0.0262574149082222,233,436,849,1518
540,TTC,0.039065388137203,0.1597729717698557,0.0168134018097334,0.0186381120836579,555,249,717,1521
541,UAA,0.1004421632469818,0.0810844090838445,0.0,-0.0513443944461959,186,466,870,1522
542,UA,0.1004421632469818,0.0810844090838445,0.0,-0.0513443944461959,186,466,870,1522
543,MPWR,0.0269246286155185,0.2933942639453963,0.0084873064462428,0.0115549542065324,691,84,748,1523
544,NFLX,0.0251543674850299,0.1744110813239094,0.0,0.0322139714487413,715,222,587,1524
545,KT,0.1437860183773853,0.0558127191752908,0.0543027977567784,-0.0444253375138047,103,560,862,1525
546,BLK,0.0484163866161842,0.0548850722918493,0.0279577049019681,0.0413568323683629,458,570,498,1526
547,FLO,0.0376391512046093,0.1103174051661064,0.0307352178201303,0.0316114552298473,569,360,598,1527
548,WHR,0.0718194509768789,0.0,0.0,0.0546484803691012,299,839,394,1532
549,TU,0.0484535451763131,0.0645471430132197,0.0356426078448668,0.0349225551611322,457,521,558,1536
550,ABB,0.0427878376738353,0.147530836907025,0.0293550498465342,0.0090762079914196,510,267,759,1536
551,PEAK,0.0370485018152984,0.0487784615375823,0.0479752591290994,0.0586137415815884,573,598,366,1537
552,AER,-0.0981725202027252,0.0686466432379775,0.0,0.1521661591370142,910,510,122,1542
553,PBH,-0.0263417294776969,0.1081943267395633,0.0,0.0710285119729331,872,367,303,1542
554,BRX,0.0237905364726707,0.0557796831116367,0.0425954814958185,0.0832964382408182,726,562,255,1543
555,CRL,0.0439151791247903,0.0999779610009545,0.0,0.0266355434101725,501,395,648,1544
556,COTY,0.0487051726963517,0.0547819603417701,0.0013129887169225,0.0386133689086188,452,571,521,1544
557,WM,0.0345583352110337,0.1247543840136432,0.0166306197597334,0.0300957083674284,611,321,615,1547
558,DLTR,0.0481309782345721,0.118971745340987,0.0,0.0107560252214191,461,335,752,1548
559,BCH,0.158099716783989,0.0496822869703076,0.0605537800039806,-0.0461838012122752,91,592,865,1548
560,WAB,0.0348081772491773,0.0671805435577114,0.0061038035934576,0.0488854179692238,605,512,431,1548
561,OSK,0.0300135176862123,0.0702399818881593,0.0167930722879152,0.0555051597923283,656,503,390,1549
562,SEM,0.0522671634114944,0.0619468822646264,0.0212327749322931,0.0310501678409618,418,529,606,1553
563,AME,0.0360501847851547,0.1097322166229652,0.0062854383953577,0.0314123620369138,588,364,603,1555
564,REG,0.0323222667539138,0.0500532061154356,0.0404940518073746,0.0624703264046732,635,589,332,1556
565,JKHY,0.0300495790105991,0.2024719293272347,0.0120672525127332,0.01430782077474,653,173,731,1557
566,HOLX,0.0266262184823232,0.0842662632375189,0.0,0.0526101378345905,698,455,405,1558
567,NNN,0.0233649091597684,0.060650559029585,0.0476205655928442,0.0723754059080813,727,535,299,1561
568,WMT,0.0298033783354139,0.1352856641434711,0.0156008437622192,0.030579082703048,659,294,610,1563
569,ENB,0.0280155425528173,0.060863615534785,0.0681590256046899,0.0597907466603418,681,534,358,1573
570,H,0.0461081900812669,0.0402216066481994,0.0,0.0479322503482181,487,646,440,1573
571,MAIN,0.0877891646294737,0.0825902885716094,0.070554428502452,-0.089725855967748,217,458,899,1574
572,MDU,0.0867812036871739,0.0701610452675641,0.0417765895246704,-0.034615192071008,219,504,854,1577
573,LNT,0.0495228588059259,0.0521348314606741,0.030897643686496,0.0350847075505539,442,579,556,1577
574,CUBE,0.0220015746653836,0.0653833370085287,0.0427583065366286,0.0653311613201386,742,516,320,1578
575,DISH,0.3094578420357404,0.0439150790147522,0.0,-1.051536439396409,16,626,937,1579
576,RJF,0.0817542170179089,0.0920495150587034,0.0,-0.173333983982191,243,417,919,1579
577,VC,0.0337293540311882,0.1434628975265017,0.0,0.0233929390861466,621,279,679,1579
578,ASGN,0.047211944169777,0.0,0.0,0.0782775326043361,471,839,270,1580
579,CAG,0.0409712364658868,0.0624293801350223,0.0373871522928908,0.0379505367615557,537,524,526,1587
580,NYT,0.0319034648210314,0.1577071981134671,0.0104183190085758,0.020863422214638,638,253,699,1590
581,LHX,0.0265934283982457,0.0854836384604295,0.0216353315782338,0.0477279421158723,699,452,442,1593
582,TDG,0.0269143639679618,0.1589364363003643,0.0007879397771822,0.0256287780157171,692,250,653,1595
583,KBR,0.0258883802049269,0.0915887850467289,0.0089928057553956,0.0442827556136908,705,420,471,1596
584,GHC,0.0230187326514262,0.082229825480085,0.0105390855139552,0.0524758060951431,730,460,407,1597
585,IQV,0.028383840265425,0.0910471177691178,0.0,0.0412619346113328,677,422,499,1598
586,FNV,0.0268060202204475,0.1247909254021835,0.0075604761569518,0.0328283833130802,695,320,584,1599
587,RMD,0.0279894917320185,0.1888599949108778,0.0080541091214128,0.0174412457119402,682,198,722,1602
588,TMO,0.0321952311404505,0.1046821991618439,0.0021077453480438,0.0320145672534753,636,380,588,1604
589,STR,0.4652134943789417,0.0377081110080882,0.3373001164031441,-0.9937875804904944,8,660,936,1604
590,BSAC,0.1252351672852763,0.0497273289850836,0.0734989730583861,-0.0746533591898407,128,591,887,1606
591,FSS,0.0428251053287733,0.1196606637892543,0.0077540473103593,0.0066869765795759,509,331,769,1609
592,MTN,0.028715414536428,0.1048558882089673,0.0336630911270125,0.0347662039048059,672,376,563,1611
593,TAP,-0.0166895039933105,0.0819280750814701,0.0294683842627194,0.0752235767119404,865,461,286,1612
594,CMG,0.0232668626271891,0.1932193890260196,0.0,0.0218413515948564,728,191,694,1613
595,THG,0.0241132758550442,0.0133654969658135,0.0226373770742614,0.1464465762058509,722,763,130,1615
596,ORCL,0.0289786671741859,0.1228278253993926,0.0125007351752221,0.0288662014542343,668,324,623,1615
597,DGX,0.0553017116333043,0.0,0.0203334162211446,0.0559492726594554,393,839,384,1616
598,AOS,0.027237563904573,0.0972019515449731,0.0204772860580837,0.0371064139573966,689,398,533,1620
599,HAE,0.0274614343013781,0.0927107341671969,0.0,0.0387566955257108,687,415,519,1621
600,STOR,0.0288806433964395,0.0441424207801103,0.0428348281895147,0.0627848449778314,670,622,330,1622
601,ESS,0.0296187214708086,0.0483107796616332,0.041051505160589,0.0589346655677291,660,600,364,1624
602,BAH,0.0221869063625019,0.0960220457375132,0.0192428398630091,0.0429950443019778,741,401,482,1624
603,HDB,0.0487897404234814,0.0273052836090274,0.0085077845296203,0.0426973511989583,451,688,487,1626
604,NOK,0.0384464939765188,0.0583537871193003,0.0361746556960881,0.0387377552945227,562,544,520,1626
605,MGA,0.0362863562319855,0.1016616044309451,0.0315053836203388,0.025375931554125,583,390,657,1630
606,SSL,0.0603123317234296,0.0623623507592442,0.0,0.0128023574030031,361,526,743,1630
607,STN,0.0343454570286479,0.0904098611798534,0.0108737438851832,0.0318981694023151,614,423,594,1631
608,MCO,0.0268159208815575,0.1572573910138633,0.010051091160118,0.0232443681003894,694,257,681,1632
609,MNST,0.0222822569979092,0.2173492520429283,0.0,0.0126320799060019,739,150,745,1634
610,HWM,0.0286040706444498,0.1047532201071469,0.0026835375444686,0.0329343244093878,674,379,583,1636
611,BMI,0.0208736801633496,0.1771641957644575,0.007810365076761,0.0240328584171385,747,217,674,1638
612,MLM,0.0411673303323483,0.0890684971951579,0.0075562093399591,0.0241931680564123,535,432,671,1638
613,LLY,0.0189298833260933,0.2203074963834864,0.0107180824789266,0.0139452080536382,761,146,733,1640
614,PAYC,0.0156539091969503,0.2482366159808479,0.0,0.0127008011656808,782,115,744,1641
615,CPT,0.0373844228956054,0.0,0.0,0.0899104505657068,571,839,235,1645
616,BAP,0.1127417874462187,0.0434804622194729,0.029113740535482,-0.0494283773797843,152,628,868,1648
617,SAP,0.022652741000527,0.1181234292097179,0.0145062338760059,0.0334945608911536,734,339,576,1649
618,NJR,0.0671505253282363,0.0710186004170728,0.0382961736011084,-0.0157082978176378,325,500,826,1651
619,AIZ,0.0406782432811119,0.0158626849550291,0.0220891979060846,0.0603849844223592,543,753,357,1653
620,ATR,0.0332671943339064,0.115410972034658,0.0138276403983679,0.0226613367307223,626,344,685,1655
621,TRI,0.0341867526208914,0.1090368608799048,0.0151639172992507,0.0239144215472054,616,365,675,1656
622,STZ,-0.0008938548710438,0.1310454503549368,0.0136446365639609,0.0399680820909627,842,307,509,1658
623,JBT,0.0447210664622796,0.0857914310459014,0.0044823716194021,0.0187164677542976,496,450,715,1661
624,INTU,0.0165799995409899,0.1309295539808253,0.006182726338901,0.0332851836422726,776,308,578,1662
625,EPAM,0.0223372210406545,0.1756665607903686,0.0,0.0203698204587434,738,220,706,1664
626,ABMD,0.0090681704672291,0.2428062147216561,0.0,0.0165829836945386,819,122,726,1667
627,SXT,0.0461248149337029,0.1150953429180308,0.0225619938046529,-0.0220175463592907,486,345,840,1671
628,TRMB,0.0357778878173467,0.0879815392033615,0.0,0.0276866910394411,592,439,641,1672
629,ICE,0.0252145635552604,0.0557265260034981,0.0148741512535526,0.0535678694617981,713,563,399,1675
630,IP,0.0255943657529953,0.0,0.0508717734161703,0.1452460446601872,707,839,132,1678
631,EGP,0.0295189252948587,0.0494895366526175,0.03074831238242,0.0501808411916731,662,594,422,1678
632,ADC,0.0273218544780947,0.033007563656309,0.0408190516905361,0.0649043031905781,688,673,322,1683
633,MDT,0.031071895222725,0.0669743702455523,0.0298978108369807,0.0378683555402024,644,513,528,1685
634,DOV,0.0491318909403122,0.0,0.0132169560218483,0.0531730306716466,448,839,401,1688
635,SNPS,0.0172196743072038,0.1727428249461054,0.0,0.0211618547143901,772,225,697,1694
636,SKX,0.0571379324022147,0.0744168060014616,0.0,-0.0184829634482613,379,487,831,1697
637,TDY,0.0421355488745651,0.0757563948685174,0.0,0.0210624313547471,518,482,698,1698
638,DAL,0.1949414202935329,0.0,0.0,8.459163388740854e-05,61,839,798,1698
639,PLD,0.0379912901437673,0.0314921677463994,0.0290311830979079,0.0465899281835377,568,675,456,1699
640,VEEV,0.0189797774768525,0.1208931787366033,0.0,0.0302762448303265,760,328,613,1701
641,DB,0.2456120638413967,0.0128213050173778,0.0180485969085261,-0.1089139468617958,28,766,908,1702
642,GD,0.046745526393194,0.0,0.0201365344462989,0.053669222760934,480,839,397,1716
643,ENPH,0.0110802858975096,0.1832583079489841,0.0,0.0194738892581257,807,203,709,1719
644,SMFG,0.5539148412709902,0.0118636296299289,0.207311999284389,-4.257810409599738,6,773,940,1719
645,ACM,0.0048070864398169,0.0602130922337717,0.0083568867711066,0.060464758555335,830,536,356,1722
646,LIN,0.0254411108757618,0.0849807689263837,0.0143800250525164,0.0349132775485798,710,454,559,1723
647,AIN,0.0300447137011458,0.1265057420337275,0.008303224119179,0.0099977532507749,654,315,755,1724
648,SAM,0.016572556679903,0.1326035383302671,0.0,0.0269453416616005,777,305,645,1727
649,PNR,0.0518892164811614,0.0,0.0120955438000716,0.045383280043244,422,839,466,1727
650,DLB,0.02521786765171,0.0857257364498697,0.0102183268600316,0.0342321325382109,712,451,570,1733
651,PWR,0.0240224991001142,0.0867016903617298,0.0020080168083008,0.0343096115623581,723,443,568,1734
652,NI,0.0720346597708328,0.0573380261912203,0.0391124641909533,-0.0711029840319736,296,553,885,1734
653,CS,-1.0002653516001097,0.0037989998068973,0.0383348341702752,1.6952211310583845,937,798,4,1739
654,VAL,0.0347559854139073,0.1303535803726813,0.0,-0.0156549622685871,606,309,825,1740
655,SBAC,0.0152480914079785,0.0935863750580611,0.0101371955574095,0.036457534273945,786,410,545,1741
656,AON,0.043294304857084,0.0,0.0082569871587808,0.0537464010764814,508,839,396,1743
657,O,0.0224049363991632,0.027129550840727,0.0467327264291001,0.0660714309238161,737,690,316,1743
658,PKI,0.0327038960267504,0.0591304523672793,0.0019957327547605,0.0335508289032967,630,540,575,1745
659,MKL,-0.0056564804336124,0.016039782459096,0.0020121270674787,0.1372007965653348,851,751,146,1748
660,JNPR,0.0328824626865671,0.0,0.0297659430122116,0.0756233039348711,628,839,281,1748
661,ANSS,0.0249022247461003,0.0944632063087468,0.0,0.0288451839842681,717,408,624,1749
662,IR,0.028554665042257,0.062427913442663,0.0015299671694544,0.0361572796805957,675,525,549,1749
663,IX,0.1058020514598503,0.0250563842478783,0.0411817268137599,-0.0646982014650721,175,698,877,1750
664,CIEN,0.0417011519763428,0.0765707229550908,0.0815491885254346,0.0101680790420562,524,478,754,1756
665,BRO,0.0437825376429232,0.0,0.0067849101987712,0.0507736608277208,502,839,418,1759
666,SJM,-0.0055159444021803,0.0896598921928226,0.0259907916957064,0.0433179861595107,850,430,481,1761
667,TR,0.0259166787754709,0.1192651659137776,0.0084056768315982,0.0166192063548936,704,332,725,1761
668,AXTA,0.033931328728519,0.0746990503759663,0.0,0.0253068208523245,618,486,660,1764
669,WTW,0.0416567953881386,0.0,0.0138987601674168,0.0531074784806128,525,839,402,1766
670,IPGP,0.0228712926097998,0.118813076381513,0.0,0.0213311963792352,733,337,696,1766
671,SR,0.073221229106701,0.0489121544249959,0.055715463986938,-0.0748371458869868,288,597,888,1773
672,GMED,0.0254855622512133,0.1189151149603374,0.0,0.0139940153013054,709,336,732,1777
673,NOC,0.0289890996191514,0.0733194613028148,0.0157353283924966,0.0296094889106119,667,491,619,1777
674,WCN,0.0244927373125342,0.0795156305610819,0.0071225610025714,0.0325279924903971,721,472,586,1779
675,BAC,0.0978605983881241,0.0168901511819335,0.0304872308840654,-0.0224921536617866,194,743,842,1779
676,TGT,0.0357012275224975,0.1137283877641495,0.0235782207666566,-0.0193916739420759,595,354,833,1782
677,VSH,0.0968782887650273,0.0,0.0151941129377723,0.010857895541193,197,839,751,1787
678,HE,0.0528987654088811,0.0240593354973327,0.0337640255092426,0.0240387393756745,414,700,673,1787
679,DEO,0.0094765967288218,0.1891669939657942,0.0044692787465064,0.0046799261831674,815,195,779,1789
680,CUK,-0.0043464879202877,0.0519673742660538,0.0,0.0585601142773905,846,583,367,1796
681,CCL,-0.0043464879202877,0.0519673742660538,0.0,0.0585601142773905,846,583,367,1796
682,TECH,0.0222331566177608,0.1190925123785795,0.0039191703113411,0.0168464699935581,740,334,723,1797
683,EFX,0.0292648101293065,0.1107765900531853,0.0080329003385672,0.005573849214516,665,358,775,1798
684,NOV,0.124591595525242,0.0,0.0099121208927433,-0.0175657838605577,130,839,829,1798
685,PGR,0.0095181527200862,0.0166675723057475,0.0034405186824649,0.0864984390229539,812,746,242,1800
686,ARE,0.0042667510640648,0.0295891356005408,0.0,0.0752580042783848,833,682,285,1800
687,QRVO,0.010167018691973,0.0298506878917364,0.0,0.0674448117002666,811,680,311,1802
688,REGN,0.0421881392319144,0.0,0.0,0.0472162278615375,517,839,448,1804
689,ROP,0.0238182413176384,0.0692421531246652,0.0049935367940894,0.0338879095874564,725,508,573,1806
690,STAG,0.0180444688495643,0.0348683054529156,0.0461980026582694,0.0580409406413175,768,669,369,1806
691,TFX,0.0310185715654084,0.0787393696533135,0.005448722559642,0.0224607227857534,646,473,688,1807
692,SYK,0.0255012327866949,0.092900820771067,0.0113663255550535,0.0220188761466118,708,414,691,1813
693,DOC,0.0115289369956754,0.0262589118830012,0.0638684566642866,0.0666480644040513,806,693,315,1814
694,PSO,0.0351986263373835,0.0463644140290846,0.0226900235893877,0.0311260580008268,600,612,605,1817
695,LXP,0.040571937916668,-0.0357215307112494,0.0507977364592816,0.057660339107693,544,901,372,1817
696,PTC,0.0145876822794291,0.0817638888789811,0.0,0.0348292945070804,791,464,562,1817
697,FRC,0.0754688245764567,0.0147082388474256,0.0157736642357999,0.0024929641751982,273,758,790,1821
698,KIM,-0.0009473123262751,0.031730569162006,0.0417845276611456,0.0660521381804158,843,674,317,1834
699,IRM,0.0384204895886509,0.0738152774213507,0.0499682064776782,0.0030428410246212,563,489,784,1836
700,IVZ,-0.0411283134359556,0.0,0.0,0.1603227752996438,886,839,111,1836
701,R,0.2241366177709441,-0.0309784357901512,0.0317979284726944,-0.0829848377214222,43,900,894,1837
702,AEG,-0.0852884162917053,-0.0040589168547648,0.0138957712397217,0.2290722049278682,906,880,53,1839
703,KRC,-0.0051340561974768,0.0,0.0,0.129098889583599,849,839,158,1846
704,AMZN,0.019433571154681,0.1015382835037485,0.0,0.0205781877367414,756,391,705,1852
705,APD,0.0365112154288694,0.0887546385737208,0.0237556234287653,-0.0225413342450819,578,435,843,1856
706,GWW,0.0442304198351934,0.0,0.0094796744534695,0.038353988987762,498,839,523,1860
707,EVRG,0.0522310434342726,0.0487457734044722,0.037110617814068,-0.025300170633899,419,599,847,1865
708,POR,0.0532545866369842,0.0442932053999776,0.0361125523117747,-0.0210275621055903,408,621,838,1867
709,VNO,-0.0958726021873477,-0.0113714941755081,0.1174385002246708,0.2001945581475969,909,887,73,1869
710,ISRG,0.0151754504897467,0.1281887570014801,0.0,0.0063267617837119,788,311,773,1872
711,RPM,0.0470514237489383,9.047091937315578e-05,0.0210258061191518,0.0317158310916017,474,802,597,1873
712,XYL,0.0178153880950638,0.0977679974850675,0.0108899696243066,0.0194714664250275,770,397,710,1877
713,ZBH,0.0086588834006885,0.0568800179604229,0.0075288130519383,0.0410417602155365,820,555,504,1879
714,ED,0.0492836736786646,0.0454537580765299,0.0323312774916058,-0.0069175276910414,447,618,816,1881
715,BFAM,0.021904041994194,0.052309071143457,0.0,0.0348933798273602,743,578,560,1881
716,MAN,0.0224378070985338,0.0,0.0364614365351174,0.0682230621239203,736,839,309,1884
717,AMH,0.0166375588721794,0.0292389982021781,0.0256075772387398,0.0500339765165106,775,684,425,1884
718,TSLA,0.0190179606436877,0.1141774752793116,0.0,0.0055244519317652,759,349,776,1884
719,SPGI,0.0306003761773584,0.0558573093125392,0.0096474092381819,0.0236851433835834,649,559,677,1885
720,HEI,0.0185719553879264,0.0957681040277218,0.0012594634708162,0.0183743157968721,765,402,718,1885
721,BKH,0.0566404366791789,0.0259183755599544,0.0343531701148256,-0.0042883649504313,381,695,811,1887
722,NWE,0.0609962710393271,0.0392866112841421,0.0466844793131707,-0.0692950970302406,357,650,882,1889
723,FLS,0.0470812842506992,0.0555940648623263,0.0260868476017486,-0.0290181839667578,473,566,851,1890
724,MMC,0.0401289854140326,0.0,0.0138677910190134,0.0410478066988054,548,839,503,1890
725,CUZ,-0.0002309002519303,0.0,0.0526084433319485,0.0997126361096756,840,839,212,1891
726,VMC,0.0247148623657825,0.0716523572827233,0.0091285263011907,0.0229973597691333,719,496,682,1897
727,IDA,0.0474025157622946,0.0467751765517085,0.0282397693639602,-0.0148813977092524,467,608,823,1898
728,CVX,0.0766492281270653,0.0,4.045286431441028e-05,0.0001274444220878,265,839,796,1900
729,EQR,0.0367607159609229,0.0,0.0,0.0425216422501075,575,839,489,1903
730,FTV,0.0333582807655297,0.0,0.00392994298693,0.0479992448344848,625,839,439,1903
731,NVDA,0.0091657078136022,0.1220139229902654,0.0008351537797192,0.0079906170682686,818,327,763,1908
732,CNP,0.056033516206515,0.046839948553824,0.0259227903736857,-0.1383078938342457,389,607,913,1909
733,ASH,0.0425291341431443,0.0313696881269378,0.0181585067128031,0.0174417235530872,515,676,721,1912
734,PRU,-0.0365091327881302,-0.0015592879835544,0.0471814326287572,0.1339360646665547,881,879,153,1913
735,MS,0.0767134348045702,0.0113779273839839,0.0375672555426134,-0.065904415157612,264,774,878,1916
736,ES,0.0483201261243267,0.0473417499114881,0.0298391117070286,-0.0357896198023335,459,603,855,1917
737,XRAY,-0.1384532873182618,0.0472732890468098,0.0151569914537886,0.0536324312980214,918,604,398,1920
738,UNF,0.0318993970665034,0.0580189912391553,0.0067999370639671,0.0134678753496336,639,545,737,1921
739,DLR,0.0131613602600198,0.0159012948835272,0.0505259880687493,0.057796828765174,799,752,371,1922
740,AZN,0.0156639454848963,0.05352614332526,0.0207899811727759,0.0344768775773097,781,575,567,1923
741,DXC,-0.0988923497716879,-0.0618314880840683,0.0,0.1677326073866085,911,910,102,1923
742,DNB,0.0003041382186548,0.0179106974298925,0.0081547059876831,0.0606755746216425,837,733,354,1924
743,ING,0.0828937125864078,0.0143356023215847,0.0697850443739138,-0.2559236205409974,239,760,926,1925
744,PNW,0.0561842903276853,0.0349173122384222,0.0440179323155068,-0.05414500420372,387,668,873,1928
745,TEO,-0.4916793677722549,-0.1792627278292896,0.0029385039048439,0.2188910447392636,936,930,62,1928
746,VFC,0.0133485668160016,0.172116692047907,0.0791168015276891,-0.10322851147159,798,229,905,1932
747,ALL,-0.0370906970875645,-0.0150659519734347,0.0280355635610549,0.1278323805048685,882,891,160,1933
748,HAS,0.0252052119176187,0.0573724353381554,0.0477226936209262,0.0246106909485544,714,552,668,1934
749,FIS,-0.4076971504145783,0.0351298508097079,0.0277686950665423,0.0621989487914029,934,667,333,1934
750,GPN,0.0040792156405299,0.0168859284053053,0.0100232437982776,0.0595781421116232,834,744,359,1937
751,CINF,-0.0298901592001541,-0.0215589840328774,0.0260155089334674,0.1252803586228681,878,895,165,1938
752,NWL,0.0362308445501821,0.0866064414768263,0.0708064728518787,-0.1074051432350576,584,447,907,1938
753,AEP,0.0474738441854778,0.0441395655369952,0.0338522748153381,-0.0305435915000534,466,623,852,1941
754,SUI,0.0140790989376679,0.0362414866405744,0.0252609287551051,0.0427550818565793,793,663,486,1942
755,ELS,0.0151868267237089,0.0866686535800873,0.0259104196947886,0.0188759000208975,787,444,713,1944
756,PANW,0.0058017198319013,0.057262404636584,0.0,0.0347179559283575,827,554,564,1945
757,SO,0.0460491820896689,0.045062811013116,0.0378684504482793,-0.0211161878832682,488,619,839,1946
758,IEX,0.0363176299337692,0.0,0.0116184734580939,0.0381880396619468,582,839,525,1946
759,XEL,0.0452670744353936,0.0440573398657231,0.0263884097515082,-0.0184093056171589,493,624,830,1947
760,NWSA,0.0131176752310119,0.0171181899374813,0.0153186274509803,0.0522065866576515,800,739,410,1949
761,NWS,0.0131176752310119,0.0171181899374813,0.0153186274509803,0.0522065866576515,800,739,410,1949
762,DXCM,0.0077377236433448,0.1101227339263596,0.0,0.0069099777084618,822,362,767,1951
763,SMG,-0.1308696825799059,-0.066060606060606,0.051335621343499,0.1508737040423961,916,911,124,1951
764,DTE,0.0472547107448834,0.0466009064249533,0.0298887136290352,-0.061130055174129,469,609,875,1953
765,EXC,0.0509093536670453,0.0391205834454436,0.0312963492128287,-0.0534196305529318,432,652,872,1956
766,RNR,-0.146270410733956,-0.0289327921705411,0.0126204727927168,0.1415492887406177,922,899,137,1958
767,HXL,0.0169411387586649,0.0,0.0067636334495331,0.0606963978042232,774,839,352,1965
768,ECL,0.026297335203366,0.0457172001692371,0.0145205034905093,0.0259095115368146,701,616,650,1967
769,CARR,0.0299358344099319,0.0,0.0128890398153873,0.0444463985891906,658,839,470,1967
770,AEE,0.0467425410394287,0.0438647287046152,0.0265483706089865,-0.0486139835577671,481,627,867,1975
771,TSCO,0.047198521332332,0.0,0.0191662760461217,0.0247304725060217,472,839,666,1977
772,NMR,0.0609670070873043,0.0286704408552741,0.0376252102669931,-0.7529477283905806,358,686,935,1979
773,ATI,0.0705271526962643,0.0,0.0027469192870989,-0.0197091458849346,307,839,834,1980
774,UDR,0.0069771859400379,0.0236289608566847,0.0391710186446575,0.0468809680383631,825,702,453,1980
775,RTX,0.0281705072458211,0.0,0.026995347032312,0.0455728797692752,678,839,464,1981
776,PVH,0.0349596367965877,0.0651386543418362,0.0017619377826623,-0.0437693257098995,602,518,861,1981
777,DUK,0.0493176112168247,0.0388172258890255,0.0400871097055192,-0.06859826259768,446,655,881,1982
778,TD,0.0763407405193908,0.0084104796385001,0.0412432585351003,-0.4754197146090722,268,784,931,1983
779,WEC,0.0501634483884526,0.0,0.0370735645445033,0.0197949178704902,437,839,708,1984
780,FRT,0.0326008497864067,0.0465360989693219,0.0444436513410422,0.012806196952337,633,610,742,1985
781,HON,0.0406939900414081,0.0,0.0205339946214599,0.03093404934042,542,839,607,1988
782,RCL,0.051192418333462,0.0,0.0,0.017496524828172,430,839,720,1989
783,TRNO,0.0287565187814953,0.0400219041695212,0.0257936614980073,0.0240411992918815,671,648,672,1991
784,DD,0.0310124603739822,0.0609288453344695,0.0190576099564904,-0.004530566784135,647,532,813,1992
785,BDX,0.0200506710560615,0.0457530505645982,0.0150515145259114,0.0285762596250473,749,615,628,1992
786,X,0.0818501038991043,-0.0161182815245712,0.0,-0.0435314519061158,242,892,860,1994
787,MGM,0.0150672975772496,-0.0440572461148416,0.0002950327749234,0.0722564273456687,789,906,300,1995
788,NOW,0.0120104942994905,0.0760327279984035,0.0,0.0187616271437448,804,481,714,1999
789,KGC,0.0058427665690644,0.0207778204024925,0.0294047729292786,0.0462456883342291,826,716,458,2000
790,MMM,-0.1155198804181796,0.0,0.0546799605524793,0.0836466324972237,914,839,254,2007
791,PCG,0.0561460068551364,0.0255697285525394,0.0,-0.1814685987826159,388,697,922,2007
792,CTVA,0.0270719200132626,0.0586057601807115,0.0098657912515638,0.0063018331678649,690,543,774,2007
793,GLOB,0.0212003475405242,0.0608860472979265,0.0,0.0144798151031401,746,533,730,2009
794,CRM,0.0012483027883243,0.0400915595273993,0.0,0.0378871899167862,836,647,527,2010
795,APH,0.0326055458685027,0.0,0.0084659420444878,0.0364596972706976,632,839,544,2015
796,BURL,0.0156342453576499,0.0765339852614375,0.0,0.0098702625728419,783,479,757,2019
797,RBC,0.024895779737299,0.0390251306749446,0.0034208374944296,0.0266795448255516,718,654,647,2019
798,NCR,0.0187491387114404,0.0556124189696349,0.0049997703230507,0.0218739951633471,762,565,693,2020
799,LII,0.0371436700287531,0.0,3.14723521680674e-05,0.0305911263073615,572,839,609,2020
800,TYL,0.0122620229089827,0.0564151351784043,0.0,0.0247348833282854,802,556,665,2023
801,ETR,0.0477002733767718,0.0392675114403348,0.0373900496591406,-0.117529167985691,464,651,910,2025
802,AWR,0.0229215654327495,0.0773183413397547,0.016477470043472,-0.0141632679107074,731,477,822,2030
803,CHD,0.0326283941993658,0.0,0.0115080294522644,0.0348522723111543,631,839,561,2031
804,WELL,0.0046611084992622,0.0200533265005236,0.0373487764445782,0.0428507817396765,831,720,484,2035
805,TEVA,-0.0478499207351939,0.0,0.0,0.0720744781020273,895,839,301,2035
806,GGG,0.0346592330856857,0.0,0.010833631964212,0.0319037299334788,609,839,592,2040
807,FTI,-0.0066613072039756,0.0416698292220113,0.0,0.0354418043564949,854,635,553,2042
808,PNM,0.0404717647718526,0.0470610338918086,0.0285202449663882,-0.0821708337042178,546,605,893,2044
809,ARES,0.0365398060248538,0.0492647223837192,0.0696275550531898,-0.0640950730254904,577,595,876,2048
810,DV,0.012022733759145,0.0609677745894612,0.0,0.0152495990439964,803,531,729,2063
811,ALE,0.0388424304889117,0.0218944758051359,0.0431615430946855,0.0002366637044259,559,710,794,2063
812,CCI,0.0300445307152318,0.0,0.054468213806642,0.0340451340062081,655,839,572,2066
813,KRG,-0.0026355751602609,0.0092541690086751,0.038951172666341,0.0478677610335262,845,783,441,2069
814,PRGO,-0.0285489645275299,0.017448024475701,0.0310570859336918,0.0459967656138736,873,738,460,2071
815,EL,0.0143132753694055,0.0878602620087336,0.0131608148277337,-0.0221670805422802,792,441,841,2074
816,SJI,0.0348209652703137,0.0549536517450838,0.0527055910965087,-0.1023441734233092,604,569,904,2077
817,NU,-0.0191556775649449,0.0415032809671747,0.0,0.0336883118004342,866,637,574,2077
818,PPL,0.0351518217924048,0.0403547932330827,0.0365932324743685,-0.0197612754785344,601,644,835,2080
819,COO,0.0190616938763212,0.0498695029888025,0.0001943748525797,0.0139301977682157,758,590,734,2082
820,CAE,0.0229105006907363,0.0578768712300666,0.0,-0.001738605575543,732,547,804,2083
821,AMRC,0.0320458336915418,0.064410609888931,0.0,-0.2248964225761875,637,523,924,2084
822,PEG,0.0337894748571567,0.0480041866882344,0.0353626026875578,-0.0453912926063647,619,602,864,2085
823,DIS,0.015888293284125,0.0194336161430864,0.0,0.0330522396823961,780,725,581,2086
824,CALX,0.0094710329703701,0.0731290649460045,0.0,0.0030290677502895,816,492,785,2093
825,TRP,0.0139311418071139,0.0747016143101979,0.0614236706950024,-0.0065558314386418,794,485,815,2094
826,SNN,0.0185942729639271,0.0545388437765119,0.0272660415210949,0.0091720628970044,764,573,758,2095
827,BSX,0.0105455214885018,0.0575225869466634,0.0008309508336212,0.0138088920350869,809,550,736,2095
828,VTR,-0.002273984561322,0.0197346990760227,0.0400184282139933,0.0370058750675348,844,723,538,2105
829,NE,0.0178641700324874,0.0500835638252922,0.0,0.0112786156727827,769,588,750,2107
830,FE,0.0169535830938535,0.0622301304863582,0.0372060161000578,-0.0030483043493874,773,527,808,2108
831,AWK,0.0295597330107236,0.050968930172966,0.016834628434156,-0.0472955728171579,661,585,866,2112
832,TM,0.0095094128060976,0.0728859247173391,0.0028240572355699,-0.0029124123107057,813,493,807,2113
833,ALGN,0.0212529901067412,0.0,0.0,0.0375238220034799,745,839,532,2116
834,CP,-0.0538106277157763,0.0,0.0040745048749956,0.0561874222261904,896,839,382,2117
835,PUK,0.0265477497722958,0.0101144415510862,0.0126088510942567,0.0277713935493756,700,778,640,2118
836,KEX,0.031653353549486,-3.236491667458827e-05,0.0,0.031454308412235,641,876,602,2119
837,NEM,-0.0135016863766383,0.0410901113736078,0.0465888229517995,0.0290579772018955,861,639,621,2121
838,WRK,-0.1796448069035286,-0.0671053040494044,0.0306452905894254,0.0747121944053608,923,913,287,2123
839,ST,-0.0006841111533931,0.0,0.0125206866838593,0.0476140662724638,841,839,445,2125
840,AMT,0.0180593851234439,0.0399489832310393,0.0269019179005023,0.0186402963676458,767,649,716,2132
841,DHR,0.0278374623221444,0.0,0.004818586668033,0.0299738393588849,684,839,616,2139
842,XPO,0.0186015566255004,0.0742121314808539,0.0,-0.0837562152820153,763,488,895,2146
843,FLR,0.0148938864048425,0.0578787039601218,0.0079570078053268,-0.0089771370111379,790,546,818,2154
844,ELP,0.0105397822773429,0.0232154466544996,0.0205464653438092,0.0279167692689665,810,705,639,2154
845,RYN,0.0305476128785588,0.0448823800113694,0.047261806292971,-0.0753279604222912,650,620,889,2159
846,CMS,0.0457317822773771,0.0100044087224878,0.0298322020590775,-0.0888409533847255,490,779,897,2166
847,F,-0.0460983291069391,0.077984882214592,0.0430351037062456,-0.0002784750364266,893,474,801,2168
848,KWR,-0.0059800301576631,0.0586334073282536,0.010109330478808,0.0044513561936219,852,542,780,2174
849,CWT,0.0291475488748392,0.0358988577942927,0.016450084712502,-0.0254966294721789,666,665,848,2179
850,SWX,-0.3999478358061597,0.1172389928799381,0.0395794243137323,-0.111410201554896,933,341,909,2183
851,FMX,0.0045472194929223,0.0502404942737553,0.0032153986526274,0.0073719433520996,832,587,765,2184
852,EBR,0.0397454578373985,0.0233059894468731,0.0,-0.3649684906286266,551,704,929,2184
853,PHI,0.0381788097333203,0.0177988121752041,0.09188767416503,-0.0704623888554585,566,734,884,2184
854,NGG,0.0134010125846182,0.0482128112771787,0.0079349400233904,0.0028293221116382,797,601,787,2185
855,EQIX,0.0117429111172271,0.0421645574226083,0.0191972409715852,0.0114233569535943,805,634,749,2188
856,TER,0.0267980097506938,0.0,0.0040534533681356,0.0254147907347221,696,839,656,2191
857,NDAQ,0.0360757660581614,0.0,0.0,0.0070175711123524,587,839,766,2192
858,GOL,-0.0683625269689603,-0.1036552142495524,0.0,0.0574160151701337,901,923,373,2197
859,REXR,0.0138132217501527,0.0240203757180548,0.0239271999950998,0.0206778006472778,795,701,703,2199
860,ALK,0.04722155171526,0.0,0.0,-0.089218591325853,470,839,898,2207
861,STE,0.0056119613159971,0.0269262183364549,0.0096214489167789,0.0207100930269077,828,691,701,2220
862,EIX,0.0339944932221416,0.021907406860283,0.0474025154274766,-0.1056964704309792,617,708,906,2231
863,STX,-0.0413052457662123,-0.0688960515713134,0.0454435785178366,0.048879175519185,887,915,432,2234
864,AES,-0.0229636572584237,0.0805409136546184,0.0223287174263936,-0.0971457943006131,870,469,901,2240
865,HASI,0.0163666059473181,0.0345455645496736,0.0521332122072083,9.070211960587852e-05,778,670,797,2245
866,NEE,0.019540891392135,0.0308605565638233,0.0201790104579286,-0.0089095869563646,753,678,817,2248
867,CZR,-0.0588605319913731,0.0563530898603324,0.0,0.0013479511143062,899,557,792,2248
868,GLW,0.0225005421817393,0.0,0.0383012671561793,0.0238172692629426,735,839,676,2250
869,ETN,0.0334820283600063,0.0,0.0,-0.000114450687371,623,839,800,2262
870,AGI,0.0093458382059221,0.0414053775448844,0.0088420194347133,-0.0038290226611864,817,638,810,2265
871,MTZ,0.0052175401623923,0.0228496288630855,0.0,0.0139135968622651,829,706,735,2270
872,AUY,-0.261708570233604,0.053687562856185,0.0214933367842704,0.004369936710938,928,574,781,2283
873,SWH,0.0153002591862109,0.0519963919318379,0.042369948515661,-0.178778542305585,784,581,920,2285
874,SWK,0.0153002591862109,0.0519963919318379,0.042369948515661,-0.178778542305585,784,581,920,2285
875,BA,-0.0140645350494479,-0.0187689692849338,0.0,0.0377248554881683,862,893,530,2285
876,ETSY,-0.0457203250753095,-0.3287530089266905,0.0,0.0429927968099581,891,936,483,2310
877,CCJ,0.0071822349148051,0.0161499969276328,0.0041699903884877,0.0129498310245361,824,749,741,2314
878,AGO,0.0337492853790228,0.0120524847117496,0.0174189860020762,-0.6747135359241736,620,770,934,2324
879,BEP,0.0197776002403752,0.0256706633313206,0.131134088550314,-0.0685050211224591,752,696,880,2328
880,IDXX,0.0183283297564104,0.0,0.0,0.0167631681902257,766,839,724,2329
881,SRE,0.0160996018949624,0.0386749180924645,0.0301535110459651,-0.086225949157899,779,657,896,2332
882,HR,-0.0217972809196829,0.0059109760233377,0.289407753659559,0.0224563526507305,868,791,689,2348
883,BIO,-0.2896398640701095,0.037316753058349,5.444138924023158,0.0064107402647222,929,661,772,2362
884,D,0.0200124020519758,0.0175784476776844,0.0444742415823085,-0.0783382861008431,750,736,890,2376
885,WDAY,-0.007932827867189,-0.0250844653328625,0.0,0.0280530432872504,856,898,634,2388
886,AMD,0.003589445751748,0.0065527158637819,0.0,0.004711672936428,835,790,778,2403
887,CVT,-0.0384403731892883,-0.0406671794855289,0.0,0.0253686527880201,885,904,658,2447
888,ORA,0.0135801448954701,0.0056424244710637,0.0055984245819132,-0.0582679195829364,796,793,874,2463
889,HL,-0.0120522804355126,0.0102950260959156,0.0041731843898481,-0.0191969063550331,859,776,832,2467
890,KSS,-0.0050280512331957,0.0219056099732858,0.0632475918280935,-0.1439610458346565,848,709,914,2471
891,CNC,6.701438253823804e-05,0.0,0.0,0.0001799120395752,839,839,795,2473
892,MUSA,7.26556791723967e-05,0.0,4.358296846907417e-06,-5.493541833976115e-06,838,839,799,2476
893,MXL,-0.0381233945985341,-0.044539975388287,0.0,0.0226049991185916,884,907,686,2477
894,RNG,-0.2607670989837461,-0.2573958397104221,0.0,0.0299193767828697,927,934,617,2478
895,UGI,-0.3112606304208982,-0.1100022853660394,0.0638270800064158,0.0275616936391341,931,924,642,2497
896,AL,-0.022623222966805,0.024896966305935,0.0291354673005771,-0.5263793302343457,869,699,933,2501
897,INTC,0.0080219427920065,0.0005687412471945,0.0146665241810042,-0.0678184257709068,821,801,879,2501
898,HUBS,-0.0081131703687451,-0.061186651225264,0.0,0.0130533613992272,857,909,738,2504
899,BAX,-0.0942431121948485,-0.0233200237872738,0.0223053710399207,0.0207093497264185,908,897,702,2507
900,CDAY,-0.007481306787299,-0.0101368324615066,0.0,0.0038833486184754,855,886,782,2523
901,COUP,-0.0372410235135132,-0.0929409377026433,0.0,0.0155617728881506,883,918,728,2529
902,MAC,-0.0824031195304747,0.0,0.0,0.0024943581983282,905,839,789,2533
903,SNOW,-0.0159946263978837,-0.1470231575345992,0.0,0.0099433996803168,863,927,756,2546
904,GWRE,-0.0160475527561572,-0.0903466461021124,0.0,0.0030082257046274,864,917,786,2567
905,TWTR,-0.0065022087014069,-0.038750597787026,0.0,-0.0111260485435955,853,903,821,2577
906,ENV,-0.0250983023738058,-0.0369861425207873,0.0,-0.0021398739787119,871,902,805,2578
907,KKR,-0.0294184694993097,0.0057392733264349,0.0147545612345193,-0.1541823352289236,876,792,915,2583
908,GME,-0.0451358458271879,-0.1740968269176576,0.0,0.0075394593955986,890,929,764,2583
909,NEWR,-0.0351284643148866,-0.4301764196358282,0.0,0.0066352914695669,879,937,770,2586
910,TSN,-0.0362548717483911,-0.0132764183920408,0.0374857470237995,-0.0104624398409709,880,888,819,2587
911,WK,-0.0204533667467482,-0.2150915963943006,0.0,0.0017352763457608,867,931,791,2589
912,MANU,-0.0091672609272623,-0.0141326854377719,0.0,-0.0242965339737231,858,889,846,2593
913,GPS,-0.0416976302534885,-0.0084870848708487,0.0454132606721162,-0.0161010651473866,888,884,827,2599
914,WBA,-0.1409766348620937,-0.0954600307935583,0.0759351419598095,0.0064538004920633,920,920,771,2611
915,TAL,-0.0289339450967737,-0.0230250611028225,0.0,-0.0229651619419147,874,896,845,2615
916,CTLT,-0.0295610690913539,-0.0147708894878706,0.0,-0.0410287252043791,877,890,858,2625
917,RIG,-0.2137899694290671,5.297171310520182e-05,0.0,-0.092607893359773,925,803,900,2628
918,LVS,-0.0291241939003118,-0.0431714175442465,0.0,-0.0395061767165581,875,905,857,2637
919,AA,-0.1073800747853034,0.0,0.0118761373034436,-0.0725763946321559,912,839,886,2637
920,TTWO,-0.0589586848863523,-0.0944340368843928,0.0,-0.0106468470707016,900,919,820,2639
921,TTM,-0.0774125649076574,-0.1012201748867129,1.0417058355567356e-05,-0.006029570398109,904,922,814,2640
922,HCP,-0.0458200912498987,-0.238307931680469,0.0,-0.0156120195124118,892,933,824,2649
923,WYNN,-0.0757023474851148,-0.0212946292800118,0.0001542075370132,-0.0452245350901817,902,894,863,2659
924,ILMN,-0.138728760702338,-0.4408692900094946,0.0,-0.0023310463878231,919,938,806,2663
925,PHG,-0.1307231816516932,-0.0050980047464182,0.0332867434119268,-0.079096412136593,915,881,891,2687
926,SE,-0.0574719893258907,-0.1125015694682403,0.0,-0.0699740465199677,898,925,883,2706
927,S,-0.0903325189540054,-0.225452696353228,0.0,-0.0505955902841612,907,932,869,2708
928,LUMN,-1.1083970661646378,0.0,0.006111462520206,-0.5222522517266965,938,839,932,2709
929,KMPR,-0.1114252037046297,-6.859683794466403,0.0,-0.0430805598881051,913,940,859,2712
930,MU,-0.0763038034692394,-0.0965724755837213,0.0065930253640488,-0.0800189209362828,903,921,892,2716
931,TV,-0.2445320224799889,-0.0056072944940943,0.0209528434450184,-0.244777694147696,926,882,925,2733
932,WDC,-0.1414389632009975,-0.0676493814161621,0.0,-0.1007317352222813,921,914,903,2738
933,ZNH,-0.1976840607936676,-0.0467861333232809,0.0,-0.1542967694068533,924,908,916,2748
934,NIO,-0.1311476334238466,-0.3102574590020672,0.0,-0.0984609586734057,917,935,902,2754
935,CEA,-0.3084501896259656,-0.0666242810462348,0.0,-0.1291733027621429,930,912,912,2754
936,NCLH,-0.4419934650570354,-0.1149207615018555,0.0,-0.3064553112327276,935,926,927,2788
937,LPL,-1.417657726038562,-0.0803660420431329,0.1031794910547047,-1.2860135962163666,939,916,938,2793
938,W,-0.3817757304221619,-0.8713527851458885,0.0,-0.3246958128008169,932,939,928,2799
939,KEP,-1.7338647958278446,-0.1716105306665162,0.0039610640057081,-2.548362299336187,940,928,939,2807
