,ticker,eps,roce,divYield,fcfYield,eps_rank,roce_rank,fcfYield_rank,overall_rank
0,RE,0.1723635667383924,0.5878709677419355,0.0197221721178613,0.3285659091024261,38,7,23,68
1,CVI,0.2525327159581629,0.3712396694214876,0.1487611447711935,0.2252762589691805,10,33,35,78
2,CEO,0.3861131669992614,0.2370224608896081,0.2108444928445225,0.3019693801471993,4,108,27,139
3,PBR,0.2393083953982756,0.221162475855934,0.1891655737616171,0.2809489890521673,11,132,29,172
4,VLO,0.1925256047069078,0.2545248631530379,0.0316408803660928,0.1593593375463063,24,90,76,190
5,TS,0.1912514216379146,0.2347036180577252,0.0310698351451981,0.1876560717108046,25,111,58,194
6,BTU,0.2269880278457772,0.1970460155324998,0.0091440674724602,0.4217925240973072,16,175,16,207
7,WU,0.1416310100417743,0.2738509983498094,0.0789604193363885,0.1437351129066122,60,74,96,230
8,HRB,0.1131749028044859,0.3675644816252913,0.0363674274543763,0.1537361584252744,114,36,82,232
9,ERF,0.1406706333246212,0.3679517067590538,0.0149909549975805,0.1190803640228159,61,35,141,237
10,MO,0.1134141452130721,0.439506807089648,0.094567587995008,0.1268201714799555,113,20,121,254
11,MPC,0.1603278564723698,0.2016145817846629,0.0208835272194668,0.2024923769329269,46,167,51,264
12,MPLX,0.1603278564723698,0.2016145817846629,0.0208835272194668,0.2024923769329269,46,167,51,264
13,CRC,0.1481976641525616,0.2643406268480189,0.0212837070857402,0.1208704353017346,54,80,138,272
14,CIVI,0.1329957386448424,0.259521428072117,0.1119738490732515,0.1237262533772582,71,86,130,287
15,MLI,0.1147620431742703,0.3016465321929781,0.0127283902606533,0.1179860179580934,107,59,144,310
16,CIG,0.233270286670182,0.1587279952229761,0.0737771916377067,0.2177596337660354,14,260,39,313
17,HPQ,0.1249264913075971,0.2761265580057526,0.039702351053012,0.1134024723423544,85,73,157,315
18,APA,0.25834672573803,0.5329439252336449,0.027870680044593,0.0698576785533307,9,10,304,323
19,SHG,0.2170850746651896,0.1413014695351873,0.0726280427351298,0.6628703751951701,18,306,9,333
20,TOL,0.1763697532681411,0.178293778710022,0.0117079290118141,0.1534117644518214,36,214,84,334
21,PBF,0.3896797866029486,0.1836749789649848,0.020225846433818,0.1231937919150737,3,198,134,335
22,VIPS,0.1163424598901636,0.2183326539317113,0.0,0.1316388551348747,100,138,116,354
23,DHI,0.1296107125847148,0.2273876822374293,0.0093185778987092,0.1134916484703589,78,124,156,358
24,ALSN,0.1285946307442438,0.2031388152077807,0.0,0.1259195567020158,82,163,122,367
25,CNQ,0.1733595367011241,0.1527145359019264,0.0819314900162849,0.1567458266978219,37,271,78,386
26,TEX,0.1335550656817625,0.2549773665024236,0.0111381830838844,0.0856247824573616,70,89,228,387
27,BP,0.1487810200055302,0.1542251925690983,0.0469511073696827,0.173335404500176,53,270,66,389
28,OGN,0.2779478627300982,0.1443107221006564,0.0798794444209666,0.146173949314558,7,295,93,395
29,ACT,0.1431965763006848,0.1638075398142164,0.0458230076967909,0.1359942625921018,59,246,107,412
30,DVN,0.129444807180093,0.2171174844818993,0.0641869366801742,0.090822097164789,79,140,214,433
31,KBH,0.1401223808475298,0.1231240691652011,0.0134930622947793,0.2486381221520654,62,352,34,448
32,WSM,0.0729967632057023,0.3705816841932163,0.0178675526355504,0.1146578472309008,264,34,152,450
33,GGB,0.184162241231724,0.1433021189193826,0.065875280483451,0.1256225519654395,28,299,123,450
34,AMG,0.1266077147730826,0.1441330312770575,0.0002822285215628,0.1621685084899984,84,297,74,455
35,NUE,0.1040890198398974,0.2029524825839077,0.0118363967242541,0.1126689317513264,131,164,160,455
36,SM,0.177985253242366,0.1717501370042287,0.0155844817402293,0.1033797751788679,35,229,191,455
37,MTG,0.1303203846930812,0.149548955818174,0.0224768477181183,0.1299573625358154,77,278,118,473
38,TMHC,0.1329310366169098,0.1461211593145188,0.0,0.1335903939485449,72,290,113,475
39,DQ,0.2161257149716088,0.105803757778126,0.0,0.215953134403251,19,421,40,480
40,VALE,0.1152832692171296,0.1842959800882325,0.07961376214381,0.1063144548389944,105,196,183,484
41,BG,0.1493162984338173,0.1242861181792479,0.0254962738743433,0.1439907059796464,51,348,95,494
42,BMY,0.0755931661517068,0.236525508594318,0.0446871003394015,0.11916874080813,247,110,140,497
43,LEN,0.108672063028391,0.1470021382924115,0.011880084493227,0.1401665378586937,122,285,98,505
44,ESNT,0.1243069560450834,0.1397699791706493,0.0189596909419898,0.1354835613169453,88,310,109,507
45,CBT,0.1145122537118053,0.1890726096333572,0.0226451198351435,0.0903231484333565,109,185,216,510
46,EOG,0.108065878348331,0.2413845109720232,0.048184232826896,0.0733578618495715,123,102,289,514
47,CHK,0.236676326269949,0.2405450926351248,0.0476483550613746,0.0539101512090706,13,103,398,514
48,ARW,0.1311349375757246,0.1723020691277076,0.0,0.0903010357461919,75,226,217,518
49,AGCO,0.1289879565726598,0.2450406917599186,0.0503663064165397,0.0644168982371572,81,99,340,520
50,MRO,0.105965720021384,0.1436146425605315,0.0171154412647151,0.1400602245327689,125,298,100,523
51,CRI,0.0848472250065431,0.1617757269180517,0.0408744663950875,0.1712534489824657,206,251,68,525
52,DFS,0.1029786757082411,0.1176822517312281,0.0263401238546249,0.2893210412755345,133,367,28,528
53,NEU,0.0743427889093973,0.2483896031638699,0.0162567496917217,0.101044051962341,256,94,197,547
54,BHP,0.0855217122292672,0.26819690467217,0.0878184411313302,0.0768973959197916,203,78,268,549
55,AB,0.0753782743415154,0.3935760562973516,0.0844958316371243,0.0742837680111773,250,28,278,556
56,SIG,0.1800039670173382,0.1342098734805259,0.0161701490607875,0.0936002859095586,33,320,210,563
57,OC,0.0895509670418747,0.2032985526758667,0.014076573414609,0.089326340870365,190,162,221,573
58,BBWI,0.0886277834978701,0.3073790129372304,0.0183715906567338,0.066218480608887,195,55,328,578
59,MAIN,0.1209872535893505,0.1422505046020529,0.0766956405053927,0.1044504717763236,90,302,187,579
60,ICL,0.1001594716816052,0.1369539291413953,0.0733780364406196,0.1281496808099534,142,318,119,579
61,PII,0.0929155239332316,0.1756315422191207,0.027220478670177,0.1016748633016389,176,215,195,586
62,SU,0.149504545142688,0.1099288084923108,0.049546473128059,0.1174408217178728,50,407,146,603
63,TPR,0.0925091323117795,0.2010874226026105,0.0279998260512042,0.0781781235668991,179,170,260,609
64,BYD,0.0977344073788631,0.1704783956840468,0.010026705330225,0.0852095771594965,157,232,233,622
65,SKM,0.1818389639208223,0.0755861331989232,0.1286637399548064,0.3074868279127901,32,568,25,625
66,MSM,0.0603673162644108,0.2553087616073907,0.031080374828951,0.1067739222733389,358,88,180,626
67,INGR,0.089767108103052,0.1635434412265758,0.0270836998009208,0.1034485647035172,189,248,190,627
68,CPG,0.113919697686426,0.0967532581431653,0.0423278694367064,0.1948000862419825,111,464,54,629
69,HP,0.1005055254284397,0.1417828552683871,0.0466423430792714,0.1014598764439108,140,304,196,640
70,RDN,0.1328397602977525,0.108893956331451,0.0321369145152523,0.1130243310459007,73,411,159,643
71,GIL,0.0935752208774535,0.2307069378020433,0.0231135600771875,0.0593805784764105,172,116,364,652
72,EME,0.0620434267093594,0.2840511282067539,0.0032035490993101,0.0804955911564535,340,67,247,654
73,GEF,0.0978637404203692,0.1205814995519267,0.0317403278367845,0.1187605914511106,156,360,142,658
74,MAS,0.0602501575926478,0.3675027262813522,0.0170531833714873,0.0776351149596894,359,37,264,660
75,G,0.0997367134188203,0.1808763222232129,0.0158019622115783,0.0682604509776557,145,206,310,661
76,MKL,0.1053251707935347,0.1048705585345818,0.0018995952769792,0.1334037217809911,127,426,115,668
77,MTCH,0.0647285396381946,0.2306008020888716,0.0,0.0823964359410352,323,117,239,679
78,MTH,0.115808833500041,0.2224262739395764,0.0061974941706652,0.0497536474904067,103,130,447,680
79,PGR,0.0418879314927088,0.9288725792096668,0.0029797278040118,0.1115390689114865,516,2,164,682
80,EBAY,0.1196871782893427,0.1191228070175438,0.0228387532116996,0.0852127723997127,93,362,232,687
81,RNR,0.2751352830943507,0.0552126920315601,0.0118693109231564,0.3545661079162256,8,659,21,688
82,HIG,0.1014393613403737,0.0946333352445387,0.0222404989520228,0.1622462628467239,137,478,73,688
83,NVR,0.0702121926932845,0.2914729512268396,0.0,0.0649928548158094,292,64,334,690
84,PSX,0.1170510665741241,0.1328024142845167,0.0314027237765504,0.0769383418351085,98,326,267,691
85,AMAT,0.0622903515370889,0.3276961938605129,0.0088583857568059,0.068995468140702,337,47,308,692
86,TX,0.08272382849241,0.1156376749896969,0.0696612697270751,0.143265280294897,220,378,97,695
87,KT,0.2290342841695347,0.0558612306535879,0.1214720416700468,0.3067933057001538,15,654,26,695
88,DKS,0.0815311375917152,0.1908192904043095,0.0273610102189716,0.0732254741697872,227,182,290,699
89,CINF,0.1134627247553133,0.0962815685942721,0.0279501231898601,0.125221477022413,112,467,125,704
90,MUR,0.0998992237408088,0.1168174040083621,0.0258186639086702,0.1030976768765897,144,373,193,710
91,THC,0.0795483918795892,0.1030485733695652,0.0,0.2113044844853901,233,439,43,715
92,CF,0.0992363680140037,0.1633028874484384,0.0202377117720361,0.0670902920802871,149,249,319,717
93,HAL,0.0811721030128758,0.2140498034076015,0.0177237040695286,0.0639714943759548,229,147,341,717
94,RS,0.0818908640852786,0.1792522825168483,0.0145955645921886,0.0737134247043548,224,210,285,719
95,CAT,0.0684577165995198,0.2621142033821187,0.0169769838069249,0.0648675780028154,301,84,335,720
96,OMC,0.0755532114781519,0.1783855711694607,0.0326201120990992,0.077883633561649,248,212,263,723
97,FITB,0.0995461517416079,0.0926388403772266,0.0449207836722453,0.1480690737271937,147,488,91,726
98,TNET,0.055317811892887,0.38130081300813,0.0,0.0693316575724183,389,31,306,726
99,CPA,0.1150297472490403,0.205729490330008,0.0300166518243702,0.0480872347052798,106,159,464,729
100,ABEV,0.0677884797711993,0.1821751483982742,0.0557283857276813,0.0874465732957854,305,202,225,732
101,TROW,0.074117416623293,0.1726665028678906,0.0464792901136846,0.0797817822812592,257,224,251,732
102,CSCO,0.0591592001608597,0.2130757126858795,0.0295584935712152,0.0892899146485599,366,150,222,738
103,XOM,0.0888874714725768,0.1395365288214507,0.0368805251672249,0.082568339926623,193,311,238,742
104,AYI,0.0674507106076621,0.1682840993921296,0.0032750634052275,0.0996944896091283,308,236,199,743
105,BSMX,0.1662143730347077,0.0557874049963975,0.1122367639037054,0.2036119791749009,43,655,48,746
106,MUSA,0.0726556791723967,0.2294890673186453,0.0043582968469074,0.0585107876093798,266,118,368,752
107,AAL,0.091530338351984,0.097692457800761,0.0,0.1344003873367941,182,459,112,753
108,SON,0.0864869220540145,0.1151204311494886,0.0359481601658571,0.1092888457285333,199,383,171,753
109,PCAR,0.0899316804223551,0.1869490310491832,0.0296840223198984,0.0572237424874901,187,191,377,755
110,MMP,0.0984795158046129,0.11403282632981,0.0826680613180367,0.0917900542910615,152,392,212,756
111,DVA,0.0727077423696902,0.1068955656317179,0.0,0.1572845937915209,265,418,77,760
112,RRC,0.1207595855587781,0.1661948958124238,0.0107073142474425,0.0515207277889622,91,242,428,761
113,HCA,0.0710930863046068,0.2210258058591238,0.0089646184752661,0.0635660617149355,284,133,345,762
114,T,0.1195048714003099,0.0695861299738995,0.0675202523411751,0.1698048037306765,95,598,69,762
115,ENS,0.0711470035338636,0.148593311304382,0.0091162584425172,0.0979817995571156,283,280,203,766
116,PAA,0.1161489539511891,0.0642000715819613,0.093391313380265,0.2047243350944536,101,618,47,766
117,CMC,0.1304583237437719,0.0825540344205211,0.0113706440728381,0.1118974194484038,76,538,162,776
118,HOG,0.1347108320743169,0.0843110495426716,0.0183615302837552,0.104377797573888,67,531,188,786
119,RIO,0.0833102486581483,0.1632381120190295,0.0535909036407059,0.0668768092728067,218,250,322,790
120,WES,0.0912090284696272,0.1154765265902972,0.0873021452663012,0.0861280102443178,183,380,227,790
121,AMX,0.0775656934690642,0.1680638596365067,0.031049094622496,0.0685987093132953,244,238,309,791
122,APH,0.0652045140598079,0.1913905650642679,0.0169301762128318,0.0729120393472717,319,181,291,791
123,WRB,0.0720767206258035,0.1034547481779871,0.0261650331435441,0.1529012602060409,271,436,85,792
124,SNA,0.0661730423421081,0.197764753986643,0.0232728057134345,0.0693210230924349,313,173,307,793
125,MTDR,0.1248957164005355,0.1723468067071516,0.0113924159272254,0.0469451678437885,86,225,484,795
126,KSS,0.109159779614325,0.0629112924453803,0.0757575757575757,0.2035123966942149,121,625,49,795
127,MOH,0.0523321955677652,0.2339381320642474,0.0,0.0756922132043387,414,113,271,798
128,SWKS,0.0625379965417022,0.1525444412805597,0.0257838789160538,0.1031036994266586,336,273,192,801
129,EQT,0.1178372083888125,0.0995520180479759,0.0155061861043901,0.0787612988770688,97,451,254,802
130,COP,0.0784862869857126,0.1749322035870995,0.0399916893530376,0.0624409020401987,238,217,350,805
131,SNY,0.0953715658101025,0.0897917277794074,0.0786638803922586,0.1237181145369941,167,507,131,805
132,BBVA,0.161815070023158,0.035747844186738,0.0566625161023853,1.520363466245769,45,760,3,808
133,QCOM,0.0586297675295668,0.1880614314691393,0.0280664069672788,0.0798457660949534,372,187,250,809
134,CVE,0.0983420710762317,0.1147049575516193,0.0245556011010498,0.0739540033160272,154,385,283,822
135,SEAS,0.0687352551628028,0.2076457987354858,0.0,0.0587223942892859,298,157,367,822
136,LRCX,0.0536776948296611,0.3545219903779786,0.0108036134624345,0.0556582309650518,400,39,387,826
137,KR,0.0653213605678732,0.1445989491102273,0.02402763540297,0.0897112216301845,316,294,219,829
138,OLN,0.0677531412385044,0.1226839126919967,0.0148697680684244,0.1086965323259188,306,353,173,832
139,EPD,0.0966588738507343,0.1117871774040206,0.0751500029703558,0.0751849483332809,163,397,273,833
140,CB,0.0972310167657141,0.0710381281062263,0.015013296120005,0.1485820898648419,160,590,90,840
141,JNJ,0.0931734953619928,0.1801922886638741,0.0311965419853399,0.0483665673872968,173,208,459,840
142,LOW,0.0604807239024423,0.4150712537786095,0.0198131908098733,0.0483470037304535,357,22,461,840
143,DE,0.094592819133989,0.2454976754518191,0.0132779808089909,0.0383451709277168,171,98,572,841
144,PRI,0.0779412247514125,0.1159983855895872,0.0126677925941485,0.0890280270859317,241,377,224,842
145,LMT,0.0609981992132783,0.2395056167121822,0.0269379330629737,0.0549071940606229,350,104,392,846
146,TLK,0.0621779700036626,0.212837743764909,0.0422622850112912,0.0611623311601099,339,151,357,847
147,FLT,0.0474931852159662,0.1956084845510068,0.0,0.0941897305226687,462,176,209,847
148,PVH,0.0900404612199152,0.0976741971576165,0.0012754375157733,0.0983308050724421,186,460,201,847
149,UBS,0.2792164894916507,0.0178502453960993,0.0168331951833566,0.481795900435906,6,829,14,849
150,FIX,0.0439196725461511,0.2626185483982948,0.0041256771293561,0.0739780803408335,489,83,282,854
151,ABM,0.0967863690283619,0.1102050702405942,0.0221457071990879,0.0734467193541926,162,406,287,855
152,PM,0.0535092419699838,0.2969091236093625,0.0545434024125114,0.0539886540956588,402,61,397,860
153,AIT,0.0620364411343361,0.2147769302420167,0.0095622345131806,0.0568033872617166,341,144,379,864
154,FANG,0.1125948421319504,0.1699326962406574,0.051729860654959,0.0432037478877289,115,233,519,867
155,SEM,0.0841665175982792,0.0861449619525408,0.0220894289341307,0.1219709519723259,209,523,136,868
156,GILD,0.0560333640354625,0.1842462385681974,0.0376753898695634,0.0734022232139748,385,197,288,870
157,SYF,0.1391304088345198,0.0256484989798892,0.027850948685373,0.5342035760120775,63,798,12,873
158,UL,0.0587872738867165,0.1925783035684214,0.039538904881724,0.0662509794029247,368,179,326,873
159,KB,0.225392282388786,0.0146546320170494,0.0560520685717412,0.6330539796742667,17,846,11,874
160,SAN,0.1828571758569689,0.015723563529772,0.0373275618104556,1.1047868681087492,30,841,4,875
161,CVX,0.0764881306485566,0.1310218246183089,0.0405760423525685,0.0708004691014296,245,328,302,875
162,VC,0.1384737683385142,0.155902004454343,0.0,0.0404594137943807,64,264,548,876
163,FOXA,0.0734448105817433,0.1140694912445451,0.0177239696238428,0.0855374186194154,258,390,229,877
164,FOX,0.0734448105817433,0.1140694912445451,0.0177239696238428,0.0855374186194154,258,390,229,877
165,FMS,0.0884615192009559,0.0538136554972716,0.0582578448855919,0.344666055984494,196,662,22,880
166,RF,0.1143349827560354,0.0668632982816106,0.0487880712338916,0.111137572437882,110,609,166,885
167,AZO,0.0556769540254107,0.4648081046590444,0.0,0.0472146240829108,387,16,483,886
168,AGO,0.1691047653219443,0.0531512259338489,0.0153315551780382,0.1054902527921736,40,668,185,893
169,BBY,0.0753138496829019,0.2431283649759138,0.0486111149041132,0.0409644226720055,251,100,543,894
170,THO,0.0605988136207943,0.1076411509522851,0.015538493616588,0.1252287401590118,355,415,124,894
171,IHG,0.0486715268971836,0.3987800228745711,0.01589936545308,0.0526301444181546,455,26,416,897
172,BAM,0.1383061258860971,0.2012280200847394,0.0320948961552157,0.0311853230484761,65,169,665,899
173,CTRA,0.0842269161234678,0.1011566771819137,0.0461304340614685,0.0808060075301454,208,447,244,899
174,LKQ,0.073190162116209,0.1153813451237139,0.0236147745289478,0.0780382284102314,262,382,261,905
175,SAIC,0.0696306553558454,0.1782964388835418,0.0115321211176347,0.053865223954522,294,213,399,906
176,NTAP,0.0467816502061049,0.2195121951219512,0.0197374913648475,0.0725922158370594,474,136,296,906
177,SMFG,0.4180255064016069,-2.363261552749548e-05,0.151074989130048,1.9395660962590413,2,904,1,907
178,CSL,0.0492230500112987,0.1818466238474704,0.0102820627010831,0.0784592582405793,448,203,257,908
179,BERY,0.0819055783347506,0.0777153558052434,0.017080473642879,0.1245395164827243,223,560,127,910
180,AFG,0.0846078886131188,0.0574898785425101,0.0679246429710953,0.1884809537414313,207,648,57,912
181,WNS,0.0581030233091657,0.1665285170722938,0.0,0.072533010389244,374,241,297,912
182,DAL,0.1792898968645468,0.1169059416423156,0.0049791943585727,0.0443848497119652,34,372,506,912
183,LYB,0.0684120255007928,0.1022780569514237,0.0521018737257693,0.1103847771916766,302,443,168,913
184,SKX,0.0566558424744297,0.1333199920359929,0.0,0.0941956489599312,383,323,208,914
185,BC,0.0618977156444856,0.1640987852804573,0.016490352407665,0.0654166390600499,342,245,332,919
186,KLAC,0.0500691001583691,0.3867263855079352,0.010828290610899,0.0491960592872936,443,29,451,923
187,VZ,0.0731568892133587,0.0881595684825949,0.0694467628359979,0.1178421804204851,263,516,145,924
188,SNX,0.0686551594184035,0.085058196068629,0.0142777009081272,0.1376984343507777,299,526,102,927
189,ORAN,0.0887341066562594,0.0568015191942501,0.0677143059811291,0.1536481969765147,194,652,83,929
190,FBHS,0.0511725406502265,0.1146217798158297,0.0147761501803373,0.133567289044522,430,386,114,930
191,AFL,0.094725402312294,0.1047113501414493,0.0196404246906366,0.0648581312247731,170,428,336,934
192,GPK,0.0951675172071558,0.1553692056836711,0.0161903245041219,0.0447537425317192,168,265,502,935
193,CMCSA,0.0851343045106022,0.1037963074265514,0.0263679552441857,0.0717068963323313,204,432,300,936
194,CCZ,0.0851343045106022,0.1037963074265514,0.0263679552441857,0.0717068963323313,204,432,300,936
195,KMB,0.0429760914063458,0.2250816208949491,0.0386882274111548,0.0676313093786938,498,127,315,940
196,AON,0.043294304857084,0.3365290867728306,0.0082569871587808,0.0537464010764814,497,42,401,940
197,GPS,0.0684884783824713,0.0782586814292903,0.0302877334679454,0.1517115298034026,300,557,86,943
198,HSBC,0.1490112964657785,0.0118054599346315,0.0772252484467188,0.2242546243841419,52,856,36,944
199,GIB,0.0521210420293304,0.2098209562745994,0.0,0.057681613754068,417,154,374,945
200,BDC,0.0744018591959855,0.126709881163331,0.0026045048770487,0.0621878407963446,255,341,352,948
201,RL,0.0527938681674295,0.1587997040152665,0.015896157736936,0.0739179503399457,407,259,284,950
202,OKE,0.0781885290988065,0.0938567330024136,0.0540762335512241,0.0845694658473739,239,483,235,957
203,AM,0.0618961821293585,0.1074501649405167,0.0,0.0990682535722825,343,416,200,959
204,STM,0.0929721070325961,0.2198523379819524,0.0049234813270645,0.0321461381713274,175,134,650,959
205,CVS,0.082236388221983,0.0805856724854725,0.0308682128369188,0.1024505339846014,221,546,194,961
206,DCI,0.0468854497514208,0.2384191450275557,0.0149489839787139,0.0557189402842972,473,105,386,964
207,PYPL,0.0626852525635478,0.1491988130563798,0.0,0.0623014050443174,334,279,351,964
208,ABG,0.1281404240395263,0.1469994645578483,0.0,0.036304681134518,83,286,595,964
209,DB,0.1689117644014381,0.005020788948369,0.024107668761085,0.2048756637007617,41,882,46,969
210,ACI,0.1050089002138127,0.1104981956226273,0.0224613632117576,0.0509394525979283,128,405,436,969
211,SIVB,0.1231651542960531,0.018441473093547,0.0120071292764692,0.1951342665850745,89,827,53,969
212,HD,0.0426150074730339,0.3978538017059524,0.0235912043615164,0.0505031317513746,504,27,441,972
213,ITUB,0.1001716470500418,0.0242858930913029,0.0313117717466797,0.3259867709301361,141,808,24,973
214,SLB,0.0566770500424774,0.1686823679185232,0.0177596181075286,0.0612888870909017,382,235,356,973
215,CTSH,0.0557381304130677,0.1943234323432343,0.0154944661684492,0.0527755675077636,386,178,411,975
216,TGT,0.0616290732546726,0.1611283701320315,0.0299507168475463,0.056818490687911,346,253,378,977
217,PAGP,0.0636604774535809,0.0585367921329264,0.0671971706454465,0.6954424885459368,327,642,8,977
218,ULTA,0.0518168117579405,0.414448901161326,0.0,0.0417823704967869,424,23,532,979
219,TKR,0.0688875320826672,0.1295952982013253,0.0164309262008899,0.0624724789808304,297,334,349,980
220,BWA,0.0748872497567662,0.1085532472393786,0.0155765479494073,0.0676980737801166,253,413,314,980
221,KOF,0.0579236085926091,0.1654407055680591,0.0363949782695678,0.0604467960881205,375,244,361,980
222,RHI,0.0443131325420359,0.2120711074868304,0.0221928879807431,0.0636984709185327,486,152,343,981
223,MOS,0.0984088582671677,0.0698414852472193,0.0297025964174917,0.0848838705355396,153,597,234,984
224,IBP,0.0473341694488339,0.2270475258425592,0.0122559954543349,0.0541128420535295,465,125,396,986
225,AOS,0.0450247167935914,0.3338622939257692,0.0148437576924614,0.0483493949470528,484,43,460,987
226,AXP,0.060815614812168,0.0894251543866215,0.0129271309249652,0.1234323130341065,352,509,132,993
227,PNC,0.0898303160407022,0.0407282286359834,0.0463484491870098,0.1628315391695124,188,736,72,996
228,EXPD,0.0396865483631862,0.3333808612267091,0.010649508196182,0.053444265038289,549,44,404,997
229,NVS,0.0707964743054875,0.1328121813608864,0.0345877724637247,0.0558028775586351,288,325,384,997
230,MTB,0.1201941740784931,0.0178321540493131,0.0424472676059764,0.160010412700628,92,830,75,997
231,FHN,0.1155111278552882,0.0226062313718464,0.047260405711138,0.1559464613520112,104,815,79,998
232,KEYS,0.0486538488094306,0.2047030449201085,0.0,0.0557885191646451,457,160,385,1002
233,CNC,0.067014382538238,0.0611371935315597,0.0,0.1799120395752697,311,634,60,1005
234,SUN,0.06171884844643,0.1108270951250684,0.0736260217801464,0.0781904382247377,345,402,259,1006
235,BNS,0.1102582450116722,0.0075642917700254,0.0806774904795259,0.4654653738805845,120,873,15,1008
236,JBL,0.0537526301332776,0.2284143260514192,0.002957051779948,0.0462614322907425,399,121,489,1009
237,ADM,0.0891453563280405,0.080152353415441,0.02500574594674,0.0759130424544841,192,548,270,1010
238,GPC,0.0677195384075561,0.1722703448112651,0.0270911279788755,0.0474740545921664,307,227,476,1010
239,UNM,0.1443615182940733,0.0225586558061614,0.0311595082717617,0.1200951094703772,57,816,139,1012
240,BABA,0.0597871444485538,0.0922124405019794,0.0134102425261376,0.1118372081484379,363,489,163,1015
241,SEE,0.0647768611590658,0.1544205495818399,0.0223571192349352,0.0515787653257199,321,268,427,1016
242,WMB,0.0749491634371003,0.0887236361305211,0.0513728301759804,0.0794758194232354,252,512,253,1017
243,CE,0.1158949770238021,0.053762486126526,0.0180346775470712,0.0787021502136125,102,663,255,1020
244,CM,0.1114884216854753,0.0078275630578805,0.0504655298159879,0.2486448483636026,116,872,33,1021
245,WFC,0.1054434152305835,0.0116243959730461,0.0326653146127552,0.222311427848495,126,858,37,1021
246,MFC,0.1018070498119174,0.0063041440947221,0.0553854204724544,0.636913699692825,136,877,10,1023
247,OXY,0.0706292740598904,0.0724020968239284,0.0257090557578001,0.1141934103000308,289,586,153,1028
248,HPE,0.1013583520783717,0.0592271271015848,0.0309831209563022,0.0800856115187135,139,640,249,1028
249,SNV,0.0988333563054697,0.0232779401835527,0.0458099391322458,0.1645346660898865,151,812,71,1034
250,AMCR,0.0715327111989646,0.140370473796891,0.0493493799588277,0.0501684568046174,280,309,446,1035
251,LEA,0.0689142007937427,0.0972829879379285,0.0218960578591821,0.0749690205316034,296,463,276,1035
252,MCK,0.0420092410049362,0.2603075699323876,0.0043940378666055,0.0507553354846448,514,85,438,1037
253,CPB,0.0626269143909058,0.1333875559170394,0.032627308546311,0.0564226163451867,335,322,380,1037
254,EXP,0.0508513113359594,0.2280341683423717,0.0037579627868258,0.047230899909567,433,123,482,1038
255,GL,0.0838637241636061,0.0488585725974277,0.0072667985452002,0.1237861068650222,214,696,129,1039
256,BKNG,0.033456443581077,0.5303305484925536,0.0,0.054595861185348,633,12,394,1039
257,HSY,0.0487744569509194,0.2938091911835386,0.023291576971915,0.0406608854390109,453,62,546,1061
258,NFG,0.1001254569691397,0.1010372295873613,0.0369741027257922,0.0477056546316729,143,448,471,1062
259,WCC,0.0861538447686665,0.1204883272649389,0.0150811433037247,0.0451196294810691,200,361,501,1062
260,ASGN,0.047211944169777,0.1155689573083637,0.0,0.0897737378878112,468,379,218,1065
261,F,0.0891955411668098,0.0317733832424219,0.1024917709059616,0.1371071097484755,191,772,103,1066
262,PKG,0.0527168574965927,0.1466050395892695,0.0309260289208317,0.0580629475929539,408,288,371,1067
263,CRH,0.0634775756375861,0.1117577958137548,0.0187756202326403,0.0639170050472862,329,398,342,1069
264,TAP,0.0717702263609795,0.0645439246045102,0.0268277998632515,0.1064565218706698,276,616,181,1073
265,AVGO,0.0403358456112712,0.2476014421901735,0.0218979931613526,0.0505071698383429,539,95,440,1074
266,WHR,0.0718194509768789,0.1097066769587032,0.0573361105511881,0.0546484803691012,274,409,393,1076
267,BAC,0.0980863771387648,0.0127575295171476,0.0336153463722404,0.1664009585689579,155,852,70,1077
268,COF,0.0974665323023274,-8.903668979394685e-06,0.0231151444523015,0.3911824359684571,159,901,18,1078
269,INFY,0.043550377232649,0.3283995926357424,0.0244240934141052,0.041133217579486,495,46,540,1081
270,GWW,0.0442304198351934,0.4061114629512349,0.0094796744534695,0.038353988987762,487,24,571,1082
271,ALLE,0.0485270766091139,0.2191967324710687,0.014251012320256,0.0463719140654079,458,137,488,1083
272,CHTR,0.0785767710195841,0.0937385709700774,0.0,0.0601783916739847,237,484,362,1083
273,HBAN,0.106039344038161,0.0125246360226333,0.0561992218018752,0.1368021675776788,124,854,106,1084
274,PAYX,0.0411801409173686,0.4288335794136258,0.0310708698246375,0.0411563419532476,526,21,539,1086
275,SQM,0.1170079803379941,0.309165907044967,0.0855197776664004,-0.0752214880571243,99,53,936,1088
276,ALV,0.0521025181104295,0.208517570397952,0.0240226774074726,0.043667889154028,418,156,515,1089
277,CMA,0.1195886476302172,-7.350238882763689e-05,0.0534823236847963,0.1490446482383411,94,907,89,1090
278,WIT,0.0441378096130443,0.151220943087841,0.0020851690377799,0.0662179035213407,488,275,329,1092
279,VIV,0.0571190141761489,0.0786639482528806,0.0435271598915252,0.1132817875931115,380,556,158,1094
280,BKH,0.0725381433887098,0.0568918710656408,0.0465051941405115,0.1075622812720457,267,651,177,1095
281,POOL,0.0339061772065261,0.2811562253744588,0.0108517730117827,0.0536645030160257,626,69,402,1097
282,CFG,0.1021311481477181,3.702716981472869e-05,0.0589413591300263,0.1771416493681503,135,899,64,1098
283,UNH,0.0458097458479148,0.1804071119139612,0.0138385099717506,0.0525662791147021,476,207,418,1101
284,BBD,0.078846531808997,0.0105076438805321,0.0,0.9656017608957462,235,862,5,1102
285,BBDO,0.078846531808997,0.0105076438805321,0.0,0.9656017608957462,235,862,5,1102
286,TGS,0.0349484365829303,0.2097002892120087,0.0,0.0647888522685565,611,155,337,1103
287,WTM,0.1338727584172928,-0.0109022899370495,0.0006835608245973,0.1369750731918349,68,931,104,1103
288,GFI,0.054445980023,0.2071869652863904,0.0,0.0403254812938728,395,158,551,1104
289,ALLY,0.0961630480002605,0.0057013865814359,0.0450646440628672,0.179504356267153,166,879,62,1107
290,WF,0.087185741649674,0.0084640378881941,0.0340344624785905,0.213564394443917,198,868,42,1108
291,CNA,0.1049770170027049,-0.0022869826962853,0.0685617530133848,0.1912236948721471,129,923,56,1108
292,AN,0.152447854801443,0.2228636390480127,0.0,-0.0746040476390961,48,128,932,1108
293,IBM,0.0503393822935649,0.1038666930379746,0.0405291747604815,0.0813334647800987,437,430,242,1109
294,ZION,0.1049106716795289,0.0156939676311917,0.0435070726670987,0.121881515627688,130,842,137,1109
295,PBH,0.0586945748301028,0.1056926930371884,0.0,0.0671163641009592,370,422,318,1110
296,YUM,0.0434966632584747,0.4648768671780379,0.0184663354347187,0.0358976845176391,496,15,599,1110
297,EXPE,0.036219796747198,0.1479866112181762,0.0,0.0838008848203678,594,281,237,1112
298,IPG,0.087612498787591,0.1659169240410008,0.0382148107876319,0.0299433103103256,197,243,675,1115
299,RY,0.0963914191912877,0.0098587652696299,0.0359967686312979,0.1514666698093665,165,864,87,1116
300,HII,0.0657359003733335,0.0954417695221801,0.0193056976133138,0.0654463149091338,315,472,330,1117
301,PBA,0.0708610630042341,0.0716739803381297,0.0630009113083815,0.0803570838347564,285,588,248,1121
302,DOV,0.0491318909403122,0.1544121228518116,0.0132169560218483,0.0531730306716466,449,269,407,1125
303,TEL,0.0490851782036109,0.1335729607513479,0.0186318084804282,0.0616777108317624,450,321,355,1126
304,OTIS,0.0381982613651102,0.6008796041781198,0.0146435724578907,0.0404532085153976,573,5,549,1127
305,MFG,0.4576531041418059,-2.031749487722866e-05,0.1582498519263645,0.0892715840726925,1,903,223,1127
306,ENB,0.0631440221663168,0.0703937294368422,0.0778004524446236,0.0951087072687618,331,593,207,1131
307,RZA,0.0840946133391211,-7.252382925818484e-05,0.0204176500235781,0.3842060993021265,211,905,19,1135
308,RGA,0.0840946133391211,-7.252382925818484e-05,0.0204176500235781,0.3842060993021265,211,905,19,1135
309,ORI,0.072013448561228,0.0517117755297735,0.0331435099876684,0.1059148682146762,273,679,184,1136
310,VOYA,0.0834112728266625,0.0046815998355981,0.0217536599531936,0.2186042638241172,216,884,38,1138
311,ATHM,0.0833574144675622,0.0441540458642302,0.0201278840165362,0.097260777305861,217,719,204,1140
312,WYNN,0.0712052378480647,0.0800396311592741,0.0082650452176046,0.0682271762246277,282,549,311,1142
313,ADP,0.0375245568915668,0.5450301094668064,0.0209354473912036,0.039988068246699,580,9,553,1142
314,GPI,0.1442911087871243,0.1867549920279401,0.0060441089452053,-0.0292371777944655,58,192,894,1144
315,CL,0.0348738190928822,0.3545314109165808,0.0265192650406308,0.046094091322766,613,38,494,1145
316,ARMK,0.1032667891004436,0.0728744221272136,0.0175577500429578,0.0512058404960059,132,584,432,1148
317,EMN,0.0839227640215788,0.0909015509662436,0.0352963750247356,0.0507854757669733,213,498,437,1148
318,VRSN,0.0383917103957764,1.7851917930419268,0.0,0.0379409271034581,568,1,580,1149
319,KMI,0.0606733293138204,0.0668192291415226,0.064175177680741,0.1052077052844414,353,610,186,1149
320,GRMN,0.0524196028269275,0.1497569822191007,0.0227121831679632,0.0480135281462919,411,277,465,1153
321,AXS,0.0798190609568707,0.000412924138704,0.0390353839374425,0.2597229160372977,231,893,31,1155
322,GOOGL,0.0418271495524503,0.2629406883816107,0.0,0.0393899011877164,517,81,557,1155
323,ORLY,0.0408412943115793,0.4592844034133589,0.0,0.035293387882586,532,17,606,1155
324,CNHI,0.1461436806264392,0.1727483799424749,0.0331612400577917,-0.0177517418896729,56,222,882,1160
325,GOOG,0.041459125246447,0.2629406883816107,0.0,0.0390433214852204,524,81,561,1166
326,MCHP,0.0392051000964656,0.1916083811349578,0.0187400748533894,0.0512797528242721,556,180,431,1167
327,ENLC,0.0367278250857813,0.0944512610770279,0.0420713495890473,0.1383972846345884,587,480,101,1168
328,TJX,0.0400370624715986,0.3004767827529022,0.0132800627420322,0.0387931751932007,546,60,564,1170
329,V,0.0366873609597598,0.3115680776249611,0.0079670173658345,0.0418337440782394,588,52,531,1171
330,DGX,0.0553017116333043,0.1106742033259605,0.0203334162211446,0.0559492726594554,390,403,382,1175
331,ITW,0.0373061625036757,0.3725906114543945,0.020375195280161,0.0389084224421156,582,32,563,1177
332,MGM,0.0720250506175594,0.0403411812912945,0.0,0.1109190067541586,272,739,167,1178
333,L,0.0905855854000596,-0.0277387951197926,0.0036006822648559,0.2034701328965078,184,944,50,1178
334,MAR,0.0453440600053551,0.21572130415364,0.0086334619601503,0.03997572335211,482,143,554,1179
335,K,0.0497353202358426,0.1425054445601742,0.0418383345832535,0.0506243848457368,446,301,439,1186
336,SLF,0.0830891861631323,0.011582799968333,0.0467765026500194,0.1352094444293868,219,859,110,1188
337,CI,0.0586778444915174,0.0520512045156738,0.0164761569544346,0.1163557566989037,371,676,148,1195
338,EPR,0.0474573593791265,0.0683914079339505,0.0746623949942229,0.1239467883884885,464,603,128,1195
339,DRI,0.0499439675377944,0.1447236907070001,0.0299999511699675,0.0484129425628605,444,293,458,1195
340,NXPI,0.0471312234877112,0.1816026084379013,0.0169517378722336,0.0422445396080414,470,204,525,1199
341,CSX,0.0533631266684056,0.1391083379459568,0.0126692537608435,0.0469423143882502,404,313,485,1202
342,APTV,0.1182519207364056,0.0794637851062745,0.0012879719072719,0.0398466308812258,96,551,555,1202
343,PSA,0.0401414190410277,0.1674934226427251,0.0430748654308678,0.0520471810364028,543,240,423,1206
344,HUM,0.0438922160903148,0.1432191291934332,0.0076004600783148,0.0524978414226063,490,300,419,1209
345,KEY,0.0724240148506528,4.265544354552047e-05,0.0682298630082158,0.2067866649458661,268,898,44,1210
346,TXT,0.05734244128544,0.1033819522359352,0.000996177047304,0.0537935605544192,378,437,400,1215
347,WMS,0.0382413091063205,0.2523172492825511,0.0032994251868106,0.0400562741920349,571,92,552,1215
348,BOH,0.0601592135920154,0.1081085005208789,0.0420519235113121,0.0503072032680744,360,414,442,1216
349,ACN,0.0336557245033651,0.2650685469580564,0.0138480978221482,0.0440613573578484,629,79,508,1216
350,EVR,0.0392008744339505,0.1305565905618228,0.019619540583072,0.0654234282960639,557,330,331,1218
351,CDW,0.0360914528589346,0.2143294315660622,0.0105074726923367,0.0474061870613824,595,145,478,1218
352,CZR,0.0779823795539328,0.0805841700352066,0.0,0.0510953250257957,240,547,433,1220
353,CHRW,0.0317458538538034,0.1741563243412902,0.0284690287925703,0.0632551240626912,654,221,346,1221
354,BAP,0.1107496911659838,0.0299128410805807,0.0453883807190044,0.0666597036126896,117,781,323,1221
355,AMP,0.0636643924081856,0.0408423338476484,0.0136993019657676,0.1121101057234911,326,735,161,1222
356,SCCO,0.0368276706461871,0.2733490689061603,0.0469593801361822,0.0389429990813734,586,75,562,1223
357,SBUX,0.0394659220159887,0.2920766957542711,0.0232690578636153,0.0351657679721082,551,63,609,1223
358,WEX,0.0320173321131679,0.1206623282179417,0.0,0.0917405851509714,651,359,213,1223
359,TDC,0.0142781541018142,0.2132269099201824,0.0,0.0817539468732915,834,148,241,1223
360,NSP,0.0386715226532847,0.304964717144105,0.019003611618122,0.0357356531848348,566,57,601,1224
361,HE,0.1291603285933596,0.0202907085779177,0.0841223362440194,0.0662568956217925,80,820,325,1225
362,EA,0.0353593431439539,0.1603097773475314,0.0056941597364576,0.0587748390358259,604,255,366,1225
363,UHS,0.0679260983581827,0.0952226600864697,0.005250161866427,0.0496571816530758,304,473,448,1225
364,PNR,0.0519296921837682,0.1407093360884977,0.012108866717654,0.045299837472656,420,307,500,1227
365,PHM,0.114621413720809,-9.034012183065883e-05,0.0062746033146885,0.0926953398982464,108,908,211,1227
366,OGS,0.0652675599633287,0.0580487240933797,0.0406719821882606,0.0770282079421208,318,644,265,1227
367,FFIV,0.0409114139192362,0.1251652738460495,0.0,0.0620718221278607,531,345,353,1229
368,ITT,0.0418022907451663,0.1824651098521486,0.0097555650508816,0.0437982101083947,518,201,513,1232
369,IGT,0.0284567676030645,0.1141130870953032,0.0291864283108354,0.1169281284202845,697,389,147,1233
370,TKC,0.0412185304229269,0.1264287138666885,0.0081589306314765,0.0592409659383347,525,343,365,1233
371,FNB,0.0976358540513472,0.0358305139358788,0.0366386091491653,0.067439198159178,158,759,316,1233
372,CHH,0.0453231993988114,0.2582643589427515,0.009898423905189,0.0312542774254868,483,87,664,1234
373,BSAC,0.0715607354885383,0.0095920815958378,0.0599223453729622,0.1474948212082267,279,865,92,1236
374,SJM,0.0622287685102357,0.0898889332994198,0.0365928578269195,0.0541156091748958,338,505,395,1238
375,DPZ,0.035895903190538,0.726814533115634,0.0117393719278931,0.0335690774161253,600,3,635,1238
376,WBS,0.0995309370627157,-0.0009756455258808,0.033810630877551,0.1076511999416466,148,917,176,1241
377,CCK,0.0409222347588751,0.1236961137265762,0.0104579044383792,0.0600192776463502,530,349,363,1242
378,DECK,0.0315525314070674,0.3839705976106833,0.0,0.0392065946341342,655,30,559,1244
379,MGA,0.0717382345746827,0.11715074780292,0.0308716887452468,0.0361956728064659,278,369,597,1244
380,BEN,0.0732966905232394,0.038370231133389,0.0504226100529715,0.0821889374138589,260,749,240,1249
381,BXMT,0.0671311843803586,0.0223821513544374,0.1162422792235135,0.1249317181653916,310,817,126,1253
382,PG,0.0407763260370508,0.2131581112691453,0.0250423911831993,0.0383636409436144,534,149,570,1253
383,BKR,0.0563949492416432,0.0967270601987142,0.0228133968625484,0.053347358057715,384,465,405,1254
384,POST,0.0585685405489464,0.0552419429225007,0.0,0.0869489153254023,373,658,226,1257
385,PSO,0.0549764555944182,0.089798985534473,0.0223978152421704,0.0609395103017493,392,506,359,1257
386,UPS,0.0496666051387166,0.1718846956619845,0.0397747469894433,0.03761275404065,447,228,582,1257
387,ABBV,0.0177490198803621,0.1798802518839682,0.0384653342626233,0.0805220803209028,811,209,246,1266
388,LII,0.0371436700287531,0.4514659377177467,0.009655717645163,0.0303959977239194,583,18,671,1272
389,A,0.0408018484553538,0.1473799126637554,0.008719749871507,0.0485015521154771,533,284,456,1273
390,BCE,0.047583570990338,0.0919058044891615,0.0771261769299867,0.0669071687544214,461,492,321,1274
391,MMC,0.0401289854140326,0.1870727820081459,0.0138677910190134,0.0410478066988054,544,190,541,1275
392,ROST,0.0389230256689542,0.228158155675032,0.009443877364125,0.0363723021134703,562,122,594,1278
393,TRV,0.0683570380198371,-0.0003676470588235,0.0207516517960588,0.1762290605720375,303,912,65,1280
394,KHC,0.0629208590030603,0.0653204053364438,0.0433063005047332,0.0653010526185876,332,615,333,1280
395,BK,0.0805179189927227,-6.520945276227242e-06,0.036436441126652,0.1149695909658718,230,900,151,1281
396,GD,0.0467381673994255,0.1106102454531241,0.020133364418214,0.0536607737925229,475,404,403,1282
397,ETSY,0.0309770536219063,0.1417189847763036,0.0,0.0670371487801363,662,305,320,1287
398,AIZ,0.0713361289248512,0.0205824595798935,0.0169097158525367,0.1038787271939157,281,819,189,1289
399,TPX,0.0419389967043536,0.1602435746221576,0.0088526488560942,0.0432492343085374,515,256,518,1289
400,RDY,0.0543071085633931,0.2323632234226136,0.0064836157195861,0.0175529656620205,396,114,781,1291
401,PRU,0.0659971720423989,-0.0001608881023248,0.0489673551407831,0.1726855265257303,314,910,67,1291
402,MT,0.0386764327114241,0.0676803237788989,0.0155294925685696,0.1276027682056997,565,606,120,1291
403,VSH,0.0968782887650273,0.1370173120544028,0.01664181239838,0.010857895541193,161,317,816,1294
404,MCD,0.0392383568430264,0.2383064368870187,0.0210017504130538,0.033612159894877,555,106,634,1295
405,HI,0.1929069042183528,0.0268048018418023,0.0207568777050816,0.046626787275526,23,792,487,1302
406,BAX,0.1357737159262159,0.0179120929591696,0.0299560984686606,0.0528576891068175,66,828,410,1304
407,AVT,0.1659990283121323,0.1442430225111728,0.0228972568267985,-0.1956204228973128,44,296,967,1307
408,ALE,0.0705099889626613,0.0258894581675587,0.0443719274937023,0.0896284400371183,291,797,220,1308
409,FN,0.0522739978731354,0.1680532901400288,0.0,0.0318475124933364,415,239,654,1308
410,FAST,0.0312151384794597,0.4021201599326599,0.0274801322994932,0.0340501757318367,658,25,625,1308
411,TPL,0.0335835762376261,0.444559993048791,0.0082767377476068,0.0313189232913208,631,19,660,1310
412,NNN,0.0502373853852311,0.0653402222375504,0.0517890411840236,0.0784163663755146,439,614,258,1311
413,MSI,0.0326855949858882,0.3134210526315789,0.0112649593017484,0.0342538915270484,644,50,622,1316
414,AWI,0.0509226140093162,0.1586710873536775,0.0106714503889049,0.0340621774673576,431,261,624,1316
415,TT,0.0362995318492117,0.2169675523301145,0.012262458582591,0.037465335283274,592,141,584,1317
416,WTS,0.0376658605607255,0.1872242067661273,0.0066824208930703,0.0403963121084316,578,189,550,1317
417,PB,0.0666400470524032,0.0243029534430793,0.0326933798838707,0.0982756181400897,312,807,202,1321
418,RHP,0.0489645553428944,0.0942103937435613,0.0276906811160854,0.0551104356301521,451,482,391,1324
419,BCO,0.0215834951480204,0.1060609313609721,0.0097457971249898,0.1229791622059956,773,419,135,1327
420,CNS,0.0345596471245491,0.2340443825631609,0.0301133219208754,0.03594847098206,617,112,598,1327
421,BRO,0.0437825376429232,0.1219612607818132,0.0067899397837962,0.0473082767454722,491,356,480,1327
422,QSR,0.0488173885076483,0.1038172781918564,0.0406127853971192,0.0502557208646338,452,431,444,1327
423,CBOE,0.0403035246051588,0.1681663193786702,0.0118306248348476,0.0395942164495125,541,237,556,1334
424,MTD,0.0297641988652917,0.5297357106756442,0.0,0.0324725221769948,678,13,647,1338
425,HST,0.053553882696299,0.0767019105917269,0.0395864511282102,0.0575342388426455,401,563,375,1339
426,GGG,0.0346592330856857,0.2776521645327696,0.010833631964212,0.0319037299334788,616,72,652,1340
427,NE,0.0723100936849227,0.1264627477286679,0.0148256834303345,0.0247218766370613,270,342,729,1341
428,CW,0.0415647916915748,0.1270445742149865,0.0035465767692172,0.0472997666027948,523,338,481,1342
429,GSK,0.0417356874917799,0.1843319187073305,0.0190300506887235,0.0339102460870711,519,195,630,1344
430,WSO,0.0343829082747745,0.2514659972415879,0.0245302530306679,0.0336966437935221,622,93,633,1348
431,CLF,0.0383130725355764,0.0482571815524984,0.0,0.1556528585969157,570,699,80,1349
432,TSCO,0.047198521332332,0.2109395871014819,0.0191662760461217,0.0247304725060217,469,153,728,1350
433,NTRS,0.0633191729592322,0.0118013017847777,0.0379297457092556,0.1114961830000099,330,857,165,1352
434,FTNT,0.0251868175909579,0.3493036526455549,0.0,0.0379930789135603,736,40,578,1354
435,PEP,0.038827583279475,0.2046101557053218,0.0285922318132524,0.0339067412284064,563,161,631,1355
436,KO,0.0420561938108308,0.1525791830788323,0.0312143786805793,0.0382603809104133,510,272,573,1355
437,FRO,0.1470596158879829,0.1292340554271032,0.1431421423980554,-0.1736812297425583,55,335,965,1355
438,SF,0.0708464969088684,0.0248530600911422,0.0271523372618432,0.0770150729875745,286,804,266,1356
439,URI,0.0617389801536533,0.1743349125364431,0.0103407697782109,0.0161479015748416,344,220,793,1357
440,E,0.0469341381770112,0.0883723460192555,0.0299646583288987,0.0580798892888438,472,515,370,1357
441,GIS,0.0518051991896827,0.1110971734403746,0.025721853593582,0.0417233669868407,425,400,533,1358
442,FDX,0.0717395874648617,0.066778144840056,0.0212581808776793,0.0476999623601963,277,611,472,1360
443,CNI,0.0514208891708034,0.1385022359387793,0.0189320287062638,0.0345365545399636,427,316,620,1363
444,PAG,0.0965450708604766,0.1171975352309324,0.0173344786362667,0.0053717633425977,164,368,838,1370
445,AEL,0.0474726366486666,-1.700427331221906e-05,0.0098483228310953,0.8770982833241566,463,902,7,1372
446,TSM,0.0514770192533033,0.1994629370617912,0.0176309365098624,0.0176568413434341,426,172,779,1377
447,REGN,0.0421881392319144,0.136464487065361,0.0,0.0391362857767526,506,319,560,1385
448,LW,0.0637917489302441,0.1709628653383983,0.0092377584683404,0.0068097644561277,325,230,832,1387
449,LVS,0.0325190433488702,0.1332680341092417,0.0081231025564335,0.0524672525776202,647,324,420,1391
450,CIB,0.0533722862657066,4.4055672288317495e-05,0.0287777356560028,0.1460704121892122,403,897,94,1394
451,MKC,0.0391141064418489,0.098633672695987,0.0240512100292591,0.0559413329569434,559,454,383,1396
452,OHI,0.0328445778599569,0.0903981174248315,0.0873215782185023,0.0786226067382258,640,503,256,1399
453,ROK,0.038942191139975,0.1613850057211084,0.016527577835933,0.0369950815829763,561,252,588,1401
454,CLX,0.0075805389424963,0.3038728897715988,0.0296607664662777,0.0473147732652458,866,58,479,1403
455,HON,0.0406939900414081,0.1831526543525799,0.0205339946214599,0.03093404934042,535,200,668,1403
456,ASB,0.0570344519063864,0.0051160428499903,0.0439657452620592,0.1187496592696826,381,880,143,1404
457,KGC,0.0573119850250377,0.0793707820264975,0.0202787782709297,0.0476241113544748,379,552,473,1404
458,DAR,0.0812962983100396,0.0552534958198627,0.0,0.0429570370238277,228,657,520,1405
459,MA,0.0278049991078556,0.5555682859761687,0.0053598202835866,0.0288332500797763,709,8,690,1407
460,VAC,0.0819755461136652,0.0699809251311397,0.0342102672757815,0.0367921742399914,222,595,590,1407
461,PXD,0.0928320365353449,-0.0418264514402925,0.0626925053285779,0.073676521115155,177,948,286,1411
462,CAJ,0.0835689112762145,0.0947405444835459,0.0408751558935468,0.0253747552752155,215,476,722,1413
463,AMGN,0.0435912095927917,0.1002640867423376,0.0295670017723327,0.047757586927699,493,450,470,1413
464,BCS,0.0549541841887936,-0.0007685110932905,0.0236055337673483,0.135906849127106,393,915,108,1416
465,TRGP,0.0428373693980452,0.1135004671441918,0.0219004641586321,0.0423453393116355,499,393,524,1416
466,AXTA,0.0356183323853759,0.1005201382472709,0.0,0.0582627471404766,602,449,369,1420
467,EMR,0.2383928265814909,0.0750914779657421,0.0216048571181349,0.0049413446163347,12,570,840,1422
468,TXN,0.042060328078312,0.2525492627807634,0.0294422296548184,0.008715726970452,509,91,823,1423
469,BUD,0.0409982289624815,0.0753223867771112,0.0231281902010778,0.0662220036059404,528,569,327,1424
470,FMC,0.167596001183508,0.0980963753863444,0.0368419510736353,-0.0659857732998707,42,458,925,1425
471,AIG,0.0747334920969817,0.0074647263767781,0.0210476428469676,0.0725179507446693,254,874,298,1426
472,SRC,0.0531054153627323,0.0403042881490174,0.0667388854333165,0.0739853689317266,405,742,281,1428
473,VMW,0.0253389263633097,0.1072906717605858,0.0433885725399139,0.0742426685682971,734,417,279,1430
474,BMO,0.0587084828304969,0.0050222399997253,0.0363548749348987,0.1064419090768735,369,881,182,1432
475,HIW,0.0613777648451275,-0.0005550148857658,0.0881191797502167,0.1099450906422241,349,913,170,1432
476,JCI,0.050780516309595,0.0895436164067013,0.0269144975572759,0.046194066215651,434,508,492,1434
477,WTW,0.0416567953881386,0.1111786148238153,0.0138987601674168,0.0435520808655137,521,399,516,1436
478,CHE,0.0309652164155678,0.2366406048854968,0.0026705338766744,0.0310715741599542,663,109,666,1438
479,LAD,0.1105221309302942,0.1185213907199172,0.0058309037900874,-0.1177555437759519,118,366,954,1438
480,JBT,0.1830693815987933,0.0739892183288409,0.0040221216691804,0.0060017596782302,29,577,836,1442
481,SHW,0.0299877252186374,0.2261644464859899,0.0078295982162023,0.033059558926357,676,126,641,1443
482,CACI,0.0486629059771564,0.1012157121742615,0.0,0.041023765089542,456,446,542,1444
483,UNP,0.0426313396791899,0.1464224679972914,0.021205399091091,0.0318983201581397,503,289,653,1445
484,MAA,0.0352838070147692,0.1545056578778168,0.0418323671170625,0.0381563296261369,606,267,575,1448
485,SWN,0.2159075375561065,-0.0949132722666147,0.0,0.0479794527902458,20,964,467,1451
486,PPG,0.035983657186248,0.1029952389561863,0.0169434858247057,0.05275714148094,598,440,414,1452
487,AME,0.0345482346408868,0.1406362429330135,0.0060596505120369,0.0420688058052664,619,308,528,1455
488,MDLZ,0.0502319187124178,0.1050441024857764,0.0218796016170241,0.0364862615854263,440,425,592,1457
489,ABC,0.0455648118015007,0.1705134085125763,0.0,0.0220830055560768,478,231,750,1459
490,CFR,0.0858476009278334,0.0344402043613374,0.0343115908687354,0.0459714561211061,201,764,495,1460
491,VRTX,0.0345198694436335,0.19549805033676,0.0,0.0312706376266023,620,177,663,1460
492,WWE,0.0323791270797903,0.3069006608168129,0.0059096873044402,0.0208080586601719,648,56,757,1461
493,PEAK,0.0420304513861074,0.0251940429825587,0.0902420817693326,0.115737745421533,511,801,149,1461
494,DOC,0.0420304513861074,0.0251940429825587,0.0902420817693326,0.115737745421533,511,801,149,1461
495,MAN,0.0224378070985338,0.1150229500062027,0.0364614365351174,0.0682230621239203,765,384,312,1461
496,ANET,0.0286499688498925,0.2808501717015876,0.0,0.0274456610712334,692,70,703,1465
497,CUBE,0.0393129001233719,0.084986869355643,0.0425876591429901,0.0554751796312898,554,527,389,1470
498,BR,0.0323473346611847,0.1604688624601569,0.0169790164491788,0.0383746290200322,649,254,569,1472
499,NVO,0.0267251285917478,0.7082323535707135,0.0101451568415813,0.0223591374946577,720,4,749,1473
500,SBS,0.069752360617948,0.1153813553703676,0.0,0.0141696511959582,293,381,801,1475
501,WMT,0.0348654915193607,0.1688418841884188,0.013801438845263,0.0339866051042959,614,234,627,1475
502,IEX,0.0363176299337692,0.1385673544707263,0.0116184734580939,0.0381880396619468,591,315,574,1480
503,CHT,0.0397493525418357,0.1025557491545403,0.0392309481929757,0.0461286321086438,548,442,493,1483
504,FUL,0.0346865267798054,0.0881066219704254,0.0103875742178354,0.0620599810874576,615,517,354,1486
505,PHI,0.0949675974470686,0.0985694423586519,0.0832420573098826,-0.0058806117303963,169,455,862,1486
506,CME,0.0426688215492832,0.0943262060861639,0.0427918207559066,0.0446685505859987,502,481,504,1487
507,FNF,0.0375306706157352,0.0002033166020712,0.0362965866689896,0.4913831903247819,579,895,13,1487
508,SJR,0.0453917929017782,0.091719298245614,0.0351726981647286,0.0436688059984384,480,494,514,1488
509,MSCI,0.0255539772538606,0.3460489543871154,0.0098112515942229,0.025478022277381,732,41,718,1491
510,IT,0.0247609011818518,0.2786617219456902,0.0,0.029535014919252,741,71,681,1493
511,J,0.0385246248587138,0.0960500593681853,0.0074309150426584,0.0484483277851733,567,469,457,1493
512,FSS,0.0337904707437639,0.1578577946234295,0.0051093596169096,0.0352288198796166,627,262,608,1497
513,GS,0.0647750289312236,0.026430049701147,0.0318626815632803,0.0562560021107714,322,795,381,1498
514,MSFT,0.0285373338809775,0.2875738645407972,0.0078086152878395,0.02345542395173,696,66,738,1500
515,GE,0.0855305278851081,0.0571013381593845,0.0053135197684135,0.032332181409158,202,650,648,1500
516,SCI,0.0521354468657465,0.0605047320633334,0.0162992586701122,0.0492180694499707,416,635,450,1501
517,AEM,0.0724193813672848,0.062763326378393,0.0238241857445347,0.0355756452637153,269,628,605,1502
518,CMI,0.0216513537589946,0.0921892995497853,0.0271304718531075,0.0810968393177036,770,490,243,1503
519,PAYC,0.0285675699934134,0.2714072317210457,0.0054352386329123,0.0241597270957947,694,77,732,1503
520,KWR,0.0295259344997143,0.0946362574524832,0.0082883583470745,0.0629077232901814,682,477,348,1507
521,VLY,0.0904442951104377,-0.0009009697538898,0.0434973938557671,0.0529394973408106,185,916,409,1510
522,CTAS,0.0280890012907362,0.2463903172835864,0.0093750930584522,0.0263948178277476,700,97,713,1510
523,NYT,0.0287975419660259,0.1454934675393098,0.0086080222005879,0.0418788508388011,690,291,529,1510
524,NNI,0.02772945497585,0.0612340037250909,0.0119419152394029,0.108712356980879,710,633,172,1515
525,FDS,0.0280877225531587,0.1810386134813953,0.008315273272039,0.0350839006279602,701,205,611,1517
526,DXC,0.0220998554038032,0.0491716788013084,0.0,0.1835987987392882,768,690,59,1517
527,FCN,0.0406887863207572,0.1551763607795623,0.0,0.0259003725389561,536,266,715,1517
528,WAT,0.0330204364785969,0.2198456508448445,0.0,0.0227345134963215,638,135,745,1518
529,SID,-0.0125825025577768,0.0963902683305935,0.157411612413592,0.1140584722487289,903,466,154,1523
530,ORCL,0.0325497429232685,0.1468583229768258,0.0136549079178439,0.0367168066012259,646,287,591,1524
531,AVY,0.0308318242289346,0.1749088071747289,0.0157346506552038,0.033154937823918,667,218,640,1525
532,STZ,0.0379186197510722,0.138980044345898,0.0143517387942868,0.0331661703032853,574,314,638,1526
533,EDU,0.0280513078493191,0.0458884263596588,0.0,0.1309648925000185,702,708,117,1527
534,ODFL,0.0279464158259841,0.3302658052412216,0.0039476418759757,0.0183038244184724,707,45,775,1527
535,NU,0.0261061903604897,0.0356007642557758,0.0,0.2155340076945022,726,761,41,1528
536,PH,0.0416016482848391,0.0726176882898823,0.0140617891675664,0.0519124432982736,522,585,424,1531
537,TREX,0.0228263914787572,0.3187699949680773,0.0,0.0248243564595426,759,48,726,1533
538,HLT,0.023916534856725,0.1905128863772583,0.0033118426883107,0.0356127894141769,751,183,603,1537
539,GHC,0.0635339123863114,0.0295821569838861,0.0095795428378351,0.0515072579528712,328,782,429,1539
540,CHD,0.0326283941993658,0.1479460488023281,0.0115080294522644,0.0348522722679722,645,282,613,1540
541,COST,0.0260465458770796,0.2291378385247522,0.00517867592057,0.0279217978291325,727,119,697,1543
542,RYN,0.0350757389405011,0.1053510041704171,0.0343675241219864,0.0438717144212662,609,423,511,1543
543,TM,0.0996573950770512,0.0878446403460054,0.0177389946789239,-0.0169696170727032,146,519,880,1545
544,NKE,0.0310430813311096,0.178815207780725,0.0123192662008269,0.0298307479773503,660,211,676,1547
545,ATI,0.0705271526962643,0.1163672654690618,0.0,-0.0197091458849346,290,375,884,1549
546,PEG,0.0841633090005155,0.0806628141143507,0.0373365908441616,0.015794986979808,210,545,795,1550
547,INCY,0.0425591748642995,0.111973196807927,0.0,0.031976479333542,505,396,651,1552
548,CPRT,0.0293665620552247,0.23803728036816,0.0,0.0201094853183299,683,107,762,1552
549,FICO,0.0197858719780524,0.5323233904138231,0.0,0.0214126565799533,786,11,755,1552
550,NOV,0.124591595525242,0.0712270007901569,0.0099121208927433,-0.0175657838605577,87,589,881,1557
551,MMS,0.0354432764526054,0.0903504768781742,0.0149125430055763,0.0489932231645751,603,504,452,1559
552,NYCB,0.3251799320470551,0.0234830805134189,0.0710903052790318,0.0226009641060505,5,811,746,1562
553,MNST,0.0270946512024461,0.2291370399865897,0.0,0.0245233149990409,714,120,730,1564
554,CX,0.0161917686893034,0.0926583388121849,0.0,0.0779340075375263,820,487,262,1569
555,FISV,0.0377561765191335,0.0846035787784715,0.0,0.0481182041035893,577,530,463,1570
556,M,0.020554598298549,0.1037481720926652,0.0354322123051179,0.0610765206585458,779,434,358,1571
557,ADBE,0.0193927240628657,0.3089000371609067,0.0,0.0248018221157726,791,54,727,1572
558,MET,0.0314927937482852,0.0023906005601833,0.0352048720988436,0.2504854590207405,656,889,32,1577
559,CLH,0.0400443826512786,0.1145745484097152,0.0,0.0328110735359073,545,387,645,1577
560,MKTX,0.0234694749626844,0.2224295138627157,0.0099731285402648,0.0279818386071539,756,129,696,1581
561,LEG,-0.0383518677331551,0.0950799252646875,0.0671157685330214,0.1074861556205531,930,474,178,1582
562,NVDA,0.0192948022097994,0.5984354865056174,0.0002560970051367,0.0175189801919015,794,6,782,1582
563,IPGP,0.0427653230153401,0.0932216388081176,0.0,0.0362443722773172,501,486,596,1583
564,ATO,0.0576257827908673,0.0504218503772565,0.0279941655643156,0.0425280777538548,376,684,523,1583
565,FLO,0.0259070963079343,0.1186891687661071,0.0409789152602046,0.0462394311858288,728,365,490,1583
566,PFG,0.0328292508625185,0.0026915763369815,0.0329504114481792,0.1944047936184824,641,888,55,1584
567,FLS,0.0345523303588882,0.0908828348105237,0.0194194150935623,0.0478131514703704,618,499,469,1586
568,ROL,0.0203288240536429,0.2889015148325392,0.0123549775746393,0.0231771972333485,782,65,740,1587
569,TTC,0.039065388137203,0.1597729717698557,0.0168134018097334,0.0186381120836579,560,257,771,1588
570,TRI,0.0397930144353789,0.1283196037900114,0.013170823330745,0.0270201928764136,547,336,705,1588
571,PDI,0.0330717761098329,0.020032247817643,0.1416518688945045,0.1232375564188636,637,821,133,1591
572,JHX,0.0290218796075504,0.1864929888940193,0.0,0.0264450643464331,688,193,711,1592
573,CR,0.0382023659491071,0.1520492901151888,0.0085541053883698,0.02252730371911,572,274,747,1593
574,WAL,0.1013886625749099,0.0834141394152278,0.0240699828787334,-0.0621609062215221,138,534,922,1594
575,ADT,-0.0268570355463741,0.0748165236870823,0.0206830265722886,0.1368560193698658,919,573,105,1597
576,VRSK,0.0175429549640027,0.3148246028875845,0.0056192277619071,0.0237189659645134,813,49,736,1598
577,TRQ,0.2057608973002174,0.0635853712443756,0.0,-0.1271275602617258,22,622,956,1600
578,RLI,0.0501851848825301,0.0040127857961579,0.0230805621128202,0.0755129603980106,442,886,272,1600
579,TMUS,0.0437712560495216,0.0763892607387258,0.0039313608595638,0.0407766853278458,492,565,545,1602
580,ZTS,0.0257521524665274,0.2475598935226264,0.0076025979124731,0.0178089757458366,729,96,777,1602
581,NFLX,0.0251543674850299,0.1744110813239094,0.0,0.0322139714487413,737,219,649,1605
582,ABB,0.0427878376738353,0.147530836907025,0.0293550498465342,0.0090762079914196,500,283,822,1605
583,HWM,0.0343088713323143,0.1391716797778806,0.0032739184408613,0.0305864709132528,624,312,670,1606
584,RCL,0.051192418333462,0.1122425184609405,0.0,0.017496524828172,429,395,783,1607
585,ATR,0.0350722747234812,0.1262330183176117,0.0127823016874398,0.0316633897186164,610,344,656,1610
586,IDXX,0.0183283297564104,0.4752809115318201,0.0,0.0167631681902257,806,14,790,1610
587,WAB,0.0359193502608229,0.0886686311277792,0.0054209571559278,0.0447339147420065,599,513,503,1615
588,WLK,0.0267780692078709,0.0675253494107974,0.0123548085489341,0.0727871526276575,719,607,293,1619
589,VTRS,0.0042079353968833,0.0514456964876804,0.0442794810684832,0.1788641789998791,877,680,63,1620
590,VMI,0.0293198915650991,0.1058534403448223,0.010118657820846,0.0429154522267786,684,420,521,1625
591,LYV,0.0263219660425755,0.1169833649728081,0.0,0.0418482717367383,724,371,530,1625
592,MDT,0.034514592848704,0.0797807859379735,0.0344113400553029,0.0488104114259616,621,550,455,1626
593,DG,0.0556064808910072,0.0907965735527385,0.0173378921029541,0.023148564071116,388,500,741,1629
594,CAH,0.0105741778576715,0.0748635567912676,0.0212698979895692,0.0955322275417224,852,572,206,1630
595,GM,0.2066950669131141,0.0520549325659644,0.0121849466719787,-0.075109889033303,21,675,935,1631
596,UAA,0.0916824739161893,0.0810844090838445,0.0,-0.0468665842349562,180,542,909,1631
597,UA,0.0916824739161893,0.0810844090838445,0.0,-0.0468665842349562,180,542,909,1631
598,TER,0.0267980097506938,0.1847783752577494,0.0040534533681356,0.0254147907347221,718,194,721,1633
599,VNO,0.0195508017327072,0.0490929713735961,0.0354310328252075,0.1139769078926488,787,692,155,1634
600,JKHY,0.0300495790105991,0.2024719293272347,0.0120672525127332,0.01430782077474,673,165,799,1637
601,WPC,0.0507471092942483,0.0012489005429123,0.0656628766675854,0.0681902236177151,435,890,313,1638
602,RSG,0.0331980774614757,0.1046030800020602,0.0122378354870985,0.0381020337912847,635,429,576,1640
603,ETN,0.0334820283600063,0.1301939058171745,0.0143479543531537,0.0298300109720752,632,332,677,1641
604,STOR,0.0365138495940296,0.0308600462152152,0.0488928865715621,0.075100374423858,589,777,275,1641
605,RJF,0.0817542170179089,0.0989261174276192,0.0166893312486243,-0.173333983982191,226,453,964,1643
606,BCH,0.1336624620752173,0.0478608826994383,0.0843330945589137,-0.0109835584846652,69,703,871,1643
607,NWL,-0.1079460536814612,0.0615152169220807,0.0511909120551259,0.1797246151500617,952,631,61,1644
608,AER,0.1881979130327079,0.0479431555036652,0.0,-0.0582671076371893,27,701,919,1647
609,KIM,0.0497654221095774,0.0322731334874433,0.0500078322354166,0.0510718658878688,445,770,434,1649
610,STN,0.0280473817935196,0.1188298587760591,0.0071896821083025,0.0376082193674579,703,364,583,1650
611,BAH,0.0311698526679676,0.1974401582951097,0.0130407258210215,0.0098875433325253,659,174,819,1652
612,ENPH,0.0243572891084362,0.1563694610503258,0.0,0.0325391465501023,745,263,646,1654
613,OSK,0.0300135176862123,0.0702399818881593,0.0167930722879152,0.0555051597923283,675,594,388,1657
614,CBU,0.0472312941543225,-0.0014054873836653,0.0340483197648978,0.0751249098638024,466,920,274,1660
615,MLM,0.0378498794577348,0.1123868758517069,0.0056342535936742,0.0284335521873872,575,394,692,1661
616,EW,0.0303150340325382,0.1878229143710668,0.0,0.0136076111833163,671,188,805,1664
617,MDU,0.1028520820064721,0.0630432392267465,0.0400082141390332,-0.0464093895148697,134,624,908,1666
618,HASI,0.052987805079761,0.0325020083086598,0.0568861661323517,0.0462210335248212,406,769,491,1666
619,TDY,0.0421355417171596,0.082370825432149,0.0,0.034309758029147,507,539,621,1667
620,HSIC,0.0420662465741183,0.0904942965779467,0.0,0.0316508057156227,508,502,657,1667
621,VFC,-0.1626338846347889,0.0698981263327637,0.0508842519400607,0.1347927426037724,963,596,111,1670
622,TR,0.0396015917741929,0.1034994335540165,0.0108043510676479,0.0292190567735104,550,435,685,1670
623,FTV,0.0333582807655297,0.0749776793095466,0.00392994298693,0.0479992448344848,634,571,466,1671
624,APO,0.093154471279074,0.0857042754242964,0.0190849461665469,-0.328541626464735,174,525,972,1671
625,HOLX,0.0266262184823232,0.0842662632375189,0.0,0.0526101378345905,723,532,417,1672
626,CDNS,0.0141900710203511,0.3124431180711926,0.0,0.0169912888218673,836,51,785,1672
627,MHK,-0.0667095747673654,0.0777174474059087,0.0,0.1078709955127111,941,559,174,1674
628,RMD,0.0279890149580647,0.1888599949108778,0.0080539719274442,0.0174409486171677,705,186,784,1675
629,MCO,0.0224596324793511,0.183220590661607,0.0,0.0262751145371375,763,199,714,1676
630,SBAC,0.0182807655278103,0.124683869261009,0.0134774617081072,0.0429042731304357,807,347,522,1676
631,EBR,0.0478896635663677,0.0466581896981994,0.0090962461293124,0.0433851064822175,459,705,517,1681
632,COTY,0.0487051726963517,0.0547819603417701,0.0013129887169225,0.0386133689086188,454,661,567,1682
633,CMG,0.0194984438434781,0.2221088415490914,0.0,0.0194033745348578,789,131,766,1686
634,STWD,0.0520953569823613,0.0247432060319022,0.0923293383653922,0.0483400891449474,419,805,462,1686
635,TDG,0.0269143639679618,0.1589364363003643,0.0007879397771822,0.0256287780157171,716,258,717,1691
636,ETR,0.1103431424603702,0.0491113683886049,0.0437443337376746,-0.0194918796937256,119,691,883,1693
637,SPG,1.4973464902678512e-07,0.0910558283334387,0.0523670763585534,0.0673057247375399,882,496,317,1695
638,STR,-0.0086803638743636,0.0442089804456332,0.0847629550688612,0.1543440400802206,898,718,81,1697
639,IQV,0.0319321709897684,0.1031203566121842,0.0,0.035271175614619,652,438,607,1697
640,EGP,0.0241543403883847,0.1300267825606075,0.027182382501605,0.0345869538519924,749,333,618,1700
641,WST,0.0226813048102865,0.2140798682585426,0.0021786895419385,0.0158432774584829,760,146,794,1700
642,BMI,0.0204836951706553,0.2018031663108085,0.0064266216559523,0.0217038949866484,780,166,754,1700
643,ALGN,0.0212529901067412,0.1636254606581626,0.0,0.0290372004329936,774,247,688,1709
644,EPAM,0.0242562393385164,0.1421902968981502,0.0,0.0310685017686717,747,303,667,1717
645,PKX,0.1819376395687841,0.0410668230836642,0.087363711810494,-0.1145721128835305,31,733,953,1717
646,LIN,0.0309169462103769,0.1232678895136264,0.0123787482649065,0.0275205209209324,664,351,702,1717
647,GNRC,0.0256493632790662,0.091678395533717,0.0,0.0454688951314621,730,495,497,1722
648,CARR,0.0280440559854154,0.0885426709344028,0.0128890398153873,0.0444463985891906,704,514,505,1723
649,WM,0.0317716018968639,0.125013113263629,0.0156651648241481,0.0251525181683506,653,346,724,1723
650,ZBH,0.0403168812372557,0.0744118672711177,0.0079098256255514,0.035135532046999,540,574,610,1724
651,JPM,0.0991325779395684,0.0160838242599683,0.0269337644656201,0.0233727378928797,150,838,739,1727
652,EQR,0.0360634885162749,0.0464075016242919,0.0428752668742957,0.0518373311343957,597,706,425,1728
653,AZN,0.028540577224188,0.1160859770180087,0.0214761253638264,0.0314737146316108,695,376,659,1730
654,ADSK,0.0166803705914388,0.2001438590181622,0.0,0.0230505783449021,818,171,743,1732
655,MTN,0.028715414536428,0.1048558882089673,0.0336630911270125,0.0347662039048059,691,427,615,1733
656,HTZ,0.1894178169596595,0.0425403319540657,0.0,-2.2225843847149664,26,726,982,1734
657,TEF,-0.0439262729977828,0.0320420142106889,0.0845531510506649,0.2702549172778388,935,771,30,1736
658,CAG,0.0409712364658868,0.0624293801350223,0.0373871522928908,0.0379505367615557,529,629,579,1737
659,KOS,0.0692304699626736,0.084807031408271,5.382286443332624e-05,-0.0542874919317175,295,528,916,1739
660,SAM,0.0180214956476717,0.0985283389381976,0.0,0.047520970503652,809,456,475,1740
661,BRX,0.0435606157497006,0.0612783950277762,0.0450169815753403,0.0347867255550377,494,632,614,1740
662,MPWR,0.0142308880216776,0.218160344248234,0.0061883155117079,0.0193342404228305,835,139,767,1741
663,ELS,0.0239388307593017,0.1751351923738746,0.0261015397837574,0.0175941731625259,750,216,780,1746
664,AL,0.1320191067350097,0.0490727999837772,0.0280293209095425,-0.597357771805062,74,694,979,1747
665,BIP,0.0070507695500212,0.0454428091918409,0.1047937905669828,0.1099781799419984,868,711,169,1748
666,KEX,0.0477173244322238,0.0654095729987424,0.0,0.0296443088757446,460,613,678,1751
667,ABMD,0.0090681704672291,0.2428062147216561,0.0,0.0165829836945386,858,101,792,1751
668,AVB,0.0351089149281589,0.0442820784581002,0.0348757689778703,0.0517178423381696,608,717,426,1751
669,ASX,0.0255814462164927,0.0932396952516316,0.030512378485242,0.0411906246947928,731,485,536,1752
670,CRL,0.0391925300337831,0.0864521012073106,0.0,0.0301707766536107,558,521,674,1753
671,NOK,0.0387292955347055,0.0634468854694773,0.0361667556797776,0.0387292955347055,564,623,566,1753
672,ICE,0.0326915951123856,0.0717866998328734,0.0131843215085845,0.0421484121106897,643,587,526,1756
673,JBHT,0.0352491785337954,0.1453208003758691,0.0084166841487901,-0.0057021633924565,607,292,861,1760
674,FTI,0.0063622132532373,0.098130300693909,0.0049244889059755,0.0510675159881739,871,457,435,1763
675,AIN,0.0362945626727629,0.1086510730709465,0.0101786128201161,0.0207821646794446,593,412,758,1763
676,SYK,0.0278425296197011,0.1215341814885436,0.0100197918599809,0.0275874163941177,708,357,699,1764
677,NEE,0.0593993527697008,0.0684630097775637,0.0307316487243513,0.0142444685916943,365,602,800,1767
678,WY,0.0329800658835425,0.0994751466502006,0.0477994757024883,0.029599510858531,639,452,680,1771
679,NJR,0.0671505253282363,0.0710186004170728,0.0382961736011084,-0.0157082978176378,309,591,878,1778
680,LPX,0.0349036033068222,0.1326860841423948,0.0135300484728693,0.0031374025444334,612,327,844,1783
681,INTU,0.0165799995409899,0.1309295539808253,0.006182726338901,0.0332851836422726,819,329,637,1785
682,LLY,0.0099867836052255,0.2812456589064939,0.0077549840708236,-0.0060068586221797,854,68,863,1785
683,ECL,0.024275713230644,0.1234629274090327,0.0109199138506715,0.0289582034238608,746,350,689,1785
684,PWR,0.0237624428236292,0.1028904921023549,0.0015237289253821,0.0364131709555823,753,441,593,1787
685,HES,0.0313389031619728,0.1501663692916043,0.0122226257628823,-0.00376429661714,657,276,855,1788
686,BLK,0.0453870102910124,0.0577104393667347,0.0250362733975322,0.0313056532268978,481,646,661,1788
687,SNPS,0.0172196743072038,0.1727428249461054,0.0,0.0211618547143901,816,223,756,1795
688,ABT,0.0298817158151186,0.1091068330722719,0.0185670769593853,0.0264147475639848,677,410,712,1799
689,PAC,0.0063540903723901,0.2731761865399983,0.0049927097947586,-0.0003422617762637,872,76,851,1799
690,LDOS,0.013419759280539,0.0639876352395672,0.0135546312331072,0.0646036652801829,840,621,339,1800
691,SSL,0.060127299978961,0.0623623507592442,0.0,0.0127630811479504,361,630,809,1800
692,ADC,0.0283629028566951,0.0343938814061531,0.0475799005770857,0.0647584486808363,698,765,338,1801
693,SAP,0.0157829803256385,0.1225728381271525,0.0146740053881616,0.0339860993269864,825,354,628,1807
694,ASR,0.0068136067379235,0.2318839223861361,0.0039925225931036,0.0081529000777862,869,115,826,1810
695,IR,0.0248728472705603,0.0847614332930504,0.0010349046507848,0.0406295899937752,740,529,547,1816
696,LH,0.0211143539772952,0.0832376536184147,0.0128302533737631,0.0441532459606548,776,535,507,1818
697,AGI,0.0394180674660609,0.0839957697285212,0.0066259894359616,0.0236640445937122,553,533,737,1823
698,VAL,0.170319562719185,0.014952905335532,0.0,-0.0843528594654988,39,843,943,1825
699,R,0.0777514438701659,0.0640315052508751,0.0245127704812345,-0.1687168030778724,243,620,963,1826
700,JLL,0.0250569719281296,0.0704045245199455,0.0,0.0458673762978983,739,592,496,1827
701,BXP,0.0172811551160707,0.0409493582699731,0.0624878901202824,0.0742235219690769,815,734,280,1829
702,ED,0.0796389053788951,0.0533832200303997,0.0346503534320242,-0.0739165386168546,232,667,931,1830
703,HAE,0.0271637241378449,0.1098238293633205,0.0,0.0266777911357363,713,408,709,1830
704,MSA,0.0088277919365734,0.2159370217249794,0.0110738059477136,0.0075484454787015,860,142,829,1831
705,SXT,0.0336702740157662,0.0871796832866475,0.0249558184457177,0.0295008764207136,628,520,683,1831
706,FCX,0.0302725611667909,0.130282067207813,0.0141370239647947,0.0074534714993993,672,331,831,1834
707,TMO,0.0292603253318667,0.086384777014425,0.0025526522349568,0.0338092199455948,685,522,632,1839
708,TFC,-0.0221855856343355,-0.0001093770974301,0.0636691738048622,0.4136361112630797,914,909,17,1840
709,O,0.0219439137785144,0.030862477178727,0.0531245275585489,0.0727031367339642,769,776,295,1840
710,LHX,0.0307260421011384,0.0601193480390701,0.0217361080226472,0.0412435137249999,668,638,535,1841
711,DOW,0.0152194070022915,0.0453447198500312,0.0509552981468912,0.0702573304570979,827,713,303,1843
712,OGE,0.0595728222724601,0.0559962106532317,0.0476239548492891,0.0077324608563821,364,653,828,1845
713,TFX,0.0304183560126287,0.0731053346753682,0.0054545566887332,0.035785156280365,669,582,600,1851
714,ESS,0.0254744010436487,0.0445878611723261,0.0368455911464221,0.0527091141145679,733,714,415,1862
715,VMC,0.0309085121949846,0.1022468559291829,0.0075648351750262,0.0217737418741779,665,444,753,1862
716,WEC,0.050208650865036,0.0537515872545711,0.0370735645445033,0.0197949178704902,441,664,764,1869
717,CS,-1.0002653516001097,0.0037989998068973,0.0383348341702752,1.6952211310583845,980,887,2,1869
718,EXR,0.0296049180167384,0.0443761774150578,0.0385668783071573,0.0474114433054024,680,715,477,1872
719,IP,0.0229657105196111,0.0415500984353953,0.0511943963666332,0.055181498887399,758,730,390,1878
720,BURL,0.0266958317476389,0.0975640597993608,0.0,0.0276234488060894,721,461,698,1880
721,DEO,0.0095071090974122,0.1891669939657942,0.0056552713093021,0.0046949944230391,855,184,842,1881
722,DLB,0.02521786765171,0.0857257364498697,0.0102183268600316,0.0342321325382109,735,524,623,1882
723,ESI,0.0211421562063417,0.0550741633548331,0.0138560786652908,0.049552488043314,775,660,449,1884
724,GPN,0.0297389543858799,0.0404384016504204,0.0078530586886355,0.0479630585340648,679,737,468,1884
725,RCI,0.0261942288391394,0.0737190082644628,0.0296189160018537,0.0374247344898422,725,579,585,1889
726,SR,0.073221229106701,0.0489121544249959,0.055715463986938,-0.0748371458869868,261,695,934,1890
727,DTE,0.0615051097230024,0.0577022020991973,0.0331079760284165,-0.0314349666014486,348,647,897,1892
728,AWR,0.0420098813767745,0.0946093265733717,0.0205793636846624,-0.040643192365998,513,479,903,1895
729,IX,0.0187629724425699,0.0368827016430959,0.0054153356147733,0.0636817448666767,800,752,344,1896
730,CCI,0.0300445307152318,0.0692226364698681,0.054468213806642,0.0340451340062081,674,600,626,1900
731,TRMB,0.0236042910826885,0.064124513618677,0.0,0.0420904014776756,755,619,527,1901
732,IBN,0.0286386950369293,0.025563768492247,0.0036229044097776,0.0531548786947291,693,800,408,1901
733,CIEN,0.0417011519763428,0.0765707229550908,0.0,0.0101680790420562,520,564,818,1902
734,ST,-0.0006841109783839,0.0807194525984032,0.0125206866838593,0.0476140662724638,885,544,474,1903
735,FIS,-0.1874293865279001,0.0429499551471987,0.0346747181869319,0.090503549581326,969,724,215,1908
736,TECH,0.0222331566177608,0.1190925123785795,0.0039191703113411,0.0168464699935581,766,363,788,1917
737,KBR,-0.0354261498459296,0.1224643125469571,0.0096252180713469,0.0335545796653899,926,355,636,1917
738,SNN,0.0221372272407419,0.121435977190254,0.0275242331092114,0.0152351259717653,767,358,797,1922
739,ALB,0.0928306606710042,0.016391562583488,0.0110435657802749,-0.0486113236976481,178,837,912,1927
740,JWN,0.045705460369955,0.0523082650781831,0.0419535195933169,0.0177364473077437,477,673,778,1928
741,UDR,0.0352985750144487,0.0272657097590551,0.0432637576915629,0.0413330137431116,605,791,534,1930
742,OUT,-0.1869675291615479,0.0531473576624782,0.0899216508746292,0.0727192480986132,968,669,294,1931
743,AKAM,0.0303402989053721,0.0774526784480007,0.0,0.0275582363967517,670,562,701,1933
744,IVZ,-0.0119428635659098,-0.0142056128789849,0.0732963979633288,0.1400729044649794,901,933,99,1933
745,NI,0.0646574256242727,0.0501896397426013,0.0413941491501888,-0.0643315587164645,324,685,924,1933
746,ING,0.1505118221041959,-0.0006146956733271,0.061282911511342,-0.2393069810483346,49,914,970,1933
747,WCN,0.0198415087820264,0.09179805131308,0.0070387934484156,0.0315958560687348,785,493,658,1936
748,BX,0.0140675693346938,0.0828100248252547,0.0431717143994922,0.0387642509057917,838,536,565,1939
749,DHR,0.0279607148434948,0.0682551762143438,0.0073247212688248,0.033929658377465,706,604,629,1939
750,RBC,0.0268492840516658,0.0790091918892411,0.0029420368422501,0.0308913868436269,717,554,669,1940
751,CPT,0.0373844228956054,0.0362617785587401,0.0403104094050131,0.0355960728440943,581,756,604,1941
752,FRC,0.0754688245764567,0.0147082388474256,0.0157736642357999,0.0024929641751982,249,845,847,1941
753,ACM,0.0048070864398169,0.0602130922337717,0.0083568867711066,0.0512905315611062,875,637,430,1942
754,TRP,0.0548170390687241,0.0525539450789192,0.0540103543733254,-0.0160961736895843,394,671,879,1944
755,NLY,-0.1715341340738539,-0.0179282948037507,0.1584424204177171,0.2056939558796495,965,939,45,1949
756,NOC,0.0289890996191514,0.0733194613028148,0.0157353283924966,0.0296094889106119,689,581,679,1949
757,MTZ,-0.0085078221239212,0.0219624896263641,0.0,0.0842003394953,897,818,236,1951
758,NWE,0.0627435534418704,0.0425227088290931,0.0497892887159709,-0.0250992313086976,333,727,891,1951
759,DEI,-0.017850429608689,0.0157859764586761,0.0528209571046007,0.096702670204194,910,840,205,1955
760,NEA,0.0122108537662188,0.005970583595519,0.0473082370494075,0.0853593297434613,846,878,231,1955
761,BIIB,0.0310089576655753,0.0553939471604621,0.0,0.0330039358221669,661,656,644,1961
762,SWK,-0.020162589844776,0.0510443967020235,0.032850998849051,0.0580372184390818,911,681,372,1964
763,SWH,-0.020162589844776,0.0510443967020235,0.032850998849051,0.0580372184390818,911,681,372,1964
764,ALK,0.04722155171526,0.079032967032967,0.0,-0.089218591325853,467,553,945,1965
765,EVRG,0.060911211061136,0.0438367511729245,0.0474429451940696,-0.0294685990338164,351,720,895,1966
766,SJI,0.070840471324085,0.0412920530332961,0.0,-0.1021953974198793,287,731,951,1969
767,SRE,0.0652838242346569,0.0398230662463841,0.032418991741893,-0.0462612855308349,317,745,907,1969
768,CP,0.0402858698514211,0.0591438430019409,0.0072528927896497,0.0168037318096836,542,641,789,1972
769,STT,0.0778589617925095,0.0078615604993923,0.038849379083711,-0.0050464141902552,242,871,860,1973
770,GLOB,0.0156377087886091,0.1165508099760703,0.0,0.0185059733930822,826,374,773,1973
771,EXC,0.0651072255596201,0.0437496601598608,0.0400767415064156,-0.0756507925853833,320,721,937,1978
772,AMH,0.0292023196982439,0.0289536232088686,0.0256130970645132,0.044042218235583,686,784,509,1979
773,SE,0.0065682058914068,0.0113671836942344,0.0,0.0795160359859745,870,860,252,1982
774,PTC,0.0146446321887006,0.0817638888789811,0.0,0.0349652671121984,831,541,612,1984
775,CCL,-0.0038935646742138,0.0519673742660538,0.0,0.0524578916242057,889,677,421,1987
776,CUK,-0.0038935646742138,0.0519673742660538,0.0,0.0524578916242057,889,677,421,1987
777,APD,0.0365112154288694,0.0887546385737208,0.0237556234287653,-0.0225413342450819,590,511,889,1990
778,ROP,0.0238182413176384,0.0692421531246652,0.0049935367940894,0.0331600439555129,752,599,639,1990
779,ALL,-0.0051163771695276,-0.0034732980024459,0.0280856448880452,0.1077977125983984,891,925,175,1991
780,HAS,-0.2101415411151033,0.0428810346749916,0.0547471415783657,0.0728503845281191,974,725,292,1991
781,HMC,0.0404445775445445,0.0644258558408791,0.0088352216975934,0.0050634717101214,537,617,839,1993
782,AMZN,0.019433571154681,0.1015382835037485,0.0,0.0205781877367414,790,445,759,1994
783,TW,0.0190458806838854,0.0819499942989926,0.0039624238948903,0.0313014731605882,797,540,662,1999
784,ISRG,0.0151754504897467,0.1281887570014801,0.0,0.0063267617837119,828,337,835,2000
785,DUK,0.057419460385384,0.0431198285648375,0.043358642804978,-0.0362213076453423,377,723,900,2000
786,CRM,0.0151069286379518,0.0787528716770594,0.0,0.0346918781922792,829,555,617,2001
787,THG,0.0081435967567722,0.0002726322645138,0.0270376640196516,0.0806977378333972,864,894,245,2003
788,SMG,-0.1313370743034055,-0.066060606060606,0.0515189628482972,0.1514125386996904,957,958,88,2003
789,FNV,-0.0223239301789098,0.1267501970182228,0.0109515537105556,0.0224770961179797,915,340,748,2003
790,NSC,0.0340638179569905,0.0730650948231676,0.0228397246838059,0.0154750787653542,625,583,796,2004
791,DXCM,0.0113050990485344,0.1269406392694063,0.0,0.0106871287219663,850,339,817,2006
792,TU,0.0246088258175208,0.0506236872562047,0.0384787228894648,0.0376886654613161,743,683,581,2007
793,AEE,0.0605966497627262,0.04156329198346,0.0348220331101777,-0.0634897189788286,356,729,923,2008
794,CBRE,0.034341333736082,0.0779587556798322,0.0,0.0079758270036133,623,558,827,2008
795,C,0.0790759115052419,0.0081215690508364,0.0524956885448122,-0.0411948131520111,234,870,905,2009
796,RH,0.0250609826546451,0.111028975897187,0.0,-0.0131909008035229,738,401,874,2013
797,SO,0.051925636637559,0.0462880569503591,0.0396363951697665,-0.0201381618951499,422,707,885,2014
798,XEL,0.0518225380929306,0.0442945898300443,0.0319538179545342,-0.0154209359542486,423,716,876,2015
799,CNP,0.0508705245135352,0.0490920755348525,0.0296790955449742,-0.0290688711505915,432,693,893,2018
800,STE,0.0173226881121526,0.0893570930178622,0.0091857570336598,0.0280719519482859,814,510,695,2019
801,RPM,0.0470514237489383,9.047091937315578e-05,0.0210258061191518,0.0317158310916017,471,896,655,2022
802,TSLA,0.0190179606436877,0.1141774752793116,0.0,0.0055244519317652,798,388,837,2023
803,EDR,0.0502611168903218,0.017045014494479,0.007682627329315,0.0220067552271966,438,835,751,2024
804,REG,0.0309006971277016,0.0273015930027279,0.038692134353363,0.0384651408601426,666,790,568,2024
805,CMS,0.052454218762123,0.0403304813532754,0.034240127016087,-0.0156712153009724,410,740,877,2027
806,UMC,0.0185899957304335,0.117104717978679,0.0140197578241264,-0.0025112062735976,803,370,854,2027
807,PRGO,-0.0029168888784768,0.0164700524786398,0.0343825405596843,0.0697756567938016,888,836,305,2029
808,STAG,0.0272554083234134,0.0411401106036103,0.0378161105492533,0.0374213668149211,712,732,586,2030
809,FE,0.0524607520263084,0.0522348493580138,0.0431301645515748,-0.0937343200905638,409,674,947,2030
810,VEEV,0.0157888609400309,0.09072921450107,0.0,0.0265841103642572,824,501,710,2035
811,PNW,0.061543203361399,0.037876508728766,0.0474234962214338,-0.0783679269164518,347,750,939,2036
812,ANSS,0.0158810742776516,0.0973229372568714,0.0,0.021955090424643,823,462,752,2037
813,LNT,0.0541648367735324,0.0479069294858768,0.0351339481774264,-0.0760465062524559,397,702,938,2037
814,DD,0.0122216162136872,0.0484289501889772,0.0188091540309938,0.0454193396877455,845,698,498,2041
815,HEI,0.0185719553879264,0.0957681040277218,0.0012594634708162,0.0183743157968721,804,470,774,2048
816,NDAQ,0.0360750949999475,0.0677951538064959,0.0150227732719328,0.0016351317847001,596,605,849,2050
817,FR,0.0394490948602016,0.0673047374409139,0.0243123191454741,-0.0252387734211631,552,608,892,2052
818,RTX,0.0266286303699404,0.0309361642978767,0.026995347032312,0.0393136931001593,722,775,558,2055
819,H,0.0160878362688094,0.0434359805510534,0.0034369468392456,0.0438027905682584,821,722,512,2055
820,KKR,0.051929196879028,0.0373604076377046,0.0085573109208874,-0.0222924438793436,421,751,888,2060
821,AEP,0.0523924853044546,0.0417882877166264,0.0417697256147647,-0.0591832689166709,412,728,920,2060
822,ELP,0.0193898518170983,0.0741131930044353,0.0064412599987816,0.0283299606095637,792,576,693,2061
823,ZBRA,0.0210778730367583,0.1051156271899089,0.0,-0.0064800217781926,777,424,866,2067
824,X,0.0818501038991043,-0.0161182815245712,0.0,-0.0435314519061158,225,937,906,2068
825,QRVO,-0.0062773654429796,0.0172223069451153,0.0,0.0630181540735545,893,832,347,2072
826,FRT,0.0282821797152344,0.0499429760248649,0.0428668027961007,0.0292040939220416,699,687,686,2072
827,KNX,0.0233682298353631,0.0308170456724462,0.0098088905832562,0.0411829417227562,757,778,537,2072
828,WPP,0.002753038917442,0.0947725627696675,0.0105433410715081,0.0254606225969958,879,475,719,2073
829,POR,0.0538126955666646,0.0458597464342313,0.0422476864317235,-0.2213873177260152,398,709,969,2076
830,LXP,0.0082879535781957,0.000735113399007,0.0527681080770412,0.0665137535853282,862,891,324,2077
831,PUK,0.0552852055197451,-0.0034095467308463,0.017323347761331,0.0195009543279524,391,924,765,2080
832,UNF,0.0331739528313197,0.0580189912391553,0.0070716318225607,0.0140059907920953,636,645,803,2084
833,TEVA,-0.0478499207351939,0.0138639856557377,0.0,0.0720744781020273,937,848,299,2084
834,IDA,0.052380475053638,0.0399749191580243,0.0327975833865397,-0.0690083855767047,413,744,928,2085
835,NWS,0.013256463638143,0.0171181899374813,0.0154807025036032,0.0527589458887168,841,833,412,2086
836,NWSA,0.013256463638143,0.0171181899374813,0.0154807025036032,0.0527589458887168,841,833,412,2086
837,ASH,0.0411176611904717,0.0313696881269378,0.017555855339752,0.0168628610500249,527,773,787,2087
838,HXL,0.0169411387586649,0.0827249673403519,0.0067636334495331,0.0238650478823576,817,537,734,2088
839,RNG,-0.0512807398925674,-0.1359703497573468,0.0,0.1069931486647393,938,974,179,2091
840,TD,0.0763671535252721,0.0084104796385001,0.0412575282215461,-0.475584204285654,246,869,977,2092
841,EFX,0.0179422564685815,0.0909852840853717,0.0063108835332366,0.0169617333753049,810,497,786,2093
842,PLD,0.0242162046674972,0.0345438189175843,0.0255569476379325,0.0370555788911457,748,763,587,2098
843,SPGI,0.0187221634368154,0.073810223266745,0.0081775786222495,0.025431057493953,801,578,720,2099
844,RBA,0.0184900090970793,0.0655125989576479,0.0294049345640719,0.0293879756889,805,612,684,2101
845,PHG,-0.0238216447839388,-0.0054448179536953,0.0001022388188151,0.0762701588361303,917,929,269,2115
846,SUI,-0.0120782832830374,0.0350445415342714,0.0288860148395534,0.0489861700018372,902,762,453,2117
847,EIX,0.0513866169089361,0.0359075997813012,0.0445569812572154,-0.0747607710110819,428,758,933,2119
848,PCG,0.0606224767506352,0.0246438588721582,0.0,-0.1334715611792576,354,806,960,2120
849,BSX,0.0189647530599861,0.0775750753236433,0.0003333415478214,0.0202743091407133,799,561,761,2121
850,KRG,0.0094726543535695,0.0194163006378786,0.0419897571166501,0.0502710005243225,856,823,443,2122
851,D,0.0507239740732826,0.0398197644164813,0.0568037282375326,-0.0931805000152629,436,746,946,2128
852,MMM,-0.1381688547846324,-0.2587081597369838,0.0654005830152849,0.1000464974244693,959,978,198,2135
853,DNB,-0.0093313203358818,0.0266015938716253,0.0170941847004134,0.0501905910832115,900,793,445,2138
854,PANW,0.0058017198319013,0.057262404636584,0.0,0.0347179559283575,873,649,616,2138
855,AWK,0.0370572900207936,0.0534337584822538,0.020883981240532,-0.0337598192986044,584,666,899,2149
856,XYL,0.0245391432844009,0.0528510821888257,0.0120479537636057,0.0228064944153874,744,670,744,2158
857,VTR,-0.0020459738089705,0.0282508745107125,0.0361306900457608,0.0466953212123852,887,787,486,2160
858,AMT,0.0147425279893677,0.0583021285066087,0.0293131111703918,0.0290646360138259,830,643,687,2160
859,NEP,0.071798951448113,-0.0013435700575815,0.2660151151152589,-0.1931391793954241,275,919,966,2160
860,TRNO,0.029058154573574,0.0400219041695212,0.0260642189870998,0.0242933746767405,687,743,731,2161
861,LYG,0.0447308603410272,0.0088386941289463,0.0135257601507391,0.0111007904326175,485,867,815,2167
862,CTVA,0.0216333757955784,0.0288765458618467,0.0129211591486516,0.03455453494423,771,785,619,2175
863,EC,0.011096517510387,0.0961688975161493,0.0029351842737485,-0.0044808742823659,851,468,856,2175
864,NOW,0.0120024338414695,0.0760327279984035,0.0,0.0187490358794532,847,566,769,2182
865,AEG,-0.0144997627599039,-0.001305653043574,0.0400161050468858,0.0605911873989283,906,918,360,2184
866,BDX,0.0200506710560615,0.0457530505645982,0.0150515145259114,0.0285762596250473,784,710,691,2185
867,MS,0.059857322591907,0.0119493152438243,0.0379616760313811,-0.2433815731402862,362,855,971,2188
868,PPL,0.0370487643245793,0.0454089592155114,0.0352463920060862,-0.0316416473691001,585,712,898,2195
869,PFSI,0.0327531236070452,0.0737017876041036,0.0093842354345315,-0.3664368913925612,642,580,974,2196
870,FMX,0.0083023280220791,0.0921769116644612,0.00237584926181,0.0024912418767708,861,491,848,2200
871,KRC,0.045470522968154,-0.0001944471204649,0.0547233365926262,0.0125908878814103,479,911,810,2200
872,NMR,0.0591392406021915,0.0074357210627924,0.0214517600163403,-0.1306651932409442,367,875,959,2201
873,WRK,-0.1799978605469577,-0.0671053040494044,0.0307055173874222,0.0748590253263211,966,959,277,2202
874,DV,0.011579452597249,0.07582886464178,0.0,0.0166454023482577,848,567,791,2206
875,WD,0.0295774246774859,0.0523887121335899,0.0233727693577428,-0.0046061734510361,681,672,858,2211
876,BFAM,0.0136457908238167,0.047610712839837,0.0,0.0303570723472323,839,704,672,2215
877,IFF,-0.1242290172830895,0.0305290227773695,0.0400051338307337,0.0453326940261098,956,779,499,2234
878,EL,0.0143132753694055,0.0878602620087336,0.0131608148277337,-0.0221670805422802,833,518,887,2238
879,GLW,0.0225005421817393,0.0368057565857491,0.0383012671561793,0.0238172692629426,762,754,735,2251
880,AU,-0.0305951449965292,0.0956958393113343,0.0139305553813984,-0.0079417184884607,923,471,867,2261
881,SCHW,0.0403773332313341,0.0189735315349582,0.0181367299061607,-0.0388234394124847,538,825,901,2264
882,TYL,0.0094427347861828,0.0594573564320743,0.0,0.018634659645819,857,639,772,2268
883,AR,0.0357270326048783,0.0291827423359474,0.0,-0.0215452895301991,601,783,886,2270
884,SWX,0.0336478604416024,0.048066533602342,0.0389295547636495,-0.081017199246059,630,700,941,2271
885,GMED,0.0203891001221137,0.0283658901991931,0.0,0.0274168374474151,781,786,704,2271
886,XRAY,-0.0174948443223928,0.0496215306980656,0.0153742571317997,0.0302183674659513,909,689,673,2271
887,MRK,0.0013196726604391,0.0368234524147639,0.0269177067314224,0.0330568962586159,881,753,642,2276
888,DIS,0.015888293284125,0.0194336161430864,0.0,0.0330522396823961,822,822,643,2287
889,FAF,0.0322566630541584,0.0176799567021468,0.0322269059849203,0.0135245879687407,650,831,806,2287
890,COO,0.0190641337677519,0.0498695029888025,0.0001943997325059,0.0139319808295943,796,688,804,2288
891,GOL,-0.0683485059782147,-0.1036552142495524,0.0,0.057404239282772,943,969,376,2288
892,MAC,-0.0824031195304747,0.0255885264539705,0.0478937219638017,0.040890817335395,947,799,544,2290
893,CUZ,0.0224574180549758,0.0265204533069329,0.0526084433319485,0.0240490868490558,764,794,733,2291
894,DNP,-0.0569175431627175,-0.0490478467113992,0.0854965200734807,0.0533158238834794,940,952,406,2298
895,XPO,0.0186015566255004,0.0742121314808539,0.0,-0.0837562152820153,802,575,942,2319
896,AJG,0.0200613689588482,-0.0965057831454277,0.0097999632170299,0.0380348656867034,783,966,577,2326
897,AMRC,0.0378314002196365,0.030095597739221,0.0,-0.3765323473308908,576,780,975,2331
898,NCLH,0.0195377654749285,0.0691906499109689,0.0,-0.0875492422906439,788,601,944,2333
899,PFE,0.0130430524756039,0.023698008471968,0.0569179359329448,0.0295022890587871,843,809,682,2334
900,NGG,0.0114784808086736,0.0628278273672586,0.0086113668250224,-0.0091075980914236,849,627,869,2345
901,STX,-0.0413052457662123,-0.0688960515713134,0.0454435785178366,0.048879175519185,932,961,454,2347
902,KMX,0.0383391908386099,-0.0048665318045148,0.0,-0.000535240078777,569,927,853,2349
903,CAE,-0.0367092060560125,0.0628302366333587,0.0,0.0144660615440698,927,626,798,2351
904,HR,-0.0431335793195082,0.0041247054669117,0.0723307190110051,0.0411697038506615,934,885,538,2357
905,EQIX,0.0128544018529242,0.0501157842213198,0.0182258653058872,0.0074554570491265,844,686,830,2360
906,FLR,0.014126457322781,0.0385826771653543,0.0049357501489234,0.0180410177857203,837,748,776,2361
907,IRM,0.0090179576213143,0.0604935917132433,0.0361067796354775,-0.0113330206588519,859,636,873,2368
908,REXR,0.0209120267609828,0.0279356645856667,0.0276454224440806,0.0141440143355491,778,789,802,2369
909,WELL,0.0073147513114258,0.0260276064798662,0.0271125470565624,0.0268574618431993,867,796,706,2369
910,LAZ,-0.02580537312163,-0.0456881261990455,0.055884895369388,0.044031453167971,918,950,510,2378
911,CCJ,0.0145919164930303,0.0281251368646578,0.0021059685103119,0.0199645038368741,832,788,763,2383
912,ORA,0.0276212354617877,0.0367249399359959,0.0063085277368814,-0.0686055721947452,711,755,927,2393
913,WDAY,0.0181544751878757,0.0106168289900851,0.0,0.0251217973092183,808,861,725,2394
914,CALX,0.010172873987283,0.0339223280117418,0.0,0.0133196136271344,853,766,807,2426
915,DLTR,-0.0327915749562885,0.0403248147378627,0.0,0.0189477760339371,924,741,768,2433
916,MC,-0.0064239904317538,-0.0697955187789935,0.0473752389103868,0.0368734449976828,894,962,589,2445
917,CDAY,0.0051510924451897,0.0362078346028291,0.0,0.009879193722435,874,757,820,2451
918,BIO,-0.0675754567002412,0.0325906222776293,0.0,0.0231424234859581,942,768,742,2452
919,ARES,0.0216157490814906,0.0226511686126152,0.0469689994704562,-0.0136916848687176,772,814,875,2461
920,HUN,0.0226555844221098,0.0138248847926267,0.0379088491815501,-0.0047105670580624,761,849,859,2469
921,LUV,0.0270606857701529,0.0092443564029548,0.024907469913173,-0.0226378640098698,715,866,890,2471
922,PNM,0.0246095059223709,0.0336142995141237,0.0352947212991421,-0.1461430715212756,742,767,962,2471
923,AUY,-0.261708570233604,0.053687562856185,0.0214933367842704,0.004369936710938,975,665,843,2483
924,DLR,0.0236111629679043,0.0185111211244498,0.0378401511113235,-0.0470516694532123,754,826,911,2491
925,AAP,0.0081979304128236,0.0148668486575421,0.0577020161389307,0.0123965610587591,863,844,812,2519
926,RKT,-0.008328623793096,-0.0022519476254158,0.0,0.0268385258017437,896,922,707,2525
927,PENN,-0.1238110976182282,0.0249481961274032,0.0,0.0186980024974467,954,803,770,2527
928,YPF,-0.1948403713179253,-0.0620432513049962,0.0,0.0356415313386448,972,954,602,2528
929,BA,-0.0140714999892215,-0.0187689692849338,0.0,0.0280733390874073,905,940,694,2539
930,ARE,0.0047834560764205,0.0312920284754312,0.0391155617674149,-0.0395895734223406,876,774,902,2552
931,MANU,-0.00921163299199,-0.0361723429160862,0.0,0.0257474746276568,899,946,716,2561
932,ES,-0.0204967372240355,0.0486968480834752,0.0429416470522568,-0.1247067766096819,913,697,955,2565
933,OFC,-0.0270521412504934,-0.0176264729723225,4.197612738102126e-07,0.0267737732478613,920,938,708,2566
934,HDB,0.0192074265952894,0.0189987368003447,0.0025198585656339,-0.0965984031219516,795,824,948,2567
935,TV,-0.000548577358494,0.0158288373714217,6.691217022963452e-05,-0.0005344197922927,884,839,852,2575
936,CWT,0.0175725248917078,0.0145055138561775,0.0199844267979207,-0.0561693871295308,812,847,918,2577
937,TAL,-0.0003977014359372,-0.0222776892091516,0.0,0.0205780718360864,883,941,760,2584
938,AMD,0.003589445751748,0.0065527158637819,0.0,0.004711672936428,878,876,841,2595
939,CVT,-0.0384403731892883,-0.0406671794855289,0.0,0.0253686527880201,931,947,723,2601
940,FL,-0.1187117828998914,0.0398063474986551,0.0406497923263264,-0.0543196339935866,953,747,917,2617
941,MBLY,-0.000773140088976,-0.0021310946076848,0.0,0.0084759061606259,886,921,825,2632
942,NEM,-0.0724238192489928,0.0131291912418195,0.0406504181821994,0.0027866364407585,944,851,846,2641
943,UGI,-0.3112606304208982,-0.1100022853660394,0.0638270800064158,0.0275616936391341,977,970,700,2647
944,NRG,-0.0171366520750619,0.0232192526303059,0.0323221011910821,-0.0715158301944416,908,813,929,2650
945,TTM,-0.0764647887017587,0.012611158036458,1.0411038202837614e-05,-0.0060260858314058,946,853,864,2663
946,ILMN,-0.0527729191742515,-0.0081957616204191,0.0,0.0127727737191771,939,930,808,2677
947,INTC,0.0080219427920065,0.0005687412471945,0.0146665241810042,-0.0678184257709068,865,892,926,2683
948,HUBS,-0.006088460922513,-0.098364887513622,0.0,0.0086586724360288,892,968,824,2684
949,MXL,-0.0381233945985341,-0.044539975388287,0.0,0.0122807708713311,929,949,814,2692
950,SNOW,-0.0130293827845126,-0.1993340316629926,0.0,0.0123212650018531,904,975,813,2692
951,AES,0.0193349251645215,-0.0053895289152503,0.0344767340283035,-0.3641799157494224,793,928,973,2694
952,LUMN,-5.717031199437558,0.0403490355596378,0.0061067530776668,-0.5218498084551666,982,738,978,2698
953,WK,-0.0232169748876075,-0.1287202462007734,0.0,0.0124739012068168,916,972,811,2699
954,BEP,-0.0067469334493962,0.0138000076668452,0.1311835337100432,-0.1273821053532194,895,850,957,2702
955,GWRE,-0.0160475527561572,-0.0903466461021124,0.0,0.0030082257046274,907,963,845,2715
956,MPW,-0.1893597756723873,0.0049744545443641,0.2094072562896341,-0.0080198089280522,970,883,868,2721
957,GME,0.0014908359206011,-0.0156077565820589,0.0,-0.0530915597993201,880,935,914,2729
958,TSN,-0.0369862380372636,-0.0132764183920408,0.0382419436496398,-0.0106734977051979,928,932,870,2730
959,NEWR,-0.0351284643148866,-0.4301764196358282,0.0,0.0066352914695669,925,981,833,2739
960,ENV,-0.088523550288856,-0.1290330519373163,0.0,0.0091095559094166,949,973,821,2743
961,LNC,-0.1644394633722437,0.0235447016865139,0.0846250961769392,-0.4535205412686614,964,810,976,2750
962,WBA,-0.1409766348620937,-0.0954600307935583,0.0759351419598095,0.0064538004920633,960,965,834,2759
963,CTLT,-0.0295610690913539,-0.0147708894878706,0.0,-0.0410287252043791,922,934,904,2760
964,HCP,-0.0450005540457791,-0.2032281139230895,0.0,-0.0045879002774241,936,976,857,2769
965,HL,-0.0290976124270932,-0.0156550712001917,0.005393608324587,-0.0509353243854653,921,936,913,2770
966,TTWO,-0.1467450519302371,-0.0465419703379032,0.0,-0.0061845972957084,962,951,865,2778
967,S,-0.0428511019461759,-0.2146949761456444,0.0,-0.0110247397273868,933,977,872,2782
968,W,-0.1049219483067474,-0.56855151045701,0.0,-0.0002843413233245,950,982,850,2782
969,RIG,-0.1956200787401575,-0.0045076099061356,0.0,-0.0539288057742782,973,926,915,2814
970,KMPR,-0.0873199620911857,-0.0638979400231954,0.0257049943531935,-0.0603313225767839,948,956,921,2825
971,AA,-0.1075677461996034,-0.031901509705248,0.0118968935888962,-0.0727032385988103,951,945,930,2826
972,TEO,-0.2842120131096284,-0.0648327914552615,0.0,-0.0302826449852364,976,957,896,2829
973,MU,-0.0763038034692394,-0.0965724755837213,0.0065930253640488,-0.0800189209362828,945,967,940,2852
974,SPR,-0.1818907427589065,-0.0267267140872932,0.0,-0.1103387855295021,967,943,952,2862
975,WDC,-0.1414389632009975,-0.0676493814161621,0.0,-0.1007317352222813,961,960,950,2871
976,BAK,-0.1342455948756865,-0.0623522238910285,0.0002052236654574,-0.1990962731602505,958,955,968,2881
977,MRNA,-0.1240856122285133,-0.275063266497956,0.0,-0.1006846556584776,955,979,949,2883
978,CEA,-0.3354717798420933,-0.0523955268384762,0.0,-0.1291733027621429,978,953,958,2889
979,KEP,-0.8010410416763826,-0.0253157364889634,0.0075282974070141,-2.0603174193197447,979,942,981,2902
980,NIO,-0.1932175677050099,-0.3802156801451961,0.0,-0.1436531229006565,971,980,961,2912
981,LPL,-1.1253666198746497,-0.1147541837967621,0.0,-1.0083417336205311,981,971,980,2932
