,ticker,eps,roce,divYield,eps_rank,roce_rank,overall_rank
0,PBF,0.57541184,0.497484548,0.014721326,6,20,26
1,SWN,0.284601461,0.778613023,0.0,27,3,30
2,DQ,0.860150992,0.44335949,0.0,3,33,36
3,LPX,0.23518711,0.620655412,0.014942827,41,10,51
4,ERF,0.221426368,0.89771845,0.010073994,53,2,55
5,PBR,0.527250274,0.366559486,0.542769914,8,55,63
6,RRC,0.196368659,0.523872006,0.006411598,71,16,87
7,APA,0.232549736,0.390675398,0.014066549,42,46,88
8,MLI,0.199209054,0.463094424,0.016881369,69,26,95
9,ICL,0.229432082,0.384514436,0.123908202,46,49,95
10,SQM,0.171288828,0.712109629,0.098151339,91,5,96
11,VLO,0.230055259,0.360515613,0.031171609,45,59,104
12,NUE,0.219991823,0.373606235,0.015430527,54,52,106
13,CHK,0.415826671,0.296145409,0.102103307,12,94,106
14,SM,0.260930618,0.308645801,0.004608018,29,79,108
15,CF,0.193174129,0.438139308,0.017666253,75,34,109
16,BTU,0.34549882,0.294452377,0.0,16,96,112
17,CIVI,0.251683068,0.301313526,0.108273649,32,89,121
18,CVI,0.204465865,0.359328358,0.153349399,64,61,125
19,E,0.297022318,0.285394955,0.064358044,22,104,126
20,AR,0.199446755,0.359487423,0.013144486,68,60,128
21,AN,0.228008985,0.304253081,0.0,48,83,131
22,DHI,0.247287594,0.292830481,0.013361762,35,99,134
23,PHM,0.244608944,0.293601429,0.013468685,38,97,135
24,MPC,0.241730877,0.282611184,0.021298828,39,107,146
25,MTDR,0.17958165,0.353364137,0.0052129,83,65,148
26,MTH,0.293271421,0.252802701,0.0,24,129,153
27,CMC,0.249058501,0.268729765,0.013861818,34,120,154
28,GGB,0.219691652,0.287836111,0.113286399,55,101,156
29,EC,0.32024605,0.241922689,0.128046653,18,141,159
30,WSM,0.127925495,0.495089978,0.024651005,141,21,162
31,DVN,0.148785055,0.391249515,0.083581829,119,45,164
32,CPG,0.289509786,0.239178408,0.039150373,25,143,168
33,CTRA,0.207846313,0.274721797,0.101852363,61,117,178
34,CRC,0.146868396,0.361210543,0.016536709,120,58,178
35,GPI,0.27054777,0.227559892,0.008532245,28,161,189
36,VALE,0.238719147,0.23571634,0.083897303,40,150,190
37,X,0.407952204,0.213497645,0.0,13,179,192
38,MRNA,0.118156944,0.449964175,0.0,164,29,193
39,PXD,0.143121415,0.322983706,0.114369427,124,72,196
40,DDS,0.114003828,0.450823966,0.03468959,170,27,197
41,NVR,0.113847204,0.449262032,0.301158389,171,30,201
42,FANG,0.181637437,0.26570857,0.065101243,81,122,203
43,EQT,0.141465298,0.319187393,0.016265955,127,76,203
44,OLN,0.172976009,0.274418461,0.015147948,90,118,208
45,BAM,0.168598192,0.267837864,0.280322007,98,121,219
46,OXY,0.214324875,0.225297601,0.020294358,57,163,220
47,UMC,0.176627857,0.245690075,0.07584877,87,134,221
48,ARW,0.210451463,0.220672832,0.0,58,166,224
49,HPQ,0.111721282,0.376065627,0.036170768,175,51,226
50,COP,0.119548257,0.346916599,0.036645253,160,67,227
51,HRB,0.11245636,0.367564482,0.036136532,173,54,227
52,MOS,0.23174962,0.209996527,0.012788015,43,190,233
53,PSX,0.22464305,0.210476772,0.0365371,50,187,237
54,EOG,0.1031081,0.400747392,0.018684107,204,42,246
55,STM,0.134202824,0.277801605,0.006581309,134,115,249
56,AMG,0.187866164,0.216039098,0.000262314,78,172,250
57,KBH,0.299521729,0.188530021,0.019237379,21,230,251
58,TMHC,0.301687504,0.186697536,0.0,20,236,256
59,QCOM,0.096201312,0.426940885,0.02388672,220,37,257
60,ABG,0.249494968,0.182112192,0.0,33,240,273
61,LEN,0.181264237,0.205092492,0.017208165,82,194,276
62,TX,0.294627118,0.176731184,0.08835083,23,257,280
63,MTG,0.217642507,0.18824356,0.027904098,56,231,287
64,RHI,0.07905037,0.607008807,0.022743116,276,11,287
65,EXPD,0.080129815,0.51588673,0.012620957,273,18,291
66,ESNT,0.199454652,0.192662973,0.022102955,67,225,292
67,CHRW,0.081692141,0.481352823,0.024782097,268,25,293
68,AMAT,0.084849804,0.40254303,0.011352319,254,41,295
69,MUSA,0.102406574,0.296237381,0.004550389,205,93,298
70,CVE,0.125792754,0.22930948,0.018079052,147,159,306
71,CNQ,0.128184488,0.218695826,0.057734003,140,169,309
72,PFE,0.109175473,0.258144814,0.031261101,186,125,311
73,AB,0.078386735,0.448232405,0.103220662,280,31,311
74,TOL,0.255740257,0.161328824,0.017672417,31,289,320
75,JBL,0.116978845,0.231395349,0.005637535,166,156,322
76,SU,0.152349591,0.200727536,0.043571614,114,208,322
77,PII,0.100746331,0.278441145,0.025044663,211,114,325
78,MAS,0.078287543,0.393268648,0.0239315,281,44,325
79,OC,0.150607162,0.198196115,0.016504894,117,213,330
80,AMCR,71532.7112,0.140370474,49349.37996,1,331,332
81,TNET,0.083110924,0.342955326,0.0,264,69,333
82,LAD,0.22381643,0.164105035,0.008086733,52,283,335
83,MT,0.321056428,0.142372036,0.011458905,17,325,342
84,RIO,0.107691198,0.234117523,0.101682341,190,154,344
85,TKC,0.141399408,0.19639523,0.015966699,128,217,345
86,XOM,0.120217588,0.209144663,0.03221978,157,191,348
87,VSH,0.138633643,0.196052424,0.018488473,131,219,350
88,DKS,0.106393402,0.230369484,0.016633219,194,158,352
89,ACT,0.179281897,0.171922223,0.063848825,84,270,354
90,TSM,0.085659946,0.278886788,0.024035827,248,111,359
91,TS,0.123026868,0.200739096,0.025597286,153,207,360
92,CVX,0.105660298,0.224562754,0.032772121,198,165,363
93,GIL,0.107339642,0.215606989,0.024532482,193,173,366
94,WLK,0.171237973,0.167104975,0.012879047,92,277,369
95,NNI,0.11936995,0.20070473,0.010727697,161,209,370
96,BC,0.120724188,0.196175022,0.0193658,156,218,374
97,IBP,0.090919782,0.238071476,0.025502773,232,145,377
98,MUR,0.14450178,0.175303827,0.019198934,123,261,384
99,LYB,0.14297916,0.172301976,0.119554444,126,267,393
100,PAG,0.161399842,0.158251343,0.018022982,102,295,397
101,M,0.185644462,0.144106622,0.027286739,80,319,399
102,OGN,0.129218442,0.17505626,0.040865156,138,262,400
103,ASX,0.149395839,0.16537715,0.072852326,118,282,400
104,LII,0.058204948,0.675172343,0.01662664,398,8,406
105,MCK,0.07086177,0.305019843,0.005812258,327,82,409
106,WSO,0.067777509,0.322105813,0.037481148,341,74,415
107,AVT,0.165999028,0.144243023,0.022897257,100,318,418
108,EVR,0.109066182,0.187649473,0.029126658,187,232,419
109,WMS,0.07315415,0.285177592,0.005714577,315,105,420
110,MO,0.06916466,0.301079822,0.079184176,330,90,420
111,UPS,0.076619262,0.247131209,0.033930629,291,132,423
112,SSD,0.087761075,0.212270103,0.011533922,241,183,424
113,TEX,0.100897585,0.198159943,0.01197318,210,214,424
114,BBY,0.074105161,0.263042204,0.041204349,303,123,426
115,HCA,0.084781035,0.213889411,0.009810742,255,178,433
116,POOL,0.062819301,0.354976238,0.01264205,370,63,433
117,AGCO,0.085982645,0.210349585,0.03907687,246,188,434
118,TPR,0.092509132,0.201087423,0.027999826,229,205,434
119,AZO,0.055863441,0.489143143,0.0,417,22,439
120,RDY,0.058081102,0.406030447,0.006415943,399,40,439
121,MSM,0.077524381,0.233950596,0.03818792,285,155,440
122,SWKS,0.09208651,0.199396717,0.026950036,231,210,441
123,TXN,0.057371222,0.418627694,0.028177408,404,39,443
124,CIG,0.170873178,0.133895352,0.087399209,94,349,443
125,YPF,0.449540933,0.106703528,0.0,11,437,448
126,GFI,0.077102204,0.21870374,0.0,288,168,456
127,CRI,0.086322265,0.198439265,0.040776929,244,212,456
128,MC,0.059578952,0.331594292,0.069210972,388,70,458
129,NVO,0.052137549,0.621765835,0.023759323,453,9,462
130,BYD,0.107684565,0.171393048,0.008111496,191,271,462
131,PM,0.05767631,0.356558451,0.049797451,402,62,464
132,TSN,0.136424154,0.139964453,0.027512345,132,332,464
133,HD,0.053261172,0.450717165,0.024253216,441,28,469
134,CLF,0.159668177,0.127515454,0.0,103,367,470
135,GWW,0.05463897,0.397095733,0.013068144,428,43,471
136,BG,0.107646841,0.165554072,0.023334626,192,279,471
137,HTZ,0.353003098,0.099860302,0.0,15,458,473
138,WES,0.114773024,0.153156161,0.069381824,169,305,474
139,ASR,0.073355857,0.224895199,0.03312071,312,164,476
140,EXP,0.085467863,0.18893639,0.0069435,249,228,477
141,DOW,0.126117532,0.139430102,0.055214266,145,333,478
142,WU,0.170788395,0.121103052,0.068307856,95,384,479
143,CTSH,0.077301091,0.204619097,0.019038347,286,195,481
144,WY,0.081742599,0.197435897,0.070307331,267,215,482
145,PAC,0.064507378,0.257797861,0.051362661,356,126,482
146,NRG,0.156620788,0.124845335,0.042586488,109,375,484
147,PSA,0.133953555,0.133464361,0.079594265,135,350,485
148,NEU,0.089538436,0.179098012,0.026990167,235,251,486
149,CSL,0.07569632,0.207646982,0.011010374,296,192,488
150,ALSN,0.111848791,0.145072775,0.016851042,174,316,490
151,VIPS,0.098335489,0.167727965,0.0,215,276,491
152,ACI,0.139292045,0.130055132,0.389971709,129,363,492
153,ALB,0.080431698,0.194255801,0.007261372,272,222,494
154,TPX,0.075895393,0.201444385,0.011741552,293,202,495
155,LRCX,0.053677695,0.35452199,0.010803613,436,64,500
156,RLI,0.097962417,0.16324423,0.061262801,216,285,501
157,CNS,0.054311093,0.328986719,0.03408756,432,71,503
158,SNA,0.075002048,0.201159768,0.025757531,299,204,503
159,SEE,0.067550744,0.228604612,0.016283082,343,160,503
160,MRO,0.194791012,0.107916525,0.011864347,73,433,506
161,MMM,0.08511269,0.177055128,0.049635564,251,256,507
162,KLAC,0.0500691,0.386726386,0.002653431,470,47,517
163,NTAP,0.093352961,0.160289718,0.031655007,227,292,519
164,TLK,0.075342368,0.193262827,0.040436641,298,223,521
165,THC,0.191678621,0.102865961,0.0,76,448,524
166,GSK,0.084169995,0.172300193,0.059300421,258,268,526
167,SCCO,0.056514045,0.276516828,0.057955544,411,116,527
168,ULTA,0.047797874,0.44423196,0.0,496,32,528
169,FRO,0.195707183,0.100992915,0.013824838,72,456,528
170,SIG,0.106364355,0.138348238,0.019623899,195,339,534
171,LOW,0.047384842,0.419845435,0.017446338,502,38,540
172,OMC,0.078499572,0.174339105,0.034649526,278,264,542
173,CR,0.07247528,0.190915008,0.01869248,319,226,545
174,CHH,0.053201375,0.287227754,0.008416226,443,103,546
175,CBT,0.057898185,0.237190083,0.023270084,401,147,548
176,TER,0.051701001,0.301975434,0.00503721,461,88,549
177,TROW,0.063207068,0.212115526,0.044929397,365,185,550
178,ADM,0.085451658,0.155920602,0.017700701,250,301,551
179,GEF,0.095943894,0.14078506,0.028347638,222,330,552
180,UL,0.063595907,0.205271596,0.036025475,361,193,554
181,TGS,0.102107157,0.134174738,0.0,206,348,554
182,AIT,0.062036441,0.21477693,0.009562235,378,177,555
183,AVGO,0.059633439,0.214888892,0.036480412,387,174,561
184,BBWI,0.072526785,0.180674671,0.007132373,317,247,564
185,CNHI,0.093307777,0.138152181,0.019452533,228,341,569
186,LKQ,0.077635602,0.161871608,0.019189305,284,287,571
187,NXPI,0.067343666,0.190173295,0.01969325,345,227,572
188,AYI,0.068529145,0.185798126,0.00323015,335,237,572
189,CSCO,0.0591592,0.213075713,0.029558494,396,181,577
190,HOG,0.11591971,0.114251444,0.014568765,168,409,577
191,PCAR,0.087340479,0.138659021,0.029137661,242,337,579
192,SID,0.110373903,0.117742279,0.191283949,183,396,579
193,FLT,0.068726628,0.179713096,0.0,332,249,581
194,URI,0.081465894,0.148679731,0.0,269,313,582
195,MPLX,0.118908359,0.110660173,0.091864546,163,420,583
196,AAPL,0.040913478,0.600871346,0.006083955,571,12,583
197,ODFL,0.043198118,0.42717804,0.004218435,548,36,584
198,MAN,0.086058401,0.138216984,0.032208588,245,340,585
199,GOOGL,0.051741036,0.25287535,0.0,459,127,586
200,GOOG,0.051741036,0.25287535,0.0,459,127,586
201,BDC,0.080782425,0.14407976,0.00283874,271,320,591
202,CARR,0.101580184,0.120325122,0.014630536,207,386,593
203,PKG,0.084903262,0.137255727,0.034652205,253,343,596
204,ORLY,0.039988479,0.530985798,0.0,583,15,598
205,RH,0.072342981,0.163261454,0.0,320,284,604
206,PAYX,0.041168718,0.428833579,0.031062251,569,35,604
207,OTIS,0.038096454,0.68313172,0.01413795,598,7,605
208,ITW,0.043776634,0.345739828,0.022249034,542,68,610
209,ABEV,0.062970357,0.181567807,0.053320468,366,244,610
210,HI,0.079344461,0.138688748,0.023548859,275,336,611
211,TEL,0.068113699,0.170650155,0.019216591,339,273,612
212,RDN,0.206817747,0.075092298,0.037702912,62,550,612
213,NOC,0.057930552,0.19715245,0.012447496,400,216,616
214,ADP,0.037524557,0.545030109,0.020935447,603,14,617
215,VZ,0.12838943,0.092461814,0.065263822,139,479,618
216,DPZ,0.036546782,0.720650338,0.012729874,614,4,618
217,NSP,0.041421624,0.364837853,0.017689239,566,56,622
218,IPG,0.071927744,0.155859983,0.035066692,322,302,624
219,EME,0.054915342,0.203846869,0.003676194,427,197,624
220,DECK,0.043376206,0.317050567,0.0,547,77,624
221,INFY,0.041353766,0.362799962,0.023541543,568,57,625
222,MMP,0.098573575,0.114032826,0.082747018,214,413,627
223,IP,0.111551074,0.102217529,0.049916139,176,452,628
224,LAZ,0.107793788,0.104821865,0.054838047,189,440,629
225,FAST,0.040029882,0.386719166,0.026196757,581,48,629
226,ABC,0.060215119,0.180878951,0.013883448,385,246,631
227,LW,0.063791749,0.170962865,0.009237758,359,272,631
228,NOK,0.174196563,0.076833836,0.014468562,89,545,634
229,GIB,0.059558268,0.181351367,0.0,389,245,634
230,EMR,0.074426189,0.13902133,0.028171844,302,335,637
231,MCHP,0.048526959,0.235139642,0.015078337,487,151,638
232,TREX,0.039043605,0.38366148,0.0,589,50,639
233,SUN,0.131584167,0.087942478,0.099449929,136,503,639
234,INGR,0.075891189,0.134178553,0.02791932,294,347,641
235,SON,0.078405508,0.127066274,0.03144931,279,368,647
236,UGI,0.158087971,0.079175203,0.043610475,108,539,647
237,DE,0.059165073,0.179052807,0.010893807,395,252,647
238,HES,0.051195243,0.212196,0.010708857,464,184,648
239,TRQ,0.158565065,0.077785186,0.0,105,543,648
240,BERY,0.126052813,0.087929204,0.003620316,146,504,650
241,REGN,0.056144834,0.186825361,0.0,415,235,650
242,ALV,0.063417169,0.161717791,0.033582614,362,288,650
243,VRTX,0.044918261,0.274002405,0.0,533,119,652
244,DVA,0.110631162,0.093585039,0.0,179,474,653
245,BBDO,0.127271583,0.086289367,0.0,143,512,655
246,BBD,0.127271583,0.086289367,0.0,143,512,655
247,DCI,0.04688545,0.238419145,0.014948984,511,144,655
248,AVY,0.050886532,0.210340342,0.01605705,467,189,656
249,YUM,0.034831976,0.523080603,0.017061096,641,17,658
250,FCX,0.063333212,0.157258425,0.015815041,363,298,661
251,BHP,0.042691135,0.278798342,0.043837628,552,112,664
252,PBA,0.117529171,0.088178328,0.065311566,165,500,665
253,JHX,0.053131792,0.196044212,0.013448985,445,220,665
254,AMX,0.064265907,0.151317184,0.001278857,357,309,666
255,FICO,0.034814181,0.488408257,0.0,643,23,666
256,WTS,0.050884418,0.202937766,0.007991787,468,199,667
257,AON,0.040746219,0.295934828,0.00728679,573,95,668
258,CRH,0.088954417,0.107275683,0.030391654,237,436,673
259,CSX,0.062955924,0.15270911,0.012875287,367,307,674
260,WPP,0.076519957,0.122204027,0.040955606,292,382,674
261,WWE,0.038338428,0.306900661,0.006997351,596,81,677
262,ACN,0.037677599,0.314970221,0.013462718,601,78,679
263,V,0.040322624,0.291006682,0.008634978,579,100,679
264,GM,0.204362083,0.059671187,0.008167077,65,615,680
265,CCK,0.073169009,0.128845597,0.010668384,314,366,680
266,MXL,0.047195163,0.214846371,0.0,505,176,681
267,MAR,0.048819961,0.201934081,0.006645974,482,201,683
268,ITT,0.054259921,0.180360721,0.012995769,435,248,683
269,DAR,0.073205392,0.12651552,0.0,313,371,684
270,BKNG,0.038056958,0.302125896,0.0,599,87,686
271,KMB,0.042225184,0.252068447,0.034015945,556,130,686
272,GGG,0.040536492,0.280875319,0.012506917,576,110,686
273,SYY,0.047019831,0.212772935,0.026456365,509,182,691
274,ITUB,0.120016312,0.080460864,0.027096808,159,534,693
275,VRSN,0.030396568,1.529764801,0.0,693,1,694
276,WRK,0.120202341,0.079860587,0.033021922,158,537,695
277,CE,0.170926602,0.06206089,0.026803168,93,602,695
278,FBHS,0.052109017,0.1827966,0.009647319,456,239,695
279,EPD,0.104851334,0.088945794,0.078208782,199,498,697
280,LMT,0.044680923,0.225664315,0.023509711,536,162,698
281,TSCO,0.043466311,0.234706429,0.016353206,546,153,699
282,DOV,0.055142446,0.169800369,0.014883258,425,274,699
283,RL,0.066176628,0.132968278,0.025105845,350,352,702
284,CDW,0.046160506,0.212013098,0.011704764,519,186,705
285,HUN,0.08328083,0.103083295,0.030958743,261,447,708
286,AWI,0.061682098,0.140910602,0.013436909,379,329,708
287,PKX,0.151266668,0.064479445,0.058619264,116,595,711
288,GNRC,0.062880449,0.135569388,4.86e-05,368,344,712
289,SYF,0.191056043,0.055962915,0.030153407,77,636,713
290,UNP,0.054272258,0.16547915,0.024499294,434,280,714
291,WIT,0.056211344,0.153739418,0.016251269,412,303,715
292,WAT,0.0344412,0.349957687,0.0,650,66,716
293,WBA,0.143107618,0.064923528,0.054741881,125,593,718
294,CHTR,0.092303292,0.090307871,0.0,230,489,719
295,FOX,0.073375458,0.114069491,0.017707233,310,411,721
296,FOXA,0.073375458,0.114069491,0.017707233,310,411,721
297,CPB,0.062626914,0.133387556,0.032627309,373,351,724
298,BIIB,0.075724822,0.109025295,0.0,295,429,724
299,FN,0.052273998,0.16805329,0.0,450,275,725
300,MA,0.02950066,0.499490897,0.00565355,706,19,725
301,GPC,0.048182823,0.186904157,0.020203484,492,234,726
302,CLH,0.066539874,0.124226042,0.0,349,378,727
303,MRK,0.05168276,0.173219816,0.024960363,462,265,727
304,DISH,0.309457842,0.043915079,0.0,19,709,728
305,TJX,0.036163432,0.281423188,0.013843006,622,108,730
306,CAJ,0.083278526,0.094740544,0.040733123,262,469,731
307,ANET,0.036365364,0.27857346,0.0,619,113,732
308,ALLE,0.049444665,0.178367198,0.015535125,478,254,732
309,LEG,0.070522103,0.114983404,0.052174519,328,406,734
310,TTC,0.040116425,0.230968731,0.011374956,580,157,737
311,ASGN,0.062436015,0.130256378,0.0,375,362,737
312,UAA,0.101022438,0.081084409,0.0,208,530,738
313,BSMX,0.166214373,0.055787405,0.112236764,99,639,738
314,BEN,0.122841268,0.067131136,0.055444495,155,583,738
315,UA,0.101022438,0.081084409,0.0,208,530,738
316,MOH,0.041494828,0.214874519,0.0,564,175,739
317,VRSK,0.034241846,0.303000926,0.007007033,656,86,742
318,FL,0.083261712,0.092266158,0.036518295,263,480,743
319,CIB,0.203965368,0.049092188,0.069476898,66,678,744
320,ABM,0.077144037,0.099212106,0.017377498,287,459,746
321,DFS,0.146235193,0.057791655,0.023406954,121,626,747
322,JLL,0.084758333,0.089664931,0.0,256,493,749
323,EMN,0.071861475,0.10984583,0.034526131,323,426,749
324,KR,0.062342079,0.125456093,0.018947102,376,373,749
325,TT,0.045666556,0.19515442,0.016124337,529,221,750
326,OKE,0.058576535,0.131633963,0.056854191,397,357,754
327,APH,0.041905803,0.204409451,0.010516654,559,196,755
328,STR,0.465213494,0.037708111,0.337300116,10,747,757
329,SBS,0.079888804,0.09140602,0.0,274,484,758
330,OGE,0.084117233,0.088312776,0.041610042,260,499,759
331,KT,0.144908686,0.055812719,0.054726789,122,638,760
332,CHE,0.032758155,0.300047082,0.002889291,671,91,762
333,MAIN,0.087789165,0.082590289,0.070554429,240,522,762
334,PG,0.040002636,0.213158111,0.024567237,582,180,762
335,CAT,0.051450024,0.156788066,0.018723051,463,300,763
336,TRGP,0.07155876,0.104830446,0.022727613,325,439,764
337,NSC,0.056516298,0.132713324,0.020169578,410,355,765
338,MTD,0.026096984,0.484308199,0.0,741,24,765
339,RBA,0.049895875,0.158612034,0.017984755,472,294,766
340,TPL,0.0246581,0.685228829,0.013660392,761,6,767
341,DEO,0.048326536,0.165387225,0.022791385,490,281,771
342,ZBRA,0.034586752,0.258995574,0.0,647,124,771
343,PFSI,0.158151085,0.049898788,0.018166652,106,669,775
344,PNR,0.064875112,0.110560137,0.01869763,355,421,776
345,ADBE,0.029628873,0.32032358,0.0,701,75,776
346,PAGP,0.481900752,0.032984473,0.06712633,9,768,777
347,BCH,0.158099717,0.049682287,0.06055378,107,672,779
348,FIX,0.059478538,0.119894776,0.004855317,393,387,780
349,CMI,0.059904123,0.118338807,0.023811262,386,395,781
350,QSR,0.074646073,0.092001939,0.048907785,301,481,782
351,KOF,0.068529062,0.103201294,0.041270812,336,446,782
352,IHG,0.035512911,0.23502994,0.022065355,633,152,785
353,DRI,0.049943968,0.144723691,0.029999951,471,317,788
354,CL,0.026810839,0.368873383,0.025398952,736,53,789
355,IT,0.029972321,0.297149267,0.0,698,92,790
356,AEL,0.285224769,0.033580254,0.017338592,26,765,791
357,LH,0.065385604,0.103878992,0.009978321,352,443,795
358,SNY,0.059171188,0.116458439,0.036700225,394,401,795
359,JWN,0.083077827,0.080799305,0.040352087,265,532,797
360,SBUX,0.033389227,0.245280614,0.023028351,665,137,802
361,CBRE,0.056648935,0.116554957,0.0,408,400,808
362,ROST,0.036847014,0.203505812,0.010510253,612,198,810
363,IDXX,0.019905971,0.594829652,0.0,797,13,810
364,TSLA,0.032636206,0.245483471,0.0,674,136,810
365,EW,0.032953263,0.240505633,0.0,670,142,812
366,WST,0.033460803,0.236942346,0.003089656,664,148,812
367,NLY,0.198971286,0.038039739,0.175205789,70,746,816
368,BWA,0.099589877,0.061216492,0.016985138,213,606,819
369,UNH,0.040500935,0.18173045,0.012059697,577,243,820
370,BSAC,0.125235167,0.049727329,0.073498973,151,670,821
371,MSFT,0.028537334,0.287573865,0.007808615,720,102,822
372,HSY,0.034357645,0.218113735,0.01618916,653,170,823
373,DGX,0.052129714,0.126528442,0.016807149,454,370,824
374,ZTS,0.030764316,0.245620003,0.008891673,689,135,824
375,VAC,0.064920304,0.094602717,0.018207111,354,470,824
376,MTCH,0.030873333,0.245227374,0.0,688,138,826
377,WF,0.375213339,0.021626208,0.078226693,14,814,828
378,DG,0.047045774,0.143488513,0.009614167,508,323,831
379,MPWR,0.026924629,0.293394264,0.008487306,734,98,832
380,CPA,0.10312339,0.057418073,0.0,203,629,832
381,AM,0.063223683,0.094822106,0.083985397,364,468,832
382,CNI,0.046329723,0.146091414,0.018140829,517,315,832
383,FMC,0.046846139,0.143711763,0.017014721,512,322,834
384,AIG,0.208692122,0.030272533,0.020532088,60,774,834
385,WD,0.084282491,0.06891134,0.031591153,257,577,834
386,JNJ,0.038687495,0.181773272,0.025190754,593,242,835
387,SLB,0.045456131,0.153003182,0.011202208,530,306,836
388,HII,0.062592781,0.097086159,0.020756155,374,463,837
389,KEYS,0.035856701,0.199372291,0.0,626,211,837
390,NJR,0.073922244,0.078816031,0.034337617,304,540,844
391,ABBV,0.041354061,0.165804863,0.035089459,567,278,845
392,MSCI,0.023177814,0.322294481,0.009928351,773,73,846
393,SAN,0.206335158,0.027787158,0.039698841,63,786,849
394,HAL,0.044191564,0.151144612,0.012228582,539,311,850
395,POST,0.151674342,0.039640602,0.109696272,115,736,851
396,ALLY,0.193341247,0.029674799,0.05572379,74,778,852
397,CPRT,0.029366562,0.23803728,0.0,708,146,854
398,JBHT,0.053588771,0.111276443,0.009217027,438,417,855
399,ORAN,0.087240725,0.0596924,0.075654702,243,614,857
400,BIP,0.100371341,0.055548675,0.103510227,212,645,857
401,CTAS,0.028089001,0.246390317,0.009375093,724,133,857
402,BXMT,0.068832676,0.08181218,0.116654169,331,527,858
403,HUM,0.042571458,0.153379449,0.00594726,554,304,858
404,COF,0.1873937,0.029387186,0.029993176,79,779,858
405,SHG,0.246940412,0.020593394,0.081969694,36,823,859
406,HMC,0.116160287,0.046468057,0.035665891,167,692,859
407,UHS,0.065582951,0.086664509,0.005673782,351,509,860
408,MMS,0.057017036,0.10126506,0.019222004,407,454,861
409,PFG,0.228337545,0.021310318,0.030480756,47,815,862
410,XPO,0.048062481,0.126837463,0.0,494,369,863
411,ABB,0.042787838,0.147530837,0.02935505,551,314,865
412,FTNT,0.021489318,0.307848616,0.0,789,80,869
413,WAL,0.17716414,0.028268226,0.027848936,86,784,870
414,SAIC,0.052122932,0.113425402,0.014420678,455,416,871
415,AAP,0.05331103,0.107421933,0.035715815,440,434,874
416,GIS,0.051805199,0.111097173,0.025721854,458,418,876
417,HSIC,0.049505637,0.11702961,0.0,477,399,876
418,MPW,0.135346589,0.038681939,0.104747002,133,744,877
419,MKTX,0.02394614,0.280877047,0.010138524,768,109,877
420,ROL,0.020490652,0.303018467,0.011763979,794,85,879
421,IVZ,0.11058434,0.045300312,0.068654294,181,699,880
422,LYG,0.174427459,0.026202722,0.047129603,88,792,880
423,UNM,0.159634532,0.029716534,0.030877414,104,777,881
424,GILD,0.042620433,0.141140679,0.03442491,553,328,881
425,BAP,0.113036974,0.043480462,0.029189968,172,711,883
426,MFG,0.583531265,0.011936418,0.220015784,5,880,885
427,DLTR,0.048130978,0.118971745,0.0,493,392,885
428,PEP,0.035738524,0.176019082,0.024756248,628,258,886
429,MSI,0.031575466,0.201235764,0.012278061,683,203,886
430,BMO,0.162582083,0.02816034,0.03116647,101,785,886
431,G,0.041423693,0.144068859,0.010764529,565,321,886
432,GD,0.048727869,0.116184748,0.01967801,483,403,886
433,TEF,0.104782096,0.046867417,0.07278995,200,687,887
434,MCD,0.031827528,0.200949961,0.021475621,681,206,887
435,HLT,0.036116147,0.172487644,0.00353967,623,266,889
436,SMFG,0.553914841,0.01186363,0.207311999,7,882,889
437,LDOS,0.047533035,0.119245945,0.013808867,499,390,889
438,JKHY,0.030049579,0.202471929,0.012067253,695,200,895
439,MMC,0.036936333,0.162849098,0.013781491,609,286,895
440,COST,0.024804196,0.242259388,0.006358091,759,140,899
441,RKT,0.829262414,0.008248278,0.0,4,896,900
442,STWD,0.168607637,0.023325668,0.114431472,96,805,901
443,TXT,0.057145219,0.088964588,0.001128303,405,497,902
444,PAA,0.125792114,0.035452934,0.094859627,148,754,902
445,CDNS,0.019486909,0.283341184,0.0,800,106,906
446,FDX,0.071739587,0.066778145,0.021258181,324,587,911
447,DB,0.245612064,0.012821305,0.018048597,37,877,914
448,BMY,0.040843505,0.137835313,0.029914462,572,342,914
449,SHW,0.032991383,0.179122603,0.010101069,667,250,917
450,BCO,0.067152585,0.069463971,0.014800335,346,573,919
451,ROK,0.036865381,0.152208895,0.020833292,611,308,919
452,HDB,1.329161067,-0.00066128,0.231774465,2,917,919
453,FCN,0.044017619,0.122932171,0.0,540,380,920
454,BCE,0.052882148,0.093536122,0.063576585,448,475,923
455,SXT,0.046124815,0.115095343,0.022561994,521,405,926
456,A,0.030314275,0.186943963,0.006043516,694,233,927
457,SPG,0.055419524,0.086644463,0.06715177,418,510,928
458,VMI,0.035599015,0.157373239,0.006501149,632,297,929
459,C,0.168598841,0.019226104,0.056820478,97,833,930
460,HBAN,0.156070211,0.020967054,0.070433831,111,820,931
461,K,0.039484885,0.134601136,0.032780681,586,346,932
462,BCS,0.225194144,0.010233871,0.075140691,49,888,937
463,FSS,0.042825105,0.119660664,0.007754047,550,388,938
464,NKE,0.031043081,0.178815208,0.012319266,685,253,938
465,ENS,0.049583891,0.096041063,0.00804878,474,465,939
466,CACI,0.048662906,0.101215712,0.0,485,455,940
467,VIV,0.063768569,0.068054245,0.089123714,360,580,940
468,SNV,0.138850116,0.021023274,0.042010522,130,817,947
469,NYCB,0.156287975,0.018880216,0.084155064,110,837,947
470,AMGN,0.046369322,0.107921673,0.029695616,516,432,948
471,CLX,0.007580539,0.30387289,0.029660766,865,84,949
472,IGT,0.060733287,0.070999647,0.035172875,382,568,950
473,MNST,0.022282257,0.217349252,0.0,780,171,951
474,NI,0.07203466,0.057338026,0.039112464,321,631,952
475,PAYC,0.015653909,0.248236616,0.0,821,131,952
476,HPE,0.046682202,0.106188695,0.033398212,514,438,952
477,LNC,0.258460596,-0.00758096,0.059000578,30,924,954
478,HON,0.033472659,0.16045067,0.018327056,663,291,954
479,RMD,0.027989492,0.188859995,0.008054109,727,229,956
480,BBVA,0.178183649,0.013953756,0.060643501,85,871,956
481,ABT,0.035651958,0.141851431,0.017016058,631,326,957
482,CI,0.059546173,0.071363131,0.012359314,391,566,957
483,KNX,0.090700938,0.040993138,0.009207852,233,725,958
484,KO,0.034659857,0.149358562,0.027663956,646,312,958
485,NEP,0.208795331,0.005752946,0.118460152,59,899,958
486,AFL,0.096740296,0.039059505,0.021437019,219,741,960
487,IX,0.105802051,0.033924569,0.041181727,197,763,960
488,SNX,0.066858885,0.06077754,0.011799599,348,612,960
489,SKX,0.057137932,0.074416806,0.0,406,555,961
490,MDU,0.059551241,0.070161045,0.028668049,390,571,961
491,KB,0.231506322,-0.001443785,0.075736364,44,918,962
492,FNF,0.109806196,0.028954207,0.047266928,184,781,965
493,BR,0.032347335,0.160468862,0.016979016,676,290,966
494,NGG,0.067343966,0.05838429,0.03987537,344,623,967
495,CMA,0.127622065,0.020463532,0.041690614,142,826,968
496,BNS,0.125680388,0.021014329,0.064868115,149,819,968
497,IEX,0.033955119,0.151238854,0.010263483,658,310,968
498,AXP,0.067717944,0.057561335,0.01410415,342,627,969
499,NDAQ,0.037180471,0.1299759,0.012657885,606,364,970
500,LLY,0.018929883,0.220307496,0.010718082,805,167,972
501,ACM,0.043081642,0.110303283,0.006575849,549,424,973
502,ORI,0.09421456,0.036721861,0.079569027,225,750,975
503,NYT,0.031903465,0.157707198,0.010418319,680,296,976
504,RCI,0.052462201,0.0817681,0.031539776,449,528,977
505,WRB,0.06859673,0.054552734,0.011681881,334,650,984
506,SSL,0.060312332,0.062362351,0.0,384,600,984
507,VC,0.033729354,0.143462898,0.0,662,324,986
508,HST,0.055182947,0.071520856,0.013076528,422,565,987
509,SF,0.104219627,0.027246363,0.026918885,201,788,989
510,R,0.224136618,-0.030978436,0.031797928,51,938,989
511,MFC,0.155712379,0.01189482,0.060416316,112,881,993
512,SIVB,0.123165154,0.018441473,0.012007129,152,841,993
513,NFLX,0.034254837,0.138522023,0.0,655,338,993
514,GS,0.094617922,0.031319375,0.030937145,223,772,995
515,SR,0.068123758,0.052806561,0.048346888,338,657,995
516,CW,0.045919565,0.094532372,0.004489649,525,471,996
517,CMG,0.023266863,0.193219389,0.0,772,224,996
518,CRL,0.043915179,0.099977961,0.0,541,457,998
519,BRO,0.042491096,0.103861617,0.00755833,555,444,999
520,TD,0.110468621,0.021021395,0.042244154,182,818,1000
521,RF,0.111366861,0.02056436,0.037800244,177,824,1001
522,ABMD,0.00906817,0.242806215,0.0,862,139,1001
523,AFG,0.076866925,0.043459491,0.103830267,289,713,1002
524,CM,0.111346919,0.020522112,0.053203062,178,825,1003
525,VTRS,0.15407682,0.009677419,0.043111267,113,891,1004
526,APD,0.043666964,0.098572079,0.026773863,544,460,1004
527,VAL,0.034755985,0.13035358,0.0,645,361,1006
528,FFIV,0.036930317,0.117509734,0.0,610,397,1007
529,BUD,0.049387509,0.081300403,0.020205109,479,529,1008
530,KEY,0.119050551,0.017481171,0.053035561,162,847,1009
531,HSBC,0.129629214,0.013885624,0.056346468,137,872,1009
532,EXR,0.043624201,0.095635187,0.040817403,545,467,1012
533,DHR,0.037457904,0.114374482,0.004250321,604,408,1012
534,SKM,0.053615163,0.069301407,0.053122731,437,576,1013
535,CHT,0.041834453,0.10234824,0.040996273,562,451,1013
536,SJR,0.04542356,0.091719298,0.035197313,531,482,1013
537,UBS,0.125308543,0.015671089,0.027397385,150,863,1013
538,FITB,0.108258439,0.020041747,0.041028444,188,828,1016
539,ZION,0.122947271,0.01514465,0.036463965,154,865,1019
540,EPR,0.062321165,0.055655237,0.093947664,377,642,1019
541,HIG,0.073691866,0.042656702,0.021397032,307,716,1023
542,TFC,0.109538218,0.01877093,0.052301874,185,838,1023
543,FLO,0.037639151,0.110317405,0.030735218,602,423,1025
544,WNS,0.030589245,0.139346993,0.0,691,334,1025
545,WM,0.034558335,0.124754384,0.01663062,648,377,1025
546,BX,0.054393382,0.061348122,0.118631502,429,605,1034
547,MCO,0.026815921,0.157257391,0.010051091,735,299,1034
548,VLY,0.103610772,0.019340075,0.039915167,202,832,1034
549,CFG,0.110627628,0.016332201,0.047602433,180,856,1036
550,EPAM,0.022337221,0.175666561,0.0,779,260,1039
551,WMB,0.051117513,0.069310796,0.051666359,465,575,1040
552,ASB,0.106302553,0.017586651,0.039091496,196,845,1041
553,WMT,0.029803378,0.135285664,0.015600844,700,345,1045
554,TGT,0.035701228,0.113728388,0.023578221,630,415,1045
555,FUL,0.041893492,0.091393937,0.009109261,560,485,1045
556,BP,-0.01227594,0.236718808,0.039424131,898,149,1047
557,SCI,0.051845529,0.064998373,0.014676352,457,591,1048
558,SNPS,0.021996824,0.174911208,0.0,785,263,1048
559,BMI,0.02087368,0.177164196,0.007810365,793,255,1048
560,RY,0.08935283,0.021705291,0.03937544,236,813,1049
561,JBT,0.044721066,0.085791431,0.004482372,535,515,1050
562,AME,0.036050185,0.109732217,0.006285438,624,427,1051
563,SEM,0.052267163,0.061946882,0.021232775,451,603,1054
564,ADSK,0.017708613,0.181868334,0.0,813,241,1054
565,J,0.046138347,0.080445598,0.008306405,520,535,1055
566,ST,0.049558023,0.067151161,0.008146603,475,582,1057
567,CME,0.044611198,0.082654118,0.043657967,537,521,1058
568,OHI,0.067070352,0.043025641,0.099427669,347,715,1062
569,PPG,0.034371081,0.113961181,0.019095045,652,414,1066
570,MLM,0.04116733,0.089068497,0.007556209,570,496,1066
571,AEM,0.052898892,0.058894193,0.048010166,446,620,1066
572,AIN,0.030044714,0.126505742,0.008303224,696,372,1068
573,BAC,0.097860598,0.016890151,0.030487231,217,853,1070
574,ATR,0.033267194,0.115410972,0.01382764,666,404,1070
575,FNB,0.096144152,0.016950606,0.039192554,221,852,1073
576,CBOE,0.017619545,0.175688647,0.01570014,814,259,1073
577,MGA,0.036286356,0.101661604,0.031505384,620,453,1073
578,OUT,0.055371732,0.052901589,0.077048698,419,656,1075
579,TDG,0.028352054,0.132785804,0.03571835,722,354,1076
580,AKAM,0.039047356,0.090356217,0.0,588,488,1076
581,MS,0.076713435,0.027328507,0.037567256,290,787,1077
582,STT,0.097762284,0.016069534,0.034255566,218,859,1077
583,ALGN,0.021926444,0.159767632,0.0,786,293,1079
584,RJF,0.072749825,0.033752967,0.013354342,316,764,1080
585,OGS,0.055115407,0.05312862,0.033295132,426,655,1081
586,TU,0.048453545,0.064547143,0.035642608,488,594,1082
587,CMCSA,0.036387642,0.096269203,0.032125477,618,464,1082
588,NVS,0.03515106,0.103573319,0.037935853,638,445,1083
589,CVS,0.035259397,0.102504746,0.023776169,635,450,1085
590,PNC,0.089575415,0.017078112,0.039916738,234,851,1085
591,ENPH,0.011080286,0.183258308,0.0,848,238,1086
592,CNA,0.077852538,0.023642913,0.085515875,283,803,1086
593,PRI,0.068285791,0.036007723,0.015547806,337,752,1089
594,ORCL,0.028978667,0.123753302,0.012500735,712,379,1091
595,EDR,0.085976259,0.017702909,0.0,247,844,1091
596,JNPR,0.045753404,0.071621733,0.026266922,527,564,1091
597,GLW,0.049761177,0.059118566,0.035241198,473,619,1092
598,RSG,0.036434704,0.093197883,0.014521468,616,476,1092
599,USB,0.08851576,0.016322529,0.046727204,238,857,1095
600,ATO,0.055164468,0.04954076,0.026778344,423,674,1097
601,TRI,0.032965801,0.109036861,0.014622351,669,428,1097
602,GL,0.062659206,0.040845453,0.006823014,372,726,1098
603,PB,0.07786526,0.021090274,0.02867195,282,816,1098
604,IBN,0.055155167,0.049540448,0.005638325,424,675,1099
605,CUZ,0.073661919,0.025717791,0.050647229,308,795,1103
606,LEA,0.044725737,0.070894609,0.025317742,534,569,1103
607,CNP,0.056033516,0.046839949,0.02592279,416,688,1104
608,TDY,0.042135549,0.075756395,0.0,557,548,1105
609,JPM,0.094597479,0.011238945,0.034051678,224,883,1107
610,VFC,0.013348567,0.172116692,0.079116802,838,269,1107
611,FNV,0.02680602,0.124790925,0.007560476,737,376,1113
612,SLF,0.088143695,0.013230159,0.045375266,239,876,1115
613,FDS,0.024190477,0.132964096,0.007675165,764,353,1117
614,PYPL,0.029432564,0.114142075,0.0,707,410,1117
615,NWE,0.060996271,0.039286611,0.046684479,380,738,1118
616,TMO,0.032195231,0.104682199,0.002107745,678,442,1120
617,MTB,0.084129801,0.015398954,0.037214981,259,864,1123
618,PH,0.041601648,0.072617688,0.014061789,563,561,1124
619,TRV,0.063958404,0.03319833,0.019556599,358,766,1124
620,ESI,0.041988449,0.071348672,0.017584906,558,567,1125
621,EA,0.024037417,0.130921958,0.006294087,766,360,1126
622,EFX,0.02926481,0.11077659,0.0080329,709,419,1128
623,DAL,0.062867642,0.034855614,0.0,369,759,1128
624,TRMB,0.035777888,0.087981539,0.0,627,502,1129
625,PENN,0.046390288,0.059595923,0.0,515,616,1131
626,CB,0.057373682,0.040726435,0.014848261,403,728,1131
627,TR,0.025924269,0.119265166,0.008408138,742,389,1131
628,CX,0.093703336,0.003588345,0.0,226,906,1132
629,NWL,0.036230845,0.086606441,0.070806473,621,511,1132
630,EVRG,0.052231043,0.048745773,0.037110618,452,680,1132
631,COTY,0.048705173,0.05478196,0.001312989,484,649,1133
632,BXP,0.055299487,0.043381813,0.06492677,420,714,1134
633,LNT,0.049522859,0.052134831,0.030897644,476,659,1135
634,ING,0.082893713,0.014335602,0.069785044,266,869,1135
635,WBS,0.081275206,0.014709097,0.032986772,270,866,1136
636,BLK,0.048416387,0.054885072,0.027957705,489,648,1137
637,BK,0.069691573,0.022293827,0.037269959,329,809,1138
638,GMED,0.025485562,0.118915115,0.0,747,393,1140
639,STN,0.034345457,0.090409861,0.010873744,654,487,1141
640,BABA,0.039533616,0.07337246,0.012378867,585,558,1143
641,POR,0.053254587,0.044293205,0.036112552,442,704,1146
642,ENLC,0.085072763,0.008308041,0.037617555,252,895,1147
643,MTN,0.036037226,0.082301264,0.0233865,625,524,1149
644,ETN,0.03934418,0.072482987,0.020758769,587,562,1149
645,FLS,0.047081284,0.055594065,0.026086848,506,644,1150
646,IRM,0.03842049,0.073815277,0.049968206,594,557,1151
647,PTC,0.025539927,0.114855161,0.0,745,407,1152
648,KMI,0.062690927,0.028742003,0.061608352,371,782,1153
649,HWM,0.028604071,0.10475322,0.002683538,717,441,1158
650,AJG,0.029157254,0.102815544,0.011239491,710,449,1159
651,WEC,0.047656722,0.051640988,0.031039598,498,662,1160
652,NMR,0.060967007,0.028670441,0.03762521,381,783,1164
653,FRC,0.075468825,0.014708239,0.015773664,297,867,1164
654,FHN,0.068662979,0.01898047,0.027160023,333,836,1169
655,WFC,0.078597222,0.009569527,0.031559331,277,892,1169
656,PNW,0.05618429,0.034917312,0.044017932,413,757,1170
657,CFR,0.068053051,0.019506766,0.025434556,340,831,1171
658,IPGP,0.022871293,0.118813076,0.0,777,394,1171
659,TECH,0.022233157,0.119092512,0.00391917,781,391,1172
660,ATI,0.034382675,0.082517161,0.008930565,651,523,1174
661,SAM,0.016572557,0.132603538,0.0,818,356,1174
662,SRC,0.053143924,0.040304288,0.06678728,444,731,1175
663,ES,0.048320126,0.04734175,0.029839112,491,684,1175
664,INTU,0.01658,0.130929554,0.006182726,817,359,1176
665,INCY,0.019104543,0.125301094,0.0,802,374,1176
666,FISV,0.038972686,0.06514431,0.053314018,590,589,1179
667,ED,0.049283674,0.045453758,0.032331277,481,698,1179
668,BOH,0.073516818,0.013316083,0.039210663,309,875,1184
669,CP,0.037450214,0.068253607,0.007528377,605,579,1184
670,NTRS,0.072477556,0.014592674,0.04322071,318,868,1186
671,VMW,0.025375708,0.107290672,0.043451555,751,435,1186
672,WTW,0.036834282,0.069334903,0.013470614,613,574,1187
673,VEEV,0.018979777,0.120893179,0.0,804,385,1189
674,AVB,0.050118663,0.041523984,0.039240099,469,720,1189
675,IDA,0.047402516,0.046775177,0.028239769,501,689,1190
676,AOS,0.027237564,0.097201952,0.020477286,731,462,1193
677,DTE,0.047254711,0.046600906,0.029888714,504,690,1194
678,MKC,0.029852999,0.089099819,0.01736464,699,495,1194
679,BKH,0.056640437,0.025918376,0.03435317,409,793,1202
680,APTV,0.034444602,0.074137121,0.002497135,649,556,1205
681,RHP,0.028644642,0.089843225,0.001300182,715,490,1205
682,EXC,0.050909354,0.039120583,0.031296349,466,740,1206
683,KHC,0.047344785,0.044597165,0.039270325,503,703,1206
684,AEP,0.047473844,0.044139566,0.033852275,500,706,1206
685,HAE,0.027461434,0.092710734,0.0,729,478,1207
686,IQV,0.02838384,0.091047118,0.0,721,486,1207
687,CPT,0.054291991,0.029984123,0.032961793,433,775,1208
688,PCG,0.056146007,0.025569729,0.0,414,797,1211
689,UNF,0.037146654,0.061509632,0.007468919,607,604,1211
690,AXTA,0.033931329,0.07469905,0.0,659,554,1213
691,ATHM,0.073842062,0.001611784,0.016010864,305,909,1214
692,FTV,0.032980038,0.075010446,0.004345225,668,551,1219
693,L,0.071447362,0.009324143,0.00430661,326,893,1219
694,WEX,0.027724389,0.089747366,0.0,728,492,1220
695,HHC,0.047803957,0.040791981,0.0,495,727,1222
696,DUK,0.049317611,0.038817226,0.04008711,480,743,1223
697,AEE,0.046742541,0.043864729,0.026548371,513,710,1223
698,SYK,0.025501233,0.092900821,0.011366326,746,477,1223
699,SO,0.046049182,0.045062811,0.03786845,524,700,1224
700,WAB,0.034808177,0.067180544,0.006103804,644,581,1225
701,KBR,0.02588838,0.091588785,0.008992806,743,483,1226
702,FMS,0.074981721,-0.008821764,0.044070534,300,926,1226
703,TFX,0.031018572,0.07873937,0.005448723,686,541,1227
704,PVH,0.034959637,0.065138654,0.001761938,639,590,1229
705,ANSS,0.024902225,0.094463206,0.0,757,472,1229
706,LYV,0.026099458,0.089747553,0.0,740,491,1231
707,AA,0.007168833,0.129467697,0.008748407,867,365,1232
708,INTC,0.073811111,-0.012871129,0.055233994,306,929,1235
709,ETR,0.047700273,0.039267511,0.03739005,497,739,1236
710,STZ,-0.000893855,0.13104545,0.013644637,880,358,1238
711,XEL,0.045267074,0.04405734,0.02638841,532,707,1239
712,NVDA,0.009165708,0.122013923,0.000835154,860,383,1243
713,TRNO,0.046118652,0.041321065,0.025016668,522,723,1245
714,KMX,0.04421578,0.044030824,0.0,538,708,1246
715,RTX,0.034900871,0.060985386,0.021006335,640,607,1247
716,BAH,0.022186906,0.096022046,0.01924284,782,466,1248
717,HE,0.052898765,0.024059335,0.033764026,447,801,1248
718,H,0.04610819,0.040221607,0.0,523,732,1255
719,FR,0.04185371,0.045909291,0.024379429,561,694,1255
720,VOYA,0.065102288,0.004853875,0.015190534,353,903,1256
721,TDC,0.009499924,0.116256158,0.0,857,402,1259
722,CBU,0.055284414,0.018657856,0.027450118,421,839,1260
723,EBAY,-0.055055561,0.141745582,0.021132001,934,327,1261
724,PNM,0.040471765,0.047061034,0.028520245,578,686,1264
725,ISRG,0.013966451,0.109002394,0.0,834,430,1264
726,LIN,0.025441111,0.084980769,0.014380025,749,518,1267
727,OSK,0.030013518,0.070239982,0.016793072,697,570,1267
728,LHX,0.025338398,0.085483638,0.02061429,752,516,1268
729,WPC,0.038402945,0.049611723,0.053537374,595,673,1268
730,MDT,0.031071895,0.06697437,0.029897811,684,585,1269
731,OFC,0.059517945,0.012077906,0.042531,392,878,1270
732,XYL,0.017815388,0.097767997,0.01088997,812,461,1273
733,PWR,0.024022499,0.08670169,0.002008017,767,507,1274
734,AMRC,0.032045834,0.06441061,0.0,679,596,1275
735,EXPE,0.025647626,0.080126124,0.004881792,744,536,1280
736,UAL,0.06037189,0.006903686,0.0,383,897,1280
737,PEAK,0.037048502,0.048778462,0.047975259,608,679,1287
738,DXCM,0.007737724,0.110122734,0.0,864,425,1289
739,SJI,0.034820965,0.054953652,0.052705591,642,647,1289
740,PKI,0.032703896,0.059130452,0.001995733,672,618,1290
741,ARES,0.036539835,0.049264722,0.06962761,615,677,1292
742,MDLZ,0.029582867,0.06492743,0.021612805,703,592,1295
743,DD,0.03101246,0.060928845,0.01905761,687,609,1296
744,CNC,0.025481534,0.075114655,0.0,748,549,1297
745,GHC,0.023018733,0.082229825,0.010539086,774,525,1299
746,SBAC,0.015248091,0.093586375,0.010137196,826,473,1299
747,WCN,0.024492737,0.079515631,0.007122561,762,538,1300
748,CCI,0.028585335,0.067007461,0.044405398,718,584,1302
749,CHD,0.021138735,0.083470636,0.013023381,791,520,1311
750,WTM,-0.047733659,0.122509876,0.000750529,932,381,1313
751,AU,0.036396047,0.045612089,0.024876759,617,697,1314
752,RGA,0.054387727,0.011149859,0.021565733,430,884,1314
753,RZA,0.054387727,0.011149859,0.021565733,430,884,1314
754,IR,0.028554665,0.062427913,0.001529967,719,599,1318
755,AWR,0.022921565,0.077318341,0.01647747,776,544,1320
756,CAG,0.028241145,0.06242938,0.037387152,723,598,1321
757,HXL,0.025428131,0.069870389,0.006784862,750,572,1322
758,VMC,0.024714862,0.071652357,0.009128526,760,563,1323
759,SCHW,0.045767596,0.025002058,0.013444192,526,798,1324
760,APO,0.053469873,0.011076198,0.025792259,439,886,1325
761,SPGI,0.030600376,0.055857309,0.009647409,690,637,1327
762,PSO,0.035198626,0.046364414,0.022690024,636,693,1329
763,ELS,0.015186827,0.086668654,0.02591042,827,508,1335
764,ENB,0.028015543,0.060863616,0.068159026,725,611,1336
765,EL,0.014313275,0.087860262,0.013160815,832,505,1337
766,PBH,-0.026341729,0.108194327,0.0,911,431,1342
767,PEG,0.033789475,0.048004187,0.035362603,660,683,1343
768,SAP,0.01515802,0.085398845,0.025337063,828,517,1345
769,REG,0.032322267,0.050053206,0.040494052,677,668,1345
770,ASH,0.035293796,0.043462898,0.013649535,634,712,1346
771,CTVA,0.02707192,0.05860576,0.009865791,732,622,1354
772,AXS,0.048527078,0.014023562,0.039066296,486,870,1356
773,RE,0.046209111,0.018595487,0.01973756,518,840,1358
774,KRC,0.038790897,0.032439987,0.054806491,592,769,1361
775,FAF,0.046961099,0.016817127,0.038747371,510,854,1364
776,FRT,0.03260085,0.046536099,0.044443651,675,691,1366
777,PPL,0.035151822,0.040354793,0.036593232,637,730,1367
778,AWK,0.029559733,0.05096893,0.016834628,704,664,1368
779,BURL,0.015634245,0.076533985,0.0,822,546,1368
780,SWX,-0.399947836,0.117238993,0.039579424,971,398,1369
781,PLD,0.03799129,0.031492168,0.029031183,600,771,1371
782,CUBE,0.022001575,0.065383337,0.042758307,784,588,1372
783,SJM,-0.005515944,0.089659892,0.025990792,887,494,1381
784,EGP,0.029518925,0.049489537,0.030748312,705,676,1381
785,WHR,-0.188678911,0.110515501,0.049319555,959,422,1381
786,NNN,0.023364909,0.060650559,0.047620566,771,613,1384
787,HAS,0.025205212,0.057372435,0.047722694,754,630,1384
788,ESS,0.029618721,0.04831078,0.041051505,702,682,1384
789,ROP,0.021539247,0.063287986,0.005732289,788,597,1385
790,COO,0.028624155,0.049705741,0.000222583,716,671,1387
791,TRP,0.013931142,0.074701614,0.061423671,835,553,1388
792,EBR,0.039745458,0.023305989,0.0,584,806,1390
793,BDX,0.028012367,0.050572879,0.017037314,726,665,1391
794,MHK,0.003869691,0.084306752,0.0,875,519,1394
795,RYN,0.030547613,0.04488238,0.047261806,692,702,1394
796,ICE,0.025214564,0.055726526,0.014874151,753,641,1394
797,GLOB,0.021200348,0.060886047,0.0,790,610,1400
798,CAE,0.022927914,0.057876871,0.0,775,625,1400
799,CAH,0.010574178,0.074863557,0.021269898,850,552,1402
800,ALE,0.03884243,0.021894476,0.043161543,591,812,1403
801,EDU,0.028890584,0.045888426,0.0,713,695,1408
802,BRX,0.023790536,0.055779683,0.042595481,770,640,1410
803,TM,0.009509413,0.072885925,0.002824057,856,560,1416
804,FE,0.016953583,0.06223013,0.037206016,815,601,1416
805,CALX,0.009471033,0.073129065,0.0,858,559,1417
806,ARMK,0.024225116,0.053266845,0.014090337,763,654,1417
807,RPM,0.047051424,9.05e-05,0.021025806,507,910,1417
808,SRE,0.032670095,0.038674918,0.06118897,673,745,1418
809,CCZ,0.019182132,0.059397179,0.018465479,801,617,1418
810,CMS,0.045731782,0.010004409,0.029832202,528,890,1418
811,STOR,0.028880643,0.044142421,0.042834828,714,705,1419
812,TAP,-0.016689504,0.081928075,0.029468384,902,526,1428
813,T,-0.052104944,0.088012,0.074731255,933,501,1434
814,ECL,0.026297335,0.0457172,0.014520503,739,696,1435
815,AIZ,0.040678243,0.015862685,0.022089198,574,862,1436
816,CIEN,0.020957577,0.055300395,0.0,792,646,1438
817,PHI,0.038247415,0.017798812,0.092052791,597,843,1440
818,AES,-0.022963657,0.080540914,0.022328717,909,533,1442
819,BFAM,0.021904042,0.052309071,0.0,787,658,1445
820,MET,0.043679779,0.004659406,0.030673905,543,904,1447
821,NCR,0.018749139,0.055612419,0.00499977,806,643,1449
822,DV,0.012022734,0.060967775,0.0,845,608,1453
823,FLR,0.014893886,0.057878704,0.007957008,830,624,1454
824,SNN,0.018594273,0.054538844,0.027266042,807,651,1458
825,PDI,0.035733333,0.020032248,0.153051757,629,829,1458
826,LUV,0.026995474,0.04069465,0.0,733,729,1462
827,CWT,0.029147549,0.035898858,0.016450085,711,753,1464
828,EIX,0.033994493,0.021907407,0.047402515,657,810,1467
829,AZN,0.015663945,0.053526143,0.020789981,820,653,1473
830,LUMN,-0.294339177,0.086786993,0.148310438,967,506,1473
831,F,-0.046098329,0.077984882,0.043035104,931,542,1473
832,TEVA,-0.232436384,0.085963672,0.0,962,514,1476
833,TYL,0.012262023,0.056415135,0.0,844,634,1478
834,NE,0.01786417,0.050083564,0.0,811,667,1478
835,BSX,0.010545521,0.057522587,0.000830951,851,628,1479
836,SWH,0.015300259,0.051996392,0.042369949,824,660,1484
837,SWK,0.015300259,0.051996392,0.042369949,824,660,1484
838,ZBH,0.008658883,0.056880018,0.007528813,863,633,1496
839,ADC,0.027321854,0.033007564,0.040819052,730,767,1497
840,RBC,0.02489578,0.039025131,0.003420837,758,742,1500
841,PANW,0.00580172,0.057262405,0.0,870,632,1502
842,ADT,0.025097197,0.036813042,0.018423954,756,749,1505
843,SMG,-0.184394921,0.075939872,0.070048996,958,547,1505
844,KWR,-0.00598003,0.058633407,0.01010933,889,621,1510
845,BAK,-0.041738787,0.066894241,0.068717822,925,586,1511
846,HIW,0.019914271,0.042059341,0.072305466,796,718,1514
847,LXP,0.040571938,-0.035721531,0.050797736,575,940,1515
848,AER,-0.09817252,0.068646643,0.0,948,578,1526
849,FMX,0.009094439,0.050240494,0.006430797,861,666,1527
850,AGO,0.033749285,0.012052485,0.017418986,661,879,1540
851,AMT,0.018059385,0.039948983,0.026901918,809,734,1543
852,DIS,0.018298793,0.039637255,0.0,808,737,1545
853,NOW,0.00416441,0.04867014,0.0,874,681,1555
854,EQIX,0.011742911,0.042164557,0.019197241,846,717,1563
855,NOV,0.019025175,0.034294622,0.009573959,803,762,1565
856,O,0.022404936,0.027129551,0.046732726,778,789,1567
857,BKR,-0.01983112,0.05128538,0.025492253,905,663,1568
858,STAG,0.018044469,0.034868305,0.046198003,810,758,1568
859,CZR,-0.058860532,0.05635309,0.0,936,635,1571
860,NEE,0.019540891,0.030860557,0.02017901,799,773,1572
861,GPN,0.001990468,0.044998931,0.009462393,876,701,1577
862,HASI,0.016366606,0.034545565,0.052133212,819,761,1580
863,AGI,0.009345838,0.041405378,0.008842019,859,722,1581
864,SUI,0.014079099,0.036241487,0.025260929,833,751,1584
865,TMUS,0.014802796,0.03506506,0.0,831,756,1587
866,BEP,0.0197776,0.025670663,0.131134089,798,796,1594
867,AMH,0.016637559,0.029238998,0.025607577,816,780,1596
868,KEX,0.031653354,-3.24e-05,0.0,682,915,1597
869,ALK,0.010664408,0.034599243,0.0,849,760,1609
870,FTI,-0.006661307,0.041669829,0.0,892,719,1611
871,CRM,0.001248303,0.04009156,0.0,878,733,1611
872,AUY,-0.26170857,0.053687563,0.021493337,965,652,1617
873,ARE,0.022152234,0.019091734,0.03217743,783,834,1617
874,AMZN,-0.003180367,0.039859152,0.0,885,735,1620
875,NEM,-0.013501686,0.041090111,0.046588823,899,724,1623
876,NU,-0.019155678,0.041503281,0.0,903,721,1624
877,PUK,0.02654775,0.010114442,0.012608851,738,889,1627
878,QRVO,0.010167019,0.029850688,0.0,854,776,1630
879,XRAY,-0.138453287,0.047273289,0.015156991,952,685,1637
880,DOC,0.011528937,0.026258912,0.063868457,847,791,1638
881,THG,0.024113276,0.013365497,0.022637377,765,873,1638
882,REXR,0.013813222,0.024020376,0.0239272,836,802,1638
883,D,0.020012402,0.017578448,0.044474242,795,846,1641
884,IBM,0.012887616,0.024775951,0.046769699,843,800,1643
885,KIM,-0.000947312,0.031730569,0.041784528,881,770,1651
886,ELP,0.010539782,0.023215447,0.020546465,852,807,1659
887,STE,0.005611961,0.026926218,0.009621449,871,790,1661
888,AMD,0.013055609,0.020649883,0.0,842,822,1664
889,RS,0.025155703,0.0,0.0,755,913,1668
890,UDR,0.006977186,0.023628961,0.039171019,868,804,1672
891,MTZ,0.00521754,0.022849629,0.0,872,808,1680
892,DLB,0.023885853,0.0,0.009678592,769,913,1682
893,NWSA,0.013117675,0.01711819,0.015318627,840,849,1689
894,NWS,0.013117675,0.01711819,0.015318627,840,849,1689
895,KGC,0.005842767,0.02077782,0.029404773,869,821,1690
896,KSS,-0.005028051,0.02190561,0.063247592,886,811,1697
897,DEI,-0.019465835,0.025772719,0.071413433,904,794,1698
898,DLR,0.01316136,0.015901295,0.050525988,839,861,1700
899,WELL,0.004661108,0.020053327,0.037348776,873,827,1700
900,AL,-0.022623223,0.024896966,0.029135467,908,799,1707
901,PGR,0.009518153,0.016667572,0.003440519,855,855,1710
902,VTR,-0.002273985,0.019734699,0.040018428,882,830,1712
903,BIO,-0.289639864,0.037316753,5.444138924,966,748,1714
904,DNB,0.000304138,0.017910697,0.008154706,879,842,1721
905,CCJ,0.007182235,0.016149997,0.00416999,866,858,1724
906,FIS,-0.40769715,0.035129851,0.027768695,972,755,1727
907,ORA,0.013580145,0.005642424,0.005598425,837,902,1739
908,AAL,0.015352277,-0.003470615,0.429017574,823,920,1743
909,MAC,-0.026878276,0.019071967,0.076955322,912,835,1747
910,MKL,-0.00565648,0.016039782,0.002012127,888,860,1748
911,PRGO,-0.028548965,0.017448024,0.031057086,913,848,1761
912,GRMN,0.010469173,0.0,,853,913,1766
913,GE,-0.011103461,0.013326352,0.008913457,896,874,1770
914,MGM,0.015067298,-0.044057246,0.000295033,829,945,1774
915,KRG,-0.002635575,0.009254169,0.038951173,883,894,1777
916,HP,0.001776085,0.005704264,0.027433143,877,901,1778
917,HL,-0.01205228,0.010295026,0.004173184,897,887,1784
918,DNP,-0.006206065,0.002128325,0.077335261,890,908,1798
919,MBLY,-0.00293913,-0.000531314,0.012079107,884,916,1800
920,HR,-0.021797281,0.005910976,0.289407754,907,898,1805
921,KKR,-0.029418469,0.005739273,0.014754561,915,900,1815
922,CDAY,-0.007481307,-0.010136832,0.0,893,927,1820
923,WDAY,-0.007932828,-0.025084465,0.0,894,936,1830
924,TWTR,-0.006502209,-0.038750598,0.0,891,943,1834
925,PRU,-0.036509133,-0.001559288,0.047181433,919,919,1838
926,HUBS,-0.00811317,-0.061186651,0.0,895,947,1842
927,CTLT,-0.029561069,-0.014770889,0.0,916,930,1846
928,TAL,-0.028933945,-0.023025061,0.0,914,934,1848
929,GPS,-0.04169763,-0.008487085,0.045413261,924,925,1849
930,CINF,-0.029890159,-0.021558984,0.026015509,917,933,1850
931,ENV,-0.025098302,-0.036986143,0.0,910,941,1851
932,ALL,-0.037090697,-0.015065952,0.028035564,920,931,1851
933,KMPR,-0.095261937,0.003387287,0.025207093,946,907,1853
934,GWRE,-0.016047553,-0.090346646,0.0,901,955,1856
935,AEG,-0.085288416,-0.004058917,0.013895771,943,921,1864
936,CVT,-0.038440373,-0.040667179,0.0,922,944,1866
937,SNOW,-0.015994626,-0.147023158,0.0,900,966,1866
938,LVS,-0.041959969,-0.037271875,0.0,926,942,1868
939,WYNN,-0.075702347,-0.021294629,0.000154208,939,932,1871
940,PHG,-0.130723182,-0.005098005,0.033286743,950,922,1872
941,RIG,-0.213789969,5.3e-05,0.0,961,911,1872
942,VNO,-0.095872602,-0.011371494,0.1174385,947,928,1875
943,STX,-0.041305246,-0.068896052,0.045443579,923,952,1875
944,WK,-0.020453367,-0.215091596,0.0,906,971,1877
945,COUP,-0.037241024,-0.092940938,0.0,921,956,1877
946,BA,-0.044589556,-0.075178541,0.0,927,953,1880
947,BAX,-0.094243112,-0.023320024,0.022305371,945,935,1880
948,CS,-1.000265352,0.003799,0.038334834,978,905,1883
949,TV,-0.244532022,-0.005607294,0.020952843,963,923,1886
950,RNR,-0.146270411,-0.028932792,0.012620473,955,937,1892
951,TTWO,-0.058958685,-0.094434037,0.0,937,957,1894
952,NEWR,-0.035128464,-0.43017642,0.0,918,977,1895
953,RCL,-0.166779323,-0.033644267,0.0,956,939,1895
954,DXC,-0.09889235,-0.061831488,0.0,949,948,1897
955,GME,-0.04510329,-0.174096827,0.0,928,969,1897
956,GOL,-0.068362527,-0.103655214,0.0,938,960,1898
957,MU,-0.076303803,-0.096572476,0.006593025,940,958,1898
958,SE,-0.057471989,-0.112501569,0.0,935,964,1899
959,TTM,-0.077412565,-0.101220175,1.04e-05,942,959,1901
960,HCP,-0.045820091,-0.238307932,0.0,930,973,1903
961,MANU,-0.077097112,-0.107211485,0.022394939,941,963,1904
962,WDC,-0.141438963,-0.067649381,0.0,954,951,1905
963,ETSY,-0.045720325,-0.328753009,0.0,929,976,1905
964,ZNH,-0.197684061,-0.046786133,0.0,960,946,1906
965,SPR,-0.175895303,-0.062604748,0.001356519,957,949,1906
966,S,-0.090332519,-0.225452696,0.0,944,972,1916
967,CEA,-0.30845019,-0.066624281,0.0,968,950,1918
968,NIO,-0.131147633,-0.310257459,0.0,951,975,1926
969,ILMN,-0.138728761,-0.44086929,0.0,953,978,1931
970,LPL,-0.714363331,-0.080366042,0.051992553,977,954,1931
971,CCL,-0.520081247,-0.106525865,0.0,975,961,1936
972,CUK,-0.520081247,-0.106525865,0.0,975,961,1936
973,NEA,-0.392244409,-0.168459055,0.073260271,970,967,1937
974,NCLH,-0.441786383,-0.114920762,0.0,973,965,1938
975,RNG,-0.260767099,-0.25739584,0.0,964,974,1938
976,TEO,-0.491679368,-0.179262728,0.002938504,974,970,1944
977,KEP,-1.747402647,-0.171610531,0.003991992,979,968,1947
978,W,-0.38177573,-0.871352785,0.0,969,979,1948
