,ticker,eps,roce,divYield,fcfYield,eps_rank,roce_rank,fcfYield_rank,overall_rank
0,IX,98931.52925711316,3.025793535417307,21029.330863951494,247294.826777072,2,1,1,4
1,RE,0.1723635667383924,0.5878709677419355,0.0197221721178613,0.3285659091024261,39,9,26,74
2,CVI,0.2525327159581629,0.3712396694214876,0.1487611447711935,0.2252762589691805,12,35,40,87
3,AVGO,0.4033344837808383,0.2476014421901735,0.218966917235088,0.5050416810472605,5,97,15,117
4,WSM,0.1459862810751064,0.3705816841932163,0.035733331816745,0.2293043140303148,57,36,39,132
5,CEO,0.3861131669992614,0.2370224608896081,0.2108444928445225,0.3019693801471993,7,110,30,147
6,PBR,0.2393083953982756,0.221162475855934,0.1891655737616171,0.2809489890521673,13,134,32,179
7,VLO,0.1925256047069078,0.2545248631530379,0.0316408803660928,0.1593593375463063,26,92,80,198
8,TS,0.1912514216379146,0.2347036180577252,0.0310698351451981,0.1876560717108046,27,113,62,202
9,BTU,0.2269880278457772,0.1970460155324998,0.0091440674724602,0.4217925240973072,18,177,19,214
10,WU,0.1416310100417743,0.2738509983498094,0.0789604193363885,0.1437351129066122,61,76,98,235
11,HRB,0.1131749028044859,0.3675644816252913,0.0363674274543763,0.1537361584252744,115,38,85,238
12,ERF,0.1406706333246212,0.3679517067590538,0.0149909549975805,0.1190803640228159,62,37,144,243
13,MO,0.1134141452130721,0.439506807089648,0.094567587995008,0.1268201714799555,114,22,123,259
14,MPC,0.1603278564723698,0.2016145817846629,0.0208835272194668,0.2024923769329269,47,169,56,272
15,CRC,0.1481976641525616,0.2643406268480189,0.0212837070857402,0.1208704353017346,54,82,141,277
16,CIVI,0.1329957386448424,0.259521428072117,0.1119738490732515,0.1237262533772582,72,88,132,292
17,MLI,0.1147620431742703,0.3016465321929781,0.0127283902606533,0.1179860179580934,108,62,147,317
18,HPQ,0.1249264913075971,0.2761265580057526,0.039702351053012,0.1134024723423544,86,75,157,318
19,CIG,0.233270286670182,0.1587279952229761,0.0737771916377067,0.2177596337660354,16,261,44,321
20,APA,0.25834672573803,0.5329439252336449,0.027870680044593,0.0698576785533307,11,12,309,332
21,SHG,0.2170850746651896,0.1413014695351873,0.0726280427351298,0.6628703751951701,20,308,11,339
22,TOL,0.1763697532681411,0.178293778710022,0.0117079290118141,0.1534117644518214,38,215,87,340
23,PBF,0.3896797866029486,0.1836749789649848,0.020225846433818,0.1231937919150737,6,200,136,342
24,VIPS,0.1163424598901636,0.2183326539317113,0.0,0.1316388551348747,101,140,118,359
25,DHI,0.1296107125847148,0.2273876822374293,0.0093185778987092,0.1134916484703589,79,126,156,361
26,ALSN,0.1285946307442438,0.2031388152077807,0.0,0.1259195567020158,83,165,124,372
27,TEX,0.1335550656817625,0.2549773665024236,0.0111381830838844,0.0856247824573616,71,91,230,392
28,BP,0.1487810200055302,0.1542251925690983,0.0469511073696827,0.173335404500176,53,271,70,394
29,OGN,0.2779478627300982,0.1443107221006564,0.0798794444209666,0.146173949314558,9,297,95,401
30,CMC,0.1304583237437719,0.2016054167284975,0.0113706440728381,0.1118974194484038,77,170,163,410
31,ACT,0.1431965763006848,0.1638075398142164,0.0458230076967909,0.1359942625921018,60,247,109,416
32,DVN,0.129444807180093,0.2171174844818993,0.0641869366801742,0.090822097164789,80,142,216,438
33,KBH,0.1401223808475298,0.1231240691652011,0.0134930622947793,0.2486381221520654,63,355,37,455
34,GGB,0.184162241231724,0.1433021189193826,0.065875280483451,0.1256225519654395,30,301,125,456
35,SM,0.177985253242366,0.1717501370042287,0.0155844817402293,0.1033797751788679,37,230,192,459
36,NUE,0.1040890198398974,0.2029524825839077,0.0118363967242541,0.1126689317513264,135,166,160,461
37,AMG,0.1266077147730826,0.1441330312770575,0.0002822285215628,0.1621685084899984,85,299,78,462
38,MTG,0.1303203846930812,0.149548955818174,0.0224768477181183,0.1299573625358154,78,280,120,478
39,TMHC,0.1329310366169098,0.1461211593145188,0.0,0.1335903939485449,73,292,115,480
40,VALE,0.1152832692171296,0.1842959800882325,0.07961376214381,0.1063144548389944,106,198,184,488
41,DQ,0.2161257149716088,0.105803757778126,0.0,0.215953134403251,21,423,45,489
42,BG,0.1493162984338173,0.1242861181792479,0.0254962738743433,0.1439907059796464,51,351,97,499
43,BMY,0.0755931661517068,0.236525508594318,0.0446871003394015,0.11916874080813,252,112,143,507
44,LEN,0.108672063028391,0.1470021382924115,0.011880084493227,0.1401665378586937,123,287,100,510
45,ESNT,0.1243069560450834,0.1397699791706493,0.0189596909419898,0.1354835613169453,89,312,111,512
46,CBT,0.1145122537118053,0.1890726096333572,0.0226451198351435,0.0903231484333565,110,187,218,515
47,ARW,0.1311349375757246,0.1723020691277076,0.0,0.0903010357461919,76,227,219,522
48,CHK,0.236676326269949,0.2405450926351248,0.0476483550613746,0.0539101512090706,15,105,403,523
49,EOG,0.108065878348331,0.2413845109720232,0.048184232826896,0.0733578618495715,126,104,294,524
50,AGCO,0.1289879565726598,0.2450406917599186,0.0503663064165397,0.0644168982371572,82,101,345,528
51,MRO,0.105965720021384,0.1436146425605315,0.0171154412647151,0.1400602245327689,129,300,102,531
52,CRI,0.0848472250065431,0.1617757269180517,0.0408744663950875,0.1712534489824657,212,252,72,536
53,DFS,0.1029786757082411,0.1176822517312281,0.0263401238546249,0.2893210412755345,137,370,31,538
54,NEU,0.0743427889093973,0.2483896031638699,0.0162567496917217,0.101044051962341,261,96,198,555
55,BHP,0.0855217122292672,0.26819690467217,0.0878184411313302,0.0768973959197916,209,80,273,562
56,AB,0.0753782743415154,0.3935760562973516,0.0844958316371243,0.0742837680111773,255,30,283,568
57,SIG,0.1800039670173382,0.1342098734805259,0.0161701490607875,0.0936002859095586,35,322,212,569
58,OC,0.0895509670418747,0.2032985526758667,0.014076573414609,0.089326340870365,195,164,223,582
59,MAIN,0.1209872535893505,0.1422505046020529,0.0766956405053927,0.1044504717763236,91,304,188,583
60,ICL,0.1001594716816052,0.1369539291413953,0.0733780364406196,0.1281496808099534,146,320,121,587
61,BBWI,0.0886277834978701,0.3073790129372304,0.0183715906567338,0.066218480608887,200,58,332,590
62,PII,0.0929155239332316,0.1756315422191207,0.027220478670177,0.1016748633016389,181,216,196,593
63,WRB,0.108107437596115,0.1034547481779871,0.0392447750564462,0.2293356759654553,125,438,38,601
64,MPLX,0.1068648127471657,0.1277392714938799,0.089670677905972,0.1214199743611508,127,340,140,607
65,SU,0.149504545142688,0.1099288084923108,0.049546473128059,0.1174408217178728,50,409,149,608
66,TPR,0.0925091323117795,0.2010874226026105,0.0279998260512042,0.0781781235668991,184,172,263,619
67,BYD,0.0977344073788631,0.1704783956840468,0.010026705330225,0.0852095771594965,161,233,233,627
68,SKM,0.1818389639208223,0.0755861331989232,0.1286637399548064,0.3074868279127901,34,569,28,631
69,MSM,0.0603673162644108,0.2553087616073907,0.031080374828951,0.1067739222733389,362,90,181,633
70,INGR,0.089767108103052,0.1635434412265758,0.0270836998009208,0.1034485647035172,194,249,191,634
71,CPG,0.113919697686426,0.0967532581431653,0.0423278694367064,0.1948000862419825,112,466,58,636
72,RDN,0.1328397602977525,0.108893956331451,0.0321369145152523,0.1130243310459007,74,413,159,646
73,HP,0.1005055254284397,0.1417828552683871,0.0466423430792714,0.1014598764439108,144,306,197,647
74,EME,0.0620434267093594,0.2840511282067539,0.0032035490993101,0.0804955911564535,344,69,247,660
75,GIL,0.0935752208774535,0.2307069378020433,0.0231135600771875,0.0593805784764105,176,118,369,663
76,GEF,0.0978637404203692,0.1205814995519267,0.0317403278367845,0.1187605914511106,160,363,145,668
77,NMR,5358916.732284205,0.0535022424888398,1177337.47044421,71289.14973785415,1,666,2,669
78,MAS,0.0602501575926478,0.3675027262813522,0.0170531833714873,0.0776351149596894,363,39,269,671
79,G,0.0997367134188203,0.1808763222232129,0.0158019622115783,0.0682604509776557,149,208,315,672
80,MKL,0.1053251707935347,0.1048705585345818,0.0018995952769792,0.1334037217809911,131,428,117,676
81,MTCH,0.0647285396381946,0.2306008020888716,0.0,0.0823964359410352,326,119,239,684
82,PGR,0.0418879314927088,0.9288725792096668,0.0029797278040118,0.1115390689114865,517,4,165,686
83,MTH,0.115808833500041,0.2224262739395764,0.0061974941706652,0.0497536474904067,104,132,453,689
84,EBAY,0.1196871782893427,0.1191228070175438,0.0228387532116996,0.0852127723997127,94,365,232,691
85,RNR,0.2751352830943507,0.0552126920315601,0.0118693109231564,0.3545661079162256,10,659,24,693
86,NVR,0.0702121926932845,0.2914729512268396,0.0,0.0649928548158094,292,66,339,697
87,HIG,0.1014393613403737,0.0946333352445387,0.0222404989520228,0.1622462628467239,141,480,77,698
88,PSX,0.1170510665741241,0.1328024142845167,0.0314027237765504,0.0769383418351085,99,328,272,699
89,KT,0.2290342841695347,0.0558612306535879,0.1214720416700468,0.3067933057001538,17,654,29,700
90,AMAT,0.0622903515370889,0.3276961938605129,0.0088583857568059,0.068995468140702,341,49,313,703
91,TX,0.08272382849241,0.1156376749896969,0.0696612697270751,0.143265280294897,226,381,99,706
92,CINF,0.1134627247553133,0.0962815685942721,0.0279501231898601,0.125221477022413,113,469,127,709
93,DKS,0.0815311375917152,0.1908192904043095,0.0273610102189716,0.0732254741697872,233,184,295,712
94,MUR,0.0998992237408088,0.1168174040083621,0.0258186639086702,0.1030976768765897,148,376,194,718
95,CF,0.0992363680140037,0.1633028874484384,0.0202377117720361,0.0670902920802871,153,250,324,727
96,THC,0.0795483918795892,0.1030485733695652,0.0,0.2113044844853901,239,441,48,728
97,CAT,0.0684577165995198,0.2621142033821187,0.0169769838069249,0.0648675780028154,304,86,340,730
98,HAL,0.0811721030128758,0.2140498034076015,0.0177237040695286,0.0639714943759548,235,149,347,731
99,OMC,0.0755532114781519,0.1783855711694607,0.0326201120990992,0.077883633561649,253,213,266,732
100,RS,0.0818908640852786,0.1792522825168483,0.0145955645921886,0.0737134247043548,230,212,290,732
101,FITB,0.0995461517416079,0.0926388403772266,0.0449207836722453,0.1480690737271937,151,490,93,734
102,CNQ,0.086679768350562,0.1527145359019264,0.0409657450081424,0.0783729133489109,204,272,261,737
103,TNET,0.055317811892887,0.38130081300813,0.0,0.0693316575724183,393,33,311,737
104,CPA,0.1150297472490403,0.205729490330008,0.0300166518243702,0.0480872347052798,107,161,469,737
105,ABEV,0.0677884797711993,0.1821751483982742,0.0557283857276813,0.0874465732957854,308,204,227,739
106,TROW,0.074117416623293,0.1726665028678906,0.0464792901136846,0.0797817822812592,262,225,253,740
107,CSCO,0.0591592001608597,0.2130757126858795,0.0295584935712152,0.0892899146485599,370,152,224,746
108,AYI,0.0674507106076621,0.1682840993921296,0.0032750634052275,0.0996944896091283,311,237,200,748
109,XOM,0.0888874714725768,0.1395365288214507,0.0368805251672249,0.082568339926623,198,313,238,749
110,BSMX,0.1662143730347077,0.0557874049963975,0.1122367639037054,0.2036119791749009,44,655,53,752
111,MUSA,0.0726556791723967,0.2294890673186453,0.0043582968469074,0.0585107876093798,268,120,373,761
112,AAL,0.091530338351984,0.097692457800761,0.0,0.1344003873367941,187,461,114,762
113,SON,0.0864869220540145,0.1151204311494886,0.0359481601658571,0.1092888457285333,205,386,172,763
114,MMP,0.0984795158046129,0.11403282632981,0.0826680613180367,0.0917900542910615,156,395,214,765
115,PCAR,0.0899316804223551,0.1869490310491832,0.0296840223198984,0.0572237424874901,192,193,382,767
116,DVA,0.0727077423696902,0.1068955656317179,0.0,0.1572845937915209,267,420,81,768
117,ENS,0.0711470035338636,0.148593311304382,0.0091162584425172,0.0979817995571156,283,282,204,769
118,HCA,0.0710930863046068,0.2210258058591238,0.0089646184752661,0.0635660617149355,284,135,350,769
119,RRC,0.1207595855587781,0.1661948958124238,0.0107073142474425,0.0515207277889622,92,243,434,769
120,PAA,0.1161489539511891,0.0642000715819613,0.093391313380265,0.2047243350944536,102,619,52,773
121,T,0.1195048714003099,0.0659140905732258,0.0675202523411751,0.1698048037306765,96,612,73,781
122,HOG,0.1347108320743169,0.0843110495426716,0.0183615302837552,0.104377797573888,68,534,189,791
123,WES,0.0912090284696272,0.1154765265902972,0.0873021452663012,0.0861280102443178,188,383,229,800
124,MTDR,0.1248957164005355,0.1723468067071516,0.0113924159272254,0.0469451678437885,87,226,488,801
125,APH,0.0652045140598079,0.1913905650642679,0.0169301762128318,0.0729120393472717,322,183,296,801
126,KSS,0.109159779614325,0.0629112924453803,0.0757575757575757,0.2035123966942149,122,626,54,802
127,AMX,0.0775656934690642,0.1680638596365067,0.031049094622496,0.0685987093132953,249,239,314,802
128,RIO,0.0833102486581483,0.1632381120190295,0.0535909036407059,0.0668768092728067,224,251,327,802
129,SNA,0.0661730423421081,0.197764753986643,0.0232728057134345,0.0693210230924349,316,175,312,803
130,SWKS,0.0625379965417022,0.1525444412805597,0.0257838789160538,0.1031036994266586,340,274,193,807
131,EQT,0.1178372083888125,0.0995520180479759,0.0155061861043901,0.0787612988770688,98,453,256,807
132,MOH,0.0523321955677652,0.2339381320642474,0.0,0.0756922132043387,418,115,276,809
133,BBVA,0.161815070023158,0.035747844186738,0.0566625161023853,1.520363466245769,46,760,5,811
134,SNY,0.0953715658101025,0.0897917277794074,0.0786638803922586,0.1237181145369941,171,508,133,812
135,COP,0.0784862869857126,0.1749322035870995,0.0399916893530376,0.0624409020401987,243,218,355,816
136,QCOM,0.0586297675295668,0.1880614314691393,0.0280664069672788,0.0798457660949534,375,189,252,816
137,SEAS,0.0687352551628028,0.2076457987354858,0.0,0.0587223942892859,300,159,372,831
138,CVE,0.0983420710762317,0.1147049575516193,0.0245556011010498,0.0739540033160272,158,388,288,834
139,KR,0.0653213605678732,0.1445989491102273,0.02402763540297,0.0897112216301845,319,296,221,836
140,LRCX,0.0536776948296611,0.3545219903779786,0.0108036134624345,0.0556582309650518,404,41,392,837
141,OLN,0.0677531412385044,0.1226839126919967,0.0148697680684244,0.1086965323259188,309,356,174,839
142,EPD,0.0966588738507343,0.1117871774040206,0.0751500029703558,0.0751849483332809,167,400,278,845
143,CB,0.0972310167657141,0.0710381281062263,0.015013296120005,0.1485820898648419,164,592,92,848
144,DE,0.094592819133989,0.2454976754518191,0.0132779808089909,0.0383451709277168,175,100,575,850
145,LOW,0.0604807239024423,0.4150712537786095,0.0198131908098733,0.0483470037304535,361,24,466,851
146,JNJ,0.0931734953619928,0.1801922886638741,0.0311965419853399,0.0483665673872968,177,210,464,851
147,PRI,0.0779412247514125,0.1159983855895872,0.0126677925941485,0.0890280270859317,246,380,226,852
148,UBS,0.2792164894916507,0.0178502453960993,0.0168331951833566,0.481795900435906,8,830,17,855
149,FLT,0.0474931852159662,0.1956084845510068,0.0,0.0941897305226687,466,178,211,855
150,PVH,0.0900404612199152,0.0976741971576165,0.0012754375157733,0.0983308050724421,191,462,202,855
151,LMT,0.0609981992132783,0.2395056167121822,0.0269379330629737,0.0549071940606229,354,106,397,857
152,PM,0.0535092419699838,0.3262249171398473,0.0545434024125114,0.0539886540956588,406,50,402,858
153,TLK,0.0621779700036626,0.212837743764909,0.0422622850112912,0.0611623311601099,343,153,362,858
154,FIX,0.0439196725461511,0.2626185483982948,0.0041256771293561,0.0739780803408335,492,85,287,864
155,ABM,0.0967863690283619,0.1102050702405942,0.0221457071990879,0.0734467193541926,166,408,292,866
156,FANG,0.1125948421319504,0.1699326962406574,0.051729860654959,0.0432037478877289,116,234,523,873
157,SYF,0.1391304088345198,0.0256484989798892,0.027850948685373,0.5342035760120775,64,797,14,875
158,AIT,0.0620364411343361,0.2147769302420167,0.0095622345131806,0.0568033872617166,345,146,384,875
159,SEM,0.0841665175982792,0.0861449619525408,0.0220894289341307,0.1219709519723259,215,526,138,879
160,KB,0.225392282388786,0.0146546320170494,0.0560520685717412,0.6330539796742667,19,847,13,879
161,SAN,0.1828571758569689,0.015723563529772,0.0373275618104556,1.1047868681087492,32,842,6,880
162,VC,0.1384737683385142,0.155902004454343,0.0,0.0404594137943807,65,265,550,880
163,GILD,0.0560333640354625,0.1842462385681974,0.0376753898695634,0.0734022232139748,389,199,293,881
164,UL,0.0587872738867165,0.1925783035684214,0.039538904881724,0.0662509794029247,371,181,330,882
165,CVX,0.0764881306485566,0.1310218246183089,0.0405760423525685,0.0708004691014296,250,330,307,887
166,FMS,0.0884615192009559,0.0538136554972716,0.0582578448855919,0.344666055984494,201,662,25,888
167,RF,0.1143349827560354,0.0668632982816106,0.0487880712338916,0.111137572437882,111,610,167,888
168,AZO,0.0556769540254107,0.4648081046590444,0.0,0.0472146240829108,391,18,487,896
169,AGO,0.1691047653219443,0.0531512259338489,0.0153315551780382,0.1054902527921736,41,669,186,896
170,THO,0.0605988136207943,0.1076411509522851,0.015538493616588,0.1252287401590118,359,417,126,902
171,BBY,0.0753138496829019,0.2431283649759138,0.0486111149041132,0.0409644226720055,256,102,545,903
172,BAM,0.1383061258860971,0.2012280200847394,0.0320948961552157,0.0311853230484761,66,171,667,904
173,ABC,0.0478872184900548,0.1705134085125763,0.0109409274817158,0.0947424691817918,463,232,209,904
174,CTRA,0.0842269161234678,0.1011566771819137,0.0461304340614685,0.0808060075301454,214,449,244,907
175,IHG,0.0486715268971836,0.3987800228745711,0.01589936545308,0.0526301444181546,458,28,422,908
176,SMFG,0.4180255064016069,-2.363261552749548e-05,0.151074989130048,1.9395660962590413,4,904,3,911
177,SAIC,0.0696306553558454,0.1782964388835418,0.0115321211176347,0.053865223954522,294,214,404,912
178,LKQ,0.073190162116209,0.1153813451237139,0.0236147745289478,0.0780382284102314,265,385,264,914
179,CSL,0.0492230500112987,0.1818466238474704,0.0102820627010831,0.0784592582405793,451,205,259,915
180,NTAP,0.0467816502061049,0.2195121951219512,0.0197374913648475,0.0725922158370594,478,138,301,917
181,LYB,0.0684120255007928,0.1022780569514237,0.0521018737257693,0.1103847771916766,305,445,169,919
182,BERY,0.0819055783347506,0.0777153558052434,0.017080473642879,0.1245395164827243,229,561,129,919
183,WNS,0.0581030233091657,0.1665285170722938,0.0,0.072533010389244,377,242,302,921
184,DAL,0.1792898968645468,0.1169059416423156,0.0049791943585727,0.0443848497119652,36,375,510,921
185,SKX,0.0566558424744297,0.1333199920359929,0.0,0.0941956489599312,387,325,210,922
186,AFG,0.0846078886131188,0.0574898785425101,0.0679246429710953,0.1884809537414313,213,648,61,922
187,BC,0.0618977156444856,0.1640987852804573,0.016490352407665,0.0654166390600499,346,246,337,929
188,VZ,0.0731568892133587,0.0881595684825949,0.0694467628359979,0.1178421804204851,266,517,148,931
189,KLAC,0.0500691001583691,0.3867263855079352,0.010828290610899,0.0491960592872936,447,31,457,935
190,SNX,0.0686551594184035,0.085058196068629,0.0142777009081272,0.1376984343507777,302,529,104,935
191,ORAN,0.0887341066562594,0.0568015191942501,0.0677143059811291,0.1536481969765147,199,652,86,937
192,FBHS,0.0511725406502265,0.1146217798158297,0.0147761501803373,0.133567289044522,433,389,116,938
193,FOXA,0.0688869120426998,0.1140694912445451,0.0166240409207161,0.0802290670521516,298,393,249,940
194,FOX,0.0688869120426998,0.1140694912445451,0.0166240409207161,0.0802290670521516,298,393,249,940
195,GPK,0.0951675172071558,0.1553692056836711,0.0161903245041219,0.0447537425317192,172,266,506,944
196,AFL,0.094725402312294,0.1047113501414493,0.0196404246906366,0.0648581312247731,174,430,341,945
197,CCZ,0.0851343045106022,0.1037963074265514,0.0263679552441857,0.0717068963323313,210,434,305,949
198,GPS,0.0684884783824713,0.0782586814292903,0.0302877334679454,0.1517115298034026,303,558,88,949
199,CMCSA,0.0851343045106022,0.1037963074265514,0.0263679552441857,0.0717068963323313,210,434,305,949
200,KMB,0.0429760914063458,0.2250816208949491,0.0386882274111548,0.0676313093786938,501,129,320,950
201,HSBC,0.1490112964657785,0.0118054599346315,0.0772252484467188,0.2242546243841419,52,858,41,951
202,AON,0.043294304857084,0.3365290867728306,0.0082569871587808,0.0537464010764814,500,44,407,951
203,GIB,0.0521210420293304,0.2098209562745994,0.0,0.057681613754068,421,156,379,956
204,GIS,0.0635159699440171,0.1497290970994565,0.0346862426586849,0.064327537452314,332,279,346,957
205,RL,0.0527938681674295,0.1587997040152665,0.015896157736936,0.0739179503399457,411,260,289,960
206,BDC,0.0744018591959855,0.126709881163331,0.0026045048770487,0.0621878407963446,260,344,357,961
207,CVS,0.082236388221983,0.0825207137370337,0.0308682128369188,0.1024505339846014,227,541,195,963
208,WTW,0.0503090741995421,2.167381974248927,0.0138458124458474,0.0433861679766184,441,2,520,963
209,OKE,0.0781885290988065,0.0938567330024136,0.0540762335512241,0.0845694658473739,244,485,235,964
210,AM,0.0618961821293585,0.1074501649405167,0.0,0.0990682535722825,347,418,201,966
211,STM,0.0929721070325961,0.2198523379819524,0.0049234813270645,0.0321461381713274,179,136,652,967
212,ABG,0.1281404240395263,0.1469994645578483,0.0,0.036304681134518,84,288,597,969
213,SIVB,0.1231651542960531,0.018441473093547,0.0120071292764692,0.1951342665850745,90,828,57,975
214,DCI,0.0468854497514208,0.2384191450275557,0.0149489839787139,0.0557189402842972,477,107,391,975
215,PYPL,0.0626852525635478,0.1491988130563798,0.0,0.0623014050443174,338,281,356,975
216,DB,0.1689117644014381,0.005020788948369,0.024107668761085,0.2048756637007617,42,883,51,976
217,ITUB,0.1001716470500418,0.0242858930913029,0.0313117717466797,0.3259867709301361,145,808,27,980
218,ACI,0.1050089002138127,0.1104981956226273,0.0224613632117576,0.0509394525979283,132,406,442,980
219,HD,0.0426150074730339,0.3978538017059524,0.0235912043615164,0.0505031317513746,507,29,446,982
220,PAGP,0.0636604774535809,0.0585367921329264,0.0671971706454465,0.6954424885459368,330,642,10,982
221,SLB,0.0566770500424774,0.1686823679185232,0.0177596181075286,0.0612888870909017,386,236,361,983
222,CTSH,0.0557381304130677,0.1943234323432343,0.0154944661684492,0.0527755675077636,390,180,417,987
223,TKR,0.0688875320826672,0.1295952982013253,0.0164309262008899,0.0624724789808304,297,336,354,987
224,TGT,0.0616290732546726,0.1611283701320315,0.0299507168475463,0.056818490687911,350,254,383,987
225,KOF,0.0579236085926091,0.1654407055680591,0.0363949782695678,0.0604467960881205,378,245,366,989
226,ULTA,0.0518168117579405,0.414448901161326,0.0,0.0417823704967869,428,25,536,989
227,MOS,0.0984088582671677,0.0698414852472193,0.0297025964174917,0.0848838705355396,157,599,234,990
228,BWA,0.0748872497567662,0.1085532472393786,0.0155765479494073,0.0676980737801166,258,415,319,992
229,RHI,0.0443131325420359,0.2120711074868304,0.0221928879807431,0.0636984709185327,489,154,349,992
230,IBP,0.0473341694488339,0.2270475258425592,0.0122559954543349,0.0541128420535295,469,127,401,997
231,AOS,0.0450247167935914,0.3338622939257692,0.0148437576924614,0.0483493949470528,487,45,465,997
232,AXP,0.060815614812168,0.0894251543866215,0.0129271309249652,0.1234323130341065,356,510,134,1000
233,EXPD,0.0396865483631862,0.3333808612267091,0.010649508196182,0.053444265038289,546,46,410,1002
234,MTB,0.1201941740784931,0.0178321540493131,0.0424472676059764,0.160010412700628,93,831,79,1003
235,FHN,0.1155111278552882,0.0226062313718464,0.047260405711138,0.1559464613520112,105,816,82,1003
236,NVS,0.0707964743054875,0.1328121813608864,0.0345877724637247,0.0558028775586351,288,327,389,1004
237,PNC,0.0898303160407022,0.0407282286359834,0.0463484491870098,0.1628315391695124,193,737,76,1006
238,CNC,0.067014382538238,0.0611371935315597,0.0,0.1799120395752697,314,634,64,1012
239,KEYS,0.0486538488094306,0.2047030449201085,0.0,0.0557885191646451,460,162,390,1012
240,BNS,0.1102582450116722,0.0075642917700254,0.0806774904795259,0.4654653738805845,120,875,18,1013
241,SUN,0.06171884844643,0.1108270951250684,0.0736260217801464,0.0781904382247377,349,403,262,1014
242,UNM,0.1443615182940733,0.0225586558061614,0.0311595082717617,0.1200951094703772,58,817,142,1017
243,GPC,0.0677195384075561,0.1722703448112651,0.0270911279788755,0.0474740545921664,310,228,480,1018
244,JBL,0.0537526301332776,0.2284143260514192,0.002957051779948,0.0462614322907425,403,123,494,1020
245,BABA,0.0597871444485538,0.0922124405019794,0.0134102425261376,0.1118372081484379,367,491,164,1022
246,ADM,0.0891453563280405,0.080152353415441,0.02500574594674,0.0759130424544841,197,550,275,1022
247,CE,0.1158949770238021,0.053762486126526,0.0180346775470712,0.0787021502136125,103,663,257,1023
248,WMB,0.0749491634371003,0.0887236361305211,0.0513728301759804,0.0794758194232354,257,513,255,1025
249,SEE,0.0647768611590658,0.1544205495818399,0.0223571192349352,0.0515787653257199,324,269,433,1026
250,CM,0.1114884216854753,0.0078275630578805,0.0504655298159879,0.2486448483636026,117,874,36,1027
251,OXY,0.0706292740598904,0.0724020968239284,0.0257090557578001,0.1141934103000308,289,587,153,1029
252,MFC,0.1018070498119174,0.0063041440947221,0.0553854204724544,0.636913699692825,140,878,12,1030
253,WFC,0.1054434152305835,0.0116243959730461,0.0326653146127552,0.222311427848495,130,860,42,1032
254,HPE,0.1013583520783717,0.0592271271015848,0.0309831209563022,0.0800856115187135,143,640,251,1034
255,AMCR,0.0715327111989646,0.140370473796891,0.0493493799588277,0.0501684568046174,280,311,451,1042
256,LEA,0.0689142007937427,0.0972829879379285,0.0218960578591821,0.0749690205316034,296,465,281,1042
257,SNV,0.0988333563054697,0.0232779401835527,0.0458099391322458,0.1645346660898865,155,813,75,1043
258,BKNG,0.033456443581077,0.5303305484925536,0.0,0.054595861185348,631,14,400,1045
259,MCK,0.0420092410049362,0.2603075699323876,0.0043940378666055,0.0507553354846448,515,87,444,1046
260,EXP,0.0508513113359594,0.2280341683423717,0.0037579627868258,0.047230899909567,436,125,486,1047
261,CPB,0.0626269143909058,0.1333875559170394,0.032627308546311,0.0564226163451867,339,324,385,1048
262,GL,0.0838637241636061,0.0488585725974277,0.0072667985452002,0.1237861068650222,220,697,131,1048
263,HSY,0.0487744569509194,0.2938091911835386,0.023291576971915,0.0406608854390109,456,64,548,1068
264,NFG,0.1001254569691397,0.1010372295873613,0.0369741027257922,0.0477056546316729,147,450,476,1073
265,F,0.0891955411668098,0.0317733832424219,0.1024917709059616,0.1371071097484755,196,772,105,1073
266,ASGN,0.047211944169777,0.1155689573083637,0.0,0.0897737378878112,472,382,220,1074
267,WCC,0.0861538447686665,0.1204883272649389,0.0150811433037247,0.0451196294810691,206,364,505,1075
268,TAP,0.0717702263609795,0.0645439246045102,0.0268277998632515,0.1064565218706698,277,617,182,1076
269,PKG,0.0527168574965927,0.1466050395892695,0.0309260289208317,0.0580629475929539,412,290,376,1078
270,DRI,0.0569883329198961,0.1452932479053721,0.0348496189584589,0.0546313807065211,385,295,399,1079
271,CRH,0.0634775756375861,0.1117577958137548,0.0187756202326403,0.0639170050472862,333,401,348,1082
272,WHR,0.0718194509768789,0.1097066769587032,0.0573361105511881,0.0546484803691012,275,411,398,1084
273,COF,0.0974665323023274,-8.903668979394685e-06,0.0231151444523015,0.3911824359684571,163,901,21,1085
274,BAC,0.0980863771387648,0.0127575295171476,0.0336153463722404,0.1664009585689579,159,854,74,1087
275,INFY,0.0435290398663315,0.3283995926357424,0.0244240934141052,0.041133217579486,498,48,542,1088
276,GWW,0.0442304198351934,0.4061114629512349,0.0094796744534695,0.038353988987762,490,26,574,1090
277,HBAN,0.106039344038161,0.0125246360226333,0.0561992218018752,0.1368021675776788,128,856,108,1092
278,ALLE,0.0485270766091139,0.2191967324710687,0.014251012320256,0.0463719140654079,461,139,492,1092
279,SQM,0.1170079803379941,0.309165907044967,0.0855197776664004,-0.0752214880571243,100,56,936,1092
280,CMA,0.1195886476302172,-7.350238882763689e-05,0.0534823236847963,0.1490446482383411,95,907,91,1093
281,CHTR,0.0785767710195841,0.0937385709700774,0.0,0.0601783916739847,242,486,367,1095
282,BKH,0.0725381433887098,0.0568918710656408,0.0465051941405115,0.1075622812720457,269,651,178,1098
283,VIV,0.0571190141761489,0.0786639482528806,0.0435271598915252,0.1132817875931115,383,557,158,1098
284,ALV,0.0521025181104295,0.208517570397952,0.0240226774074726,0.043667889154028,422,158,519,1099
285,WIT,0.0441378096130443,0.151220943087841,0.0020851690377799,0.0662179035213407,491,276,333,1100
286,POOL,0.0339061772065261,0.2811562253744588,0.0108517730117827,0.0536645030160257,624,71,408,1103
287,WTM,0.1338727584172928,-0.0109022899370495,0.0006835608245973,0.1369750731918349,69,931,106,1106
288,CFG,0.1021311481477181,3.702716981472869e-05,0.0589413591300263,0.1771416493681503,139,900,68,1107
289,TGS,0.0349484365829303,0.2097002892120087,0.0,0.0647888522685565,609,157,342,1108
290,AN,0.152447854801443,0.2228636390480127,0.0,-0.0746040476390961,48,130,932,1110
291,BBDO,0.078846531808997,0.0105076438805321,0.0,0.9656017608957462,240,864,7,1111
292,BBD,0.078846531808997,0.0105076438805321,0.0,0.9656017608957462,240,864,7,1111
293,EXPE,0.036219796747198,0.1479866112181762,0.0,0.0838008848203678,592,283,237,1112
294,GFI,0.054445980023,0.2071869652863904,0.0,0.0403254812938728,399,160,553,1112
295,UNH,0.0458097458479148,0.1804071119139612,0.0138385099717506,0.0525662791147021,480,209,424,1113
296,IBM,0.0503393822935649,0.1038666930379746,0.0405291747604815,0.0813334647800987,440,432,242,1114
297,ZION,0.1049106716795289,0.0156939676311917,0.0435070726670987,0.121881515627688,134,843,139,1116
298,ALLY,0.0961630480002605,0.0057013865814359,0.0450646440628672,0.179504356267153,170,880,66,1116
299,CNA,0.1049770170027049,-0.0022869826962853,0.0685617530133848,0.1912236948721471,133,923,60,1116
300,YUM,0.0434966632584747,0.4648768671780379,0.0184663354347187,0.0358976845176391,499,17,601,1117
301,PBH,0.0586945748301028,0.1056926930371884,0.0,0.0671163641009592,373,424,323,1120
302,WF,0.087185741649674,0.0084640378881941,0.0340344624785905,0.213564394443917,203,870,47,1120
303,PBA,0.0708610630042341,0.0716739803381297,0.0630009113083815,0.0803570838347564,285,590,248,1123
304,IPG,0.087612498787591,0.1659169240410008,0.0382148107876319,0.0299433103103256,202,244,677,1123
305,RY,0.0963914191912877,0.0098587652696299,0.0359967686312979,0.1514666698093665,169,866,89,1124
306,HII,0.0657359003733335,0.0954417695221801,0.0193056976133138,0.0654463149091338,318,474,335,1127
307,OTIS,0.0381982613651102,0.6008796041781198,0.0146435724578907,0.0404532085153976,571,7,551,1129
308,MFG,0.4576531041418059,-2.031749487722866e-05,0.1582498519263645,0.0892715840726925,3,903,225,1131
309,DOV,0.0491318909403122,0.1544121228518116,0.0132169560218483,0.0531730306716466,452,270,413,1135
310,TEL,0.0490851782036109,0.1335729607513479,0.0186318084804282,0.0616777108317624,453,323,360,1136
311,ENB,0.0631440221663168,0.0703937294368422,0.0778004524446236,0.0951087072687618,335,595,208,1138
312,ORI,0.072013448561228,0.0517117755297735,0.0331435099876684,0.1059148682146762,274,680,185,1139
313,PAYX,0.039044988770639,0.4284785179345683,0.0303809002188958,0.0394099383817228,558,23,559,1140
314,RGA,0.0840946133391211,-7.252382925818484e-05,0.0204176500235781,0.3842060993021265,217,905,22,1144
315,ADP,0.0375245568915668,0.5450301094668064,0.0209354473912036,0.039988068246699,578,11,555,1144
316,RZA,0.0840946133391211,-7.252382925818484e-05,0.0204176500235781,0.3842060993021265,217,905,22,1144
317,GPI,0.1442911087871243,0.1867549920279401,0.0060441089452053,-0.0292371777944655,59,194,894,1147
318,ATHM,0.0833574144675622,0.0441540458642302,0.0201278840165362,0.097260777305861,223,720,205,1148
319,CL,0.0348738190928822,0.3545314109165808,0.0265192650406308,0.046094091322766,611,40,498,1149
320,WYNN,0.0712052378480647,0.0800396311592741,0.0082650452176046,0.0682271762246277,282,551,316,1149
321,VOYA,0.0834112728266625,0.0046815998355981,0.0217536599531936,0.2186042638241172,222,885,43,1150
322,VRSN,0.0383917103957764,1.7851917930419268,0.0,0.0379409271034581,566,3,582,1151
323,KMI,0.0606733293138204,0.0668192291415226,0.064175177680741,0.1052077052844414,357,611,187,1155
324,ORLY,0.0408412943115793,0.4592844034133589,0.0,0.035293387882586,530,19,608,1157
325,ARMK,0.1032667891004436,0.0728744221272136,0.0175577500429578,0.0512058404960059,136,585,438,1159
326,GOOG,0.0418271495524503,0.2629406883816107,0.0,0.0393899011877164,518,83,560,1161
327,GOOGL,0.0418271495524503,0.2629406883816107,0.0,0.0393899011877164,518,83,560,1161
328,CNHI,0.1461436806264392,0.1727483799424749,0.0331612400577917,-0.0177517418896729,56,223,882,1161
329,EMN,0.0839227640215788,0.0909015509662436,0.0352963750247356,0.0507854757669733,219,500,443,1162
330,GRMN,0.0524196028269275,0.1497569822191007,0.0227121831679632,0.0480135281462919,415,278,470,1163
331,AXS,0.0798190609568707,0.000412924138704,0.0390353839374425,0.2597229160372977,237,894,34,1165
332,ENLC,0.0367278250857813,0.0944512610770279,0.0420713495890473,0.1383972846345884,585,482,103,1170
333,MCHP,0.0392051000964656,0.1916083811349578,0.0187400748533894,0.0512797528242721,553,182,437,1172
334,TJX,0.0400370624715986,0.3004767827529022,0.0132800627420322,0.0387931751932007,543,63,567,1173
335,V,0.0366873609597598,0.3115680776249611,0.0079670173658345,0.0418337440782394,586,55,535,1176
336,ITW,0.0373061625036757,0.3725906114543945,0.020375195280161,0.0389084224421156,580,34,566,1180
337,MGM,0.0720250506175594,0.0403411812912945,0.0,0.1109190067541586,273,740,168,1181
338,DGX,0.0553017116333043,0.1106742033259605,0.0203334162211446,0.0559492726594554,394,404,387,1185
339,MAR,0.0453440600053551,0.21572130415364,0.0086334619601503,0.03997572335211,485,145,556,1186
340,L,0.0905855854000596,-0.0277387951197926,0.0036006822648559,0.2034701328965078,189,944,55,1188
341,K,0.0497353202358426,0.1425054445601742,0.0418383345832535,0.0506243848457368,449,303,445,1197
342,SLF,0.0830891861631323,0.011582799968333,0.0467765026500194,0.1352094444293868,225,861,112,1198
343,CI,0.0586778444915174,0.0520512045156738,0.0164761569544346,0.1163557566989037,374,677,151,1202
344,EPR,0.0474573593791265,0.0683914079339505,0.0746623949942229,0.1239467883884885,468,604,130,1202
345,APTV,0.1182519207364056,0.0794637851062745,0.0012879719072719,0.0398466308812258,97,552,557,1206
346,NXPI,0.0471312234877112,0.1816026084379013,0.0169517378722336,0.0422445396080414,474,206,529,1209
347,PSA,0.0401414190410277,0.1674934226427251,0.0430748654308678,0.0520471810364028,540,241,429,1210
348,CSX,0.0533631266684056,0.1391083379459568,0.0126692537608435,0.0469423143882502,408,315,489,1212
349,WMS,0.0382413091063205,0.2523172492825511,0.0032994251868106,0.0400562741920349,569,94,554,1217
350,KEY,0.0724240148506528,4.265544354552047e-05,0.0682298630082158,0.2067866649458661,270,899,49,1218
351,HUM,0.0438922160903148,0.1432191291934332,0.0076004600783148,0.0524978414226063,493,302,425,1220
352,ACN,0.0336557245033651,0.2650685469580564,0.0138480978221482,0.0440613573578484,627,81,512,1220
353,EVR,0.0392008744339505,0.1305565905618228,0.019619540583072,0.0654234282960639,554,332,336,1222
354,CDW,0.0360914528589346,0.2143294315660622,0.0105074726923367,0.0474061870613824,593,147,482,1222
355,TDC,0.0142781541018142,0.2132269099201824,0.0,0.0817539468732915,833,150,241,1224
356,SBUX,0.0394659220159887,0.2920766957542711,0.0232690578636153,0.0351657679721082,548,65,611,1224
357,CHRW,0.0317458538538034,0.1741563243412902,0.0284690287925703,0.0632551240626912,652,222,351,1225
358,TXT,0.05734244128544,0.1033819522359352,0.000996177047304,0.0537935605544192,381,439,405,1225
359,WEX,0.0320173321131679,0.1206623282179417,0.0,0.0917405851509714,649,362,215,1226
360,SCCO,0.0368276706461871,0.2733490689061603,0.0469593801361822,0.0389429990813734,584,77,565,1226
361,BOH,0.0601592135920154,0.1081085005208789,0.0420519235113121,0.0503072032680744,364,416,447,1227
362,AMP,0.0636643924081856,0.0408423338476484,0.0136993019657676,0.1121101057234911,329,736,162,1227
363,NSP,0.0386715226532847,0.304964717144105,0.019003611618122,0.0357356531848348,564,60,603,1227
364,EA,0.0353593431439539,0.1603097773475314,0.0056941597364576,0.0587748390358259,602,256,371,1229
365,PHM,0.114621413720809,-9.034012183065883e-05,0.0062746033146885,0.0926953398982464,109,908,213,1230
366,HE,0.1291603285933596,0.0202907085779177,0.0841223362440194,0.0662568956217925,81,821,329,1231
367,CZR,0.0779823795539328,0.0805841700352066,0.0,0.0510953250257957,245,549,439,1233
368,OGS,0.0652675599633287,0.0580487240933797,0.0406719821882606,0.0770282079421208,321,644,270,1235
369,FFIV,0.0409114139192362,0.1251652738460495,0.0,0.0620718221278607,529,348,358,1235
370,BAP,0.1097820256192124,0.0299128410805807,0.0449918037914923,0.0660772703989724,121,781,334,1236
371,IGT,0.0284567676030645,0.1141130870953032,0.0291864283108354,0.1169281284202845,694,392,150,1236
372,UHS,0.0679260983581827,0.0952226600864697,0.005250161866427,0.0496571816530758,307,475,454,1236
373,PNR,0.0519296921837682,0.1407093360884977,0.012108866717654,0.045299837472656,424,309,504,1237
374,BSAC,0.0715607354885383,0.0095920815958378,0.0599223453729622,0.1474948212082267,279,867,94,1240
375,DPZ,0.035895903190538,0.726814533115634,0.0117393719278931,0.0335690774161253,598,5,637,1240
376,ITT,0.0418022907451663,0.1824651098521486,0.0097555650508816,0.0437982101083947,520,203,517,1240
377,TKC,0.0412185304229269,0.1264287138666885,0.0081589306314765,0.0592409659383347,525,346,370,1241
378,BK,0.0805179189927227,0.0130353696071782,0.036436441126652,0.1149695909658718,236,853,152,1241
379,CHH,0.0453231993988114,0.2582643589427515,0.009898423905189,0.0312542774254868,486,89,666,1241
380,FNB,0.0976358540513472,0.0358305139358788,0.0366386091491653,0.067439198159178,162,759,321,1242
381,WBS,0.0995309370627157,-0.0009756455258808,0.033810630877551,0.1076511999416466,152,917,177,1246
382,CCK,0.0409222347588751,0.1236961137265762,0.0104579044383792,0.0600192776463502,528,352,368,1248
383,DECK,0.0315525314070674,0.3839705976106833,0.0,0.0392065946341342,653,32,563,1248
384,MGA,0.0717382345746827,0.11715074780292,0.0308716887452468,0.0361956728064659,278,372,599,1249
385,BEN,0.0732966905232394,0.038370231133389,0.0504226100529715,0.0821889374138589,263,750,240,1253
386,PG,0.0407763260370508,0.2131581112691453,0.0250423911831993,0.0383636409436144,532,151,573,1256
387,BXMT,0.0671311843803586,0.0223821513544374,0.1162422792235135,0.1249317181653916,313,818,128,1259
388,POST,0.0585685405489464,0.0552419429225007,0.0,0.0869489153254023,376,658,228,1262
389,UPS,0.0496666051387166,0.1718846956619845,0.0397747469894433,0.03761275404065,450,229,584,1263
390,BKR,0.0563949492416432,0.0967270601987142,0.0228133968625484,0.053347358057715,388,467,411,1266
391,PSO,0.0549764555944182,0.089798985534473,0.0223978152421704,0.0609395103017493,396,507,364,1267
392,ABBV,0.0177490198803621,0.1798802518839682,0.0384653342626233,0.0805220803209028,810,211,246,1267
393,SJM,0.0622287685102357,0.0865510588123198,0.0365928578269195,0.0537726818215464,342,522,406,1270
394,LII,0.0371436700287531,0.4514659377177467,0.009655717645163,0.0303959977239194,581,20,673,1274
395,MMC,0.0401289854140326,0.1870727820081459,0.0138677910190134,0.0410478066988054,541,192,543,1276
396,FDX,0.0686703265436771,0.0862841470700048,0.0199898129753733,0.0497919408187217,301,525,452,1278
397,A,0.0408018484553538,0.1473799126637554,0.008719749871507,0.0485015521154771,531,286,462,1279
398,ROST,0.0389230256689542,0.228158155675032,0.009443877364125,0.0363723021134703,560,124,596,1280
399,BCE,0.047583570990338,0.0919058044891615,0.0771261769299867,0.0669071687544214,465,494,326,1285
400,TRV,0.0683570380198371,-0.0003676470588235,0.0207516517960588,0.1762290605720375,306,912,69,1287
401,KHC,0.0629208590030603,0.0653204053364438,0.0433063005047332,0.0653010526185876,336,616,338,1290
402,ETSY,0.0309770536219063,0.1417189847763036,0.0,0.0670371487801363,659,307,325,1291
403,AIZ,0.0713361289248512,0.0205824595798935,0.0169097158525367,0.1038787271939157,281,820,190,1291
404,MT,0.0386764327114241,0.0676803237788989,0.0155294925685696,0.1276027682056997,563,607,122,1292
405,GD,0.0467381673994255,0.1106102454531241,0.020133364418214,0.0536607737925229,479,405,409,1293
406,TPX,0.0419389967043536,0.1602435746221576,0.0088526488560942,0.0432492343085374,516,257,522,1295
407,MCD,0.0392383568430264,0.2383064368870187,0.0210017504130538,0.033612159894877,552,108,636,1296
408,RDY,0.0543071085633931,0.2323632234226136,0.0064836157195861,0.0175529656620205,400,116,780,1296
409,PRU,0.0659971720423989,-0.0001608881023248,0.0489673551407831,0.1726855265257303,317,910,71,1298
410,VSH,0.0968782887650273,0.1370173120544028,0.01664181239838,0.010857895541193,165,319,815,1299
411,HI,0.1929069042183528,0.0268048018418023,0.0207568777050816,0.046626787275526,25,792,491,1308
412,AVT,0.1659990283121323,0.1442430225111728,0.0228972568267985,-0.1956204228973128,45,298,966,1309
413,ALE,0.0705099889626613,0.0258894581675587,0.0443719274937023,0.0896284400371183,291,796,222,1309
414,FAST,0.0312151384794597,0.4021201599326599,0.0274801322994932,0.0340501757318367,656,27,627,1310
415,BAX,0.1357737159262159,0.0179120929591696,0.0299560984686606,0.0528576891068175,67,829,416,1312
416,TPL,0.0335835762376261,0.444559993048791,0.0082767377476068,0.0313189232913208,629,21,662,1312
417,FN,0.0522739978731354,0.1680532901400288,0.0,0.0318475124933364,419,240,656,1315
418,CAG,0.0239580325928608,0.110218211742005,0.0454940405773996,0.1123032777790351,749,407,161,1317
419,NNN,0.0502373853852311,0.0653402222375504,0.0517890411840236,0.0784163663755146,443,615,260,1318
420,TT,0.0362995318492117,0.2169675523301145,0.012262458582591,0.037465335283274,590,143,586,1319
421,MSI,0.0326855949858882,0.3134210526315789,0.0112649593017484,0.0342538915270484,642,53,624,1319
422,WTS,0.0376658605607255,0.1872242067661273,0.0066824208930703,0.0403963121084316,576,191,552,1319
423,AWI,0.0509226140093162,0.1586710873536775,0.0106714503889049,0.0340621774673576,434,262,626,1322
424,PB,0.0666400470524032,0.0243029534430793,0.0326933798838707,0.0982756181400897,315,807,203,1325
425,CNS,0.0345596471245491,0.2340443825631609,0.0301133219208754,0.03594847098206,616,114,600,1330
426,BCO,0.0215834951480204,0.1060609313609721,0.0097457971249898,0.1229791622059956,773,421,137,1331
427,CBOE,0.0403035246051588,0.1681663193786702,0.0118306248348476,0.0395942164495125,538,238,558,1334
428,RHP,0.0489645553428944,0.0942103937435613,0.0276906811160854,0.0551104356301521,454,484,396,1334
429,BRO,0.0437825376429232,0.1219612607818132,0.0067899397837962,0.0473082767454722,494,359,484,1337
430,QSR,0.0488173885076483,0.1038172781918564,0.0406127853971192,0.0502557208646338,455,433,449,1337
431,MTD,0.0297641988652917,0.5297357106756442,0.0,0.0324725221769948,675,15,649,1339
432,GGG,0.0346592330856857,0.2776521645327696,0.010833631964212,0.0319037299334788,615,74,654,1343
433,NE,0.0723100936849227,0.1264627477286679,0.0148256834303345,0.0247218766370613,272,345,730,1347
434,HST,0.053553882696299,0.0767019105917269,0.0395864511282102,0.0575342388426455,405,564,380,1349
435,GSK,0.0417356874917799,0.1843319187073305,0.0190300506887235,0.0339102460870711,521,197,632,1350
436,CW,0.0415647916915748,0.1270445742149865,0.0035465767692172,0.0472997666027948,524,341,485,1350
437,WSO,0.0343829082747745,0.2514659972415879,0.0245302530306679,0.0336966437935221,620,95,635,1350
438,CLF,0.0383130725355764,0.0482571815524984,0.0,0.1556528585969157,568,700,83,1351
439,FRO,0.1470596158879829,0.1292340554271032,0.1431421423980554,-0.1736812297425583,55,337,964,1356
440,TSCO,0.047198521332332,0.2109395871014819,0.0191662760461217,0.0247304725060217,473,155,729,1357
441,PEP,0.038827583279475,0.2046101557053218,0.0285922318132524,0.0339067412284064,561,163,633,1357
442,FTNT,0.0251868175909579,0.3493036526455549,0.0,0.0379930789135603,735,42,581,1358
443,NTRS,0.0633191729592322,0.0118013017847777,0.0379297457092556,0.1114961830000099,334,859,166,1359
444,SF,0.0708464969088684,0.0248530600911422,0.0271523372618432,0.0770150729875745,286,803,271,1360
445,URI,0.0617389801536533,0.1743349125364431,0.0103407697782109,0.0161479015748416,348,221,792,1361
446,KO,0.0420561938108308,0.1525791830788323,0.0312143786805793,0.0382603809104133,513,273,576,1362
447,E,0.0469341381770112,0.0883723460192555,0.0299646583288987,0.0580798892888438,476,516,375,1367
448,CNI,0.0514208891708034,0.1385022359387793,0.0189320287062638,0.0345365545399636,430,318,622,1370
449,PAG,0.0965450708604766,0.1171975352309324,0.0173344786362667,0.0053717633425977,168,371,838,1377
450,AEL,0.0474726366486666,-1.700427331221906e-05,0.0098483228310953,0.8770982833241566,467,902,9,1378
451,TSM,0.0514770192533033,0.1994629370617912,0.0176309365098624,0.0176568413434341,429,174,778,1381
452,LW,0.0637917489302441,0.1709628653383983,0.0092377584683404,0.0068097644561277,328,231,832,1391
453,REGN,0.0421881392319144,0.136464487065361,0.0,0.0391362857767526,509,321,564,1394
454,LVS,0.0325190433488702,0.1332680341092417,0.0081231025564335,0.0524672525776202,645,326,426,1397
455,MKC,0.0391141064418489,0.098633672695987,0.0240512100292591,0.0559413329569434,556,456,388,1400
456,CIB,0.0533722862657066,4.4055672288317495e-05,0.0287777356560028,0.1460704121892122,407,898,96,1401
457,OHI,0.0328445778599569,0.0903981174248315,0.0873215782185023,0.0786226067382258,638,505,258,1401
458,ROK,0.038942191139975,0.1613850057211084,0.016527577835933,0.0369950815829763,559,253,590,1402
459,HON,0.0406939900414081,0.1831526543525799,0.0205339946214599,0.03093404934042,533,202,670,1405
460,MA,0.0278049991078556,0.5555682859761687,0.0053598202835866,0.0288332500797763,707,10,691,1408
461,CLX,0.0075805389424963,0.3038728897715988,0.0296607664662777,0.0473147732652458,866,61,483,1410
462,ASB,0.0570344519063864,0.0051160428499903,0.0439657452620592,0.1187496592696826,384,881,146,1411
463,KGC,0.0573119850250377,0.0793707820264975,0.0202787782709297,0.0476241113544748,382,553,477,1412
464,DAR,0.0812962983100396,0.0552534958198627,0.0,0.0429570370238277,234,657,524,1415
465,VAC,0.0819755461136652,0.0699809251311397,0.0342102672757815,0.0367921742399914,228,597,592,1417
466,PXD,0.0928320365353449,-0.0418264514402925,0.0626925053285779,0.073676521115155,182,948,291,1421
467,BCS,0.0549541841887936,-0.0007685110932905,0.0236055337673483,0.135906849127106,397,915,110,1422
468,CAJ,0.0835689112762145,0.0947405444835459,0.0408751558935468,0.0253747552752155,221,478,723,1422
469,AMGN,0.0435912095927917,0.1002640867423376,0.0295670017723327,0.047757586927699,496,452,475,1423
470,EMR,0.2383928265814909,0.0750914779657421,0.0216048571181349,0.0049413446163347,14,571,840,1425
471,AXTA,0.0356183323853759,0.1005201382472709,0.0,0.0582627471404766,600,451,374,1425
472,TRGP,0.0428373693980452,0.1135004671441918,0.0219004641586321,0.0423453393116355,502,396,528,1426
473,TXN,0.042060328078312,0.2525492627807634,0.0294422296548184,0.008715726970452,512,93,822,1427
474,FMC,0.167596001183508,0.0980963753863444,0.0368419510736353,-0.0659857732998707,43,460,925,1428
475,BUD,0.0409982289624815,0.0753223867771112,0.0231281902010778,0.0662220036059404,527,570,331,1428
476,VMW,0.0253389263633097,0.1072906717605858,0.0433885725399139,0.0742426685682971,733,419,284,1436
477,BMO,0.0587084828304969,0.0050222399997253,0.0363548749348987,0.1064419090768735,372,882,183,1437
478,HIW,0.0613777648451275,-0.0005550148857658,0.0881191797502167,0.1099450906422241,353,913,171,1437
479,SRC,0.0531054153627323,0.0403042881490174,0.0667388854333165,0.0739853689317266,409,743,286,1438
480,AIG,0.0747334920969817,0.0074647263767781,0.0210476428469676,0.0725179507446693,259,876,303,1438
481,CHE,0.0309652164155678,0.2366406048854968,0.0026705338766744,0.0310715741599542,660,111,668,1439
482,LAD,0.1105221309302942,0.1185213907199172,0.0058309037900874,-0.1177555437759519,118,369,954,1441
483,JCI,0.050780516309595,0.0895436164067013,0.0269144975572759,0.046194066215651,437,509,497,1443
484,SHW,0.0299877252186374,0.2261644464859899,0.0078295982162023,0.033059558926357,673,128,643,1444
485,JBT,0.1830693815987933,0.0739892183288409,0.0040221216691804,0.0060017596782302,31,578,836,1445
486,MAA,0.0352838070147692,0.1545056578778168,0.0418323671170625,0.0381563296261369,604,268,578,1450
487,CACI,0.0486629059771564,0.1012157121742615,0.0,0.041023765089542,459,448,544,1451
488,UNP,0.0426313396791899,0.1464224679972914,0.021205399091091,0.0318983201581397,506,291,655,1452
489,PPG,0.035983657186248,0.1029952389561863,0.0169434858247057,0.05275714148094,596,442,420,1458
490,SWN,0.2159075375561065,-0.0949132722666147,0.0,0.0479794527902458,22,964,472,1458
491,AME,0.0345482346408868,0.1406362429330135,0.0060596505120369,0.0420688058052664,618,310,532,1460
492,WWE,0.0323791270797903,0.3069006608168129,0.0059096873044402,0.0208080586601719,646,59,756,1461
493,VRTX,0.0345198694436335,0.19549805033676,0.0,0.0312706376266023,619,179,665,1463
494,MDLZ,0.0502319187124178,0.1050441024857764,0.0218796016170241,0.0364862615854263,444,427,594,1465
495,ANET,0.0286499688498925,0.2808501717015876,0.0,0.0274456610712334,689,72,704,1465
496,MAN,0.0224378070985338,0.1150229500062027,0.0364614365351174,0.0682230621239203,765,387,317,1469
497,CFR,0.0858476009278334,0.0344402043613374,0.0343115908687354,0.0459714561211061,207,764,499,1470
498,BR,0.0323473346611847,0.1604688624601569,0.0169790164491788,0.0383746290200322,647,255,572,1474
499,NVO,0.0267251285917478,0.7082323535707135,0.0101451568415813,0.0223591374946577,719,6,749,1474
500,CUBE,0.0393129001233719,0.084986869355643,0.0425876591429901,0.0554751796312898,551,530,394,1475
501,WMT,0.0348654915193607,0.1688418841884188,0.013801438845263,0.0339866051042959,612,235,629,1476
502,SBS,0.069752360617948,0.1153813553703676,0.0,0.0141696511959582,293,384,800,1477
503,CHT,0.0399333300028161,0.1025557491545403,0.039412526250953,0.046342135677159,544,444,493,1481
504,IEX,0.0363176299337692,0.1385673544707263,0.0116184734580939,0.0381880396619468,589,317,577,1483
505,FNF,0.0375306706157352,0.0002033166020712,0.0362965866689896,0.4913831903247819,577,896,16,1489
506,FUL,0.0346865267798054,0.0881066219704254,0.0103875742178354,0.0620599810874576,614,518,359,1491
507,PHI,0.0949675974470686,0.0985694423586519,0.0832420573098826,-0.0058806117303963,173,457,862,1492
508,MSCI,0.0255539772538606,0.3460489543871154,0.0098112515942229,0.025478022277381,731,43,719,1493
509,IT,0.0247609011818518,0.2786617219456902,0.0,0.029535014919252,740,73,682,1495
510,CME,0.0426688215492832,0.0943262060861639,0.0427918207559066,0.0446685505859987,505,483,508,1496
511,SJR,0.0453917929017782,0.091719298245614,0.0351726981647286,0.0436688059984384,483,496,518,1497
512,FSS,0.0337904707437639,0.1578577946234295,0.0051093596169096,0.0352288198796166,625,263,610,1498
513,J,0.0385246248587138,0.0960500593681853,0.0074309150426584,0.0484483277851733,565,471,463,1499
514,MSFT,0.0285373338809775,0.2875738645407972,0.0078086152878395,0.02345542395173,693,68,739,1500
515,PAYC,0.0285675699934134,0.2714072317210457,0.0054352386329123,0.0241597270957947,691,79,733,1503
516,CMI,0.0216513537589946,0.0921892995497853,0.0271304718531075,0.0810968393177036,770,492,243,1505
517,AEM,0.0724193813672848,0.062763326378393,0.0238241857445347,0.0355756452637153,271,629,607,1507
518,GE,0.0855305278851081,0.0571013381593845,0.0053135197684135,0.032332181409158,208,650,650,1508
519,KWR,0.0295259344997143,0.0946362574524832,0.0082883583470745,0.0629077232901814,679,479,353,1511
520,SCI,0.0521354468657465,0.0605047320633334,0.0162992586701122,0.0492180694499707,420,635,456,1511
521,CTAS,0.0280890012907362,0.2463903172835864,0.0093750930584522,0.0263948178277476,699,99,714,1512
522,NYT,0.0287975419660259,0.1454934675393098,0.0086080222005879,0.0418788508388011,687,293,533,1513
523,NNI,0.02772945497585,0.0612340037250909,0.0119419152394029,0.108712356980879,709,633,173,1515
524,FCN,0.0406887863207572,0.1551763607795623,0.0,0.0259003725389561,534,267,716,1517
525,WAT,0.0330204364785969,0.2198456508448445,0.0,0.0227345134963215,636,137,746,1519
526,GS,0.0647750289312236,0.0239238287036933,0.0318626815632803,0.0562560021107714,325,809,386,1520
527,FDS,0.0280877225531587,0.1810386134813953,0.008315273272039,0.0350839006279602,700,207,613,1520
528,VLY,0.0904442951104377,-0.0009009697538898,0.0434973938557671,0.0529394973408106,190,916,415,1521
529,DXC,0.0220998554038032,0.0491716788013084,0.0,0.1835987987392882,768,691,63,1522
530,SID,-0.0125825025577768,0.0963902683305935,0.157411612413592,0.1140584722487289,902,468,154,1524
531,AVY,0.0308318242289346,0.1749088071747289,0.0157346506552038,0.033154937823918,664,219,642,1525
532,ORCL,0.0325497429232685,0.1468583229768258,0.0136549079178439,0.0367168066012259,644,289,593,1526
533,STZ,0.0379186197510722,0.138980044345898,0.0143517387942868,0.0331661703032853,572,316,640,1528
534,EDU,0.0280513078493191,0.0458884263596588,0.0,0.1309648925000185,701,709,119,1529
535,ODFL,0.0277791434665226,0.3302658052412216,0.0039240133944196,0.018194267475045,708,47,774,1529
536,NU,0.0261061903604897,0.0356007642557758,0.0,0.2155340076945022,725,761,46,1532
537,TREX,0.0228263914787572,0.3187699949680773,0.0,0.0248243564595426,759,51,727,1537
538,PH,0.0416016482848391,0.0726176882898823,0.0140617891675664,0.0519124432982736,523,586,430,1539
539,HLT,0.023916534856725,0.1905128863772583,0.0033118426883107,0.0356127894141769,751,185,605,1541
540,CHD,0.0326283941993658,0.1479460488023281,0.0115080294522644,0.0348522722679722,643,284,615,1542
541,COST,0.0260465458770796,0.2291378385247522,0.00517867592057,0.0279217978291325,726,121,698,1545
542,RYN,0.0350757389405011,0.1053510041704171,0.0343675241219864,0.0438717144212662,607,425,515,1547
543,GHC,0.0635339123863114,0.0295821569838861,0.0095795428378351,0.0515072579528712,331,782,435,1548
544,TM,0.0996573950770512,0.0878446403460054,0.0177389946789239,-0.0169696170727032,150,520,880,1550
545,CPRT,0.0293665620552247,0.23803728036816,0.0,0.0201094853183299,680,109,761,1550
546,ATI,0.0705271526962643,0.1163672654690618,0.0,-0.0197091458849346,290,378,884,1552
547,FICO,0.0197858719780524,0.5323233904138231,0.0,0.0214126565799533,786,13,754,1553
548,PEG,0.0841633090005155,0.0806628141143507,0.0373365908441616,0.015794986979808,216,548,794,1558
549,NOV,0.124591595525242,0.0712270007901569,0.0099121208927433,-0.0175657838605577,88,591,881,1560
550,INCY,0.0425591748642995,0.111973196807927,0.0,0.031976479333542,508,399,653,1560
551,MNST,0.0270946512024461,0.2291370399865897,0.0,0.0245233149990409,713,122,731,1566
552,MMS,0.0354432764526054,0.0903504768781742,0.0149125430055763,0.0489932231645751,601,506,459,1566
553,CX,0.0161917686893034,0.0926583388121849,0.0,0.0779340075375263,819,489,265,1573
554,FISV,0.0377561765191335,0.0846035787784715,0.0,0.0481182041035893,575,533,468,1576
555,ADBE,0.0193927240628657,0.3089000371609067,0.0,0.0248018221157726,791,57,728,1576
556,M,0.020554598298549,0.1037481720926652,0.0354322123051179,0.0610765206585458,779,436,363,1578
557,MET,0.0314927937482852,0.0023906005601833,0.0352048720988436,0.2504854590207405,654,890,35,1579
558,CLH,0.0400443826512786,0.1145745484097152,0.0,0.0328110735359073,542,390,647,1579
559,NVDA,0.0192948022097994,0.5984354865056174,0.0002560970051367,0.0175189801919015,794,8,781,1583
560,LEG,-0.0383518677331551,0.0950799252646875,0.0671157685330214,0.1074861556205531,929,476,179,1584
561,MKTX,0.0234694749626844,0.2224295138627157,0.0099731285402648,0.0279818386071539,756,131,697,1584
562,TTC,0.039065388137203,0.1597729717698557,0.0168134018097334,0.0186381120836579,557,258,770,1585
563,PFG,0.0328292508625185,0.0026915763369815,0.0329504114481792,0.1944047936184824,639,889,59,1587
564,TRI,0.0397930144353789,0.1283196037900114,0.013170823330745,0.0270201928764136,545,338,706,1589
565,FLO,0.0259070963079343,0.1186891687661071,0.0409789152602046,0.0462394311858288,727,368,495,1590
566,ROL,0.0203288240536429,0.2889015148325392,0.0123549775746393,0.0231771972333485,782,67,741,1590
567,IPGP,0.0427653230153401,0.0932216388081176,0.0,0.0362443722773172,504,488,598,1590
568,ATO,0.0576257827908673,0.0504218503772565,0.0279941655643156,0.0425280777538548,379,685,527,1591
569,PDI,0.0330717761098329,0.020032247817643,0.1416518688945045,0.1232375564188636,635,822,135,1592
570,JHX,0.0290218796075504,0.1864929888940193,0.0,0.0264450643464331,685,195,712,1592
571,FLS,0.0345523303588882,0.0908828348105237,0.0194194150935623,0.0478131514703704,617,501,474,1592
572,CR,0.0382023659491071,0.1520492901151888,0.0085541053883698,0.02252730371911,570,275,747,1592
573,ADT,-0.0268570355463741,0.0748165236870823,0.0206830265722886,0.1368560193698658,918,574,107,1599
574,VRSK,0.0175429549640027,0.3148246028875845,0.0056192277619071,0.0237189659645134,812,52,737,1601
575,WAL,0.1013886625749099,0.0834141394152278,0.0240699828787334,-0.0621609062215221,142,537,922,1601
576,ZTS,0.0257521524665274,0.2475598935226264,0.0076025979124731,0.0178089757458366,728,98,776,1602
577,TRQ,0.2057608973002174,0.0635853712443756,0.0,-0.1271275602617258,24,623,956,1603
578,NFLX,0.0251543674850299,0.1744110813239094,0.0,0.0322139714487413,736,220,651,1607
579,HWM,0.0343088713323143,0.1391716797778806,0.0032739184408613,0.0305864709132528,622,314,672,1608
580,TMUS,0.0437712560495216,0.0763892607387258,0.0039313608595638,0.0407766853278458,495,566,547,1608
581,ABB,0.0427878376738353,0.147530836907025,0.0293550498465342,0.0090762079914196,503,285,821,1609
582,RLI,0.0501851848825301,0.0040127857961579,0.0230805621128202,0.0755129603980106,446,887,277,1610
583,IDXX,0.0183283297564104,0.4752809115318201,0.0,0.0167631681902257,805,16,789,1610
584,RCL,0.051192418333462,0.1122425184609405,0.0,0.017496524828172,432,398,782,1612
585,ATR,0.0350722747234812,0.1262330183176117,0.0127823016874398,0.0316633897186164,608,347,658,1613
586,WAB,0.0359193502608229,0.0886686311277792,0.0054209571559278,0.0447339147420065,597,514,507,1618
587,WLK,0.0267780692078709,0.0675253494107974,0.0123548085489341,0.0727871526276575,718,608,298,1624
588,VTRS,0.0042079353968833,0.0514456964876804,0.0442794810684832,0.1788641789998791,877,681,67,1625
589,VMI,0.0293198915650991,0.1058534403448223,0.010118657820846,0.0429154522267786,681,422,525,1628
590,LYV,0.0263219660425755,0.1169833649728081,0.0,0.0418482717367383,723,374,534,1631
591,CAH,0.0105741778576715,0.0748635567912676,0.0212698979895692,0.0955322275417224,852,573,207,1632
592,GM,0.2066950669131141,0.0520549325659644,0.0121849466719787,-0.075109889033303,23,676,935,1634
593,JKHY,0.0300495790105991,0.2024719293272347,0.0120672525127332,0.01430782077474,670,167,798,1635
594,TER,0.0267980097506938,0.1847783752577494,0.0040534533681356,0.0254147907347221,717,196,722,1635
595,VNO,0.0195508017327072,0.0490929713735961,0.0354310328252075,0.1139769078926488,787,693,155,1635
596,DG,0.0556064808910072,0.0907965735527385,0.0173378921029541,0.023148564071116,392,502,742,1636
597,UA,0.0916824739161893,0.0810844090838445,0.0,-0.0468665842349562,185,545,909,1639
598,UAA,0.0916824739161893,0.0810844090838445,0.0,-0.0468665842349562,185,545,909,1639
599,ETN,0.0334820283600063,0.1301939058171745,0.0143479543531537,0.0298300109720752,630,334,678,1642
600,RSG,0.0331980774614757,0.1046030800020602,0.0122378354870985,0.0381020337912847,633,431,579,1643
601,STOR,0.0365138495940296,0.0308600462152152,0.0488928865715621,0.075100374423858,587,777,280,1644
602,BCH,0.1336624620752173,0.0478608826994383,0.0843330945589137,-0.0109835584846652,70,704,871,1645
603,NWL,-0.1079460536814612,0.0615152169220807,0.0511909120551259,0.1797246151500617,951,631,65,1647
604,WPC,0.0507471092942483,0.0012489005429123,0.0656628766675854,0.0681902236177151,438,891,318,1647
605,RJF,0.0817542170179089,0.0989261174276192,0.0166893312486243,-0.173333983982191,232,455,963,1650
606,AER,0.1881979130327079,0.0479431555036652,0.0,-0.0582671076371893,29,702,919,1650
607,BAH,0.0311698526679676,0.1974401582951097,0.0130407258210215,0.0098875433325253,657,176,818,1651
608,STN,0.0280473817935196,0.1188298587760591,0.0071896821083025,0.0376082193674579,702,367,585,1654
609,ENPH,0.0243572891084362,0.1563694610503258,0.0,0.0325391465501023,744,264,648,1656
610,KIM,0.0497654221095774,0.0322731334874433,0.0500078322354166,0.0510718658878688,448,770,440,1658
611,MDT,0.0347215669423782,0.0723810485907667,0.0346271121900866,0.0491164711916122,613,588,458,1659
612,OSK,0.0300135176862123,0.0702399818881593,0.0167930722879152,0.0555051597923283,672,596,393,1661
613,EW,0.0303150340325382,0.1878229143710668,0.0,0.0136076111833163,668,190,804,1662
614,MLM,0.0378498794577348,0.1123868758517069,0.0056342535936742,0.0284335521873872,573,397,693,1663
615,CBU,0.0472312941543225,-0.0014054873836653,0.0340483197648978,0.0751249098638024,470,920,279,1669
616,TR,0.0396015917741929,0.1034994335540165,0.0108043510676479,0.0292190567735104,547,437,686,1670
617,MDU,0.1028520820064721,0.0630432392267465,0.0400082141390332,-0.0464093895148697,138,625,908,1671
618,CDNS,0.0141900710203511,0.3124431180711926,0.0,0.0169912888218673,835,54,784,1673
619,VFC,-0.1626338846347889,0.0698981263327637,0.0508842519400607,0.1347927426037724,962,598,113,1673
620,HSIC,0.0420662465741183,0.0904942965779467,0.0,0.0316508057156227,511,504,659,1674
621,MHK,-0.0667095747673654,0.0777174474059087,0.0,0.1078709955127111,940,560,175,1675
622,TDY,0.0421355417171596,0.082370825432149,0.0,0.034309758029147,510,542,623,1675
623,FTV,0.0333582807655297,0.0749776793095466,0.00392994298693,0.0479992448344848,632,572,471,1675
624,HASI,0.052987805079761,0.0325020083086598,0.0568861661323517,0.0462210335248212,410,769,496,1675
625,RMD,0.0279890149580647,0.1888599949108778,0.0080539719274442,0.0174409486171677,704,188,783,1675
626,APO,0.093154471279074,0.0857042754242964,0.0190849461665469,-0.328541626464735,178,528,972,1678
627,MCO,0.0224596324793511,0.183220590661607,0.0,0.0262751145371375,763,201,715,1679
628,HOLX,0.0266262184823232,0.0842662632375189,0.0,0.0526101378345905,722,535,423,1680
629,SBAC,0.0182807655278103,0.124683869261009,0.0134774617081072,0.0429042731304357,806,350,526,1682
630,CMG,0.0194981028125408,0.2221088415490914,0.0,0.019403035166698,789,133,765,1687
631,COTY,0.0487051726963517,0.0547819603417701,0.0013129887169225,0.0386133689086188,457,661,570,1688
632,EBR,0.0478896635663677,0.0466581896981994,0.0090962461293124,0.0433851064822175,462,706,521,1689
633,TDG,0.0269143639679618,0.1589364363003643,0.0007879397771822,0.0256287780157171,715,259,718,1692
634,ETR,0.1103431424603702,0.0491113683886049,0.0437443337376746,-0.0194918796937256,119,692,883,1694
635,STWD,0.0520953569823613,0.0247432060319022,0.0923293383653922,0.0483400891449474,423,805,467,1695
636,IQV,0.0319321709897684,0.1031203566121842,0.0,0.035271175614619,650,440,609,1699
637,STR,-0.0086803638743636,0.0442089804456332,0.0847629550688612,0.1543440400802206,897,719,84,1700
638,WST,0.0226813048102865,0.2140798682585426,0.0021786895419385,0.0158432774584829,760,148,793,1701
639,BMI,0.0204836951706553,0.2018031663108085,0.0064266216559523,0.0217038949866484,780,168,753,1701
640,SPG,1.4973464902678512e-07,0.0910558283334387,0.0523670763585534,0.0673057247375399,882,498,322,1702
641,EGP,0.0241543403883847,0.1300267825606075,0.027182382501605,0.0345869538519924,748,335,620,1703
642,ALGN,0.0212529901067412,0.1636254606581626,0.0,0.0290372004329936,774,248,689,1711
643,LIN,0.0309169462103769,0.1232678895136264,0.0123787482649065,0.0275205209209324,661,354,703,1718
644,PKX,0.1819376395687841,0.0410668230836642,0.087363711810494,-0.1145721128835305,33,734,953,1720
645,EPAM,0.0242562393385164,0.1421902968981502,0.0,0.0310685017686717,746,305,669,1720
646,ZBH,0.0403168812372557,0.0744118672711177,0.0079098256255514,0.035135532046999,537,575,612,1724
647,WM,0.0317716018968639,0.125013113263629,0.0156651648241481,0.0251525181683506,651,349,725,1725
648,CARR,0.0280440559854154,0.0885426709344028,0.0128890398153873,0.0444463985891906,703,515,509,1727
649,GNRC,0.0256493632790662,0.091678395533717,0.0,0.0454688951314621,729,497,501,1727
650,AZN,0.028540577224188,0.1160859770180087,0.0214761253638264,0.0314737146316108,692,379,661,1732
651,JPM,0.0991325779395684,0.0160838242599683,0.0269337644656201,0.0233727378928797,154,839,740,1733
652,EQR,0.0360634885162749,0.0464075016242919,0.0428752668742957,0.0518373311343957,595,707,431,1733
653,ADSK,0.0166803705914388,0.2001438590181622,0.0,0.0230505783449021,817,173,744,1734
654,MTN,0.028715414536428,0.1048558882089673,0.0336630911270125,0.0347662039048059,688,429,617,1734
655,HTZ,0.1894178169596595,0.0425403319540657,0.0,-2.2225843847149664,28,727,982,1737
656,TEF,-0.0439262729977828,0.0320420142106889,0.0845531510506649,0.2702549172778388,934,771,33,1738
657,MPWR,0.0142308880216776,0.218160344248234,0.0061883155117079,0.0193342404228305,834,141,766,1741
658,KOS,0.0692304699626736,0.084807031408271,5.382286443332624e-05,-0.0542874919317175,295,531,916,1742
659,SAM,0.0180214956476717,0.0985283389381976,0.0,0.047520970503652,808,458,479,1745
660,BRX,0.0435606157497006,0.0612783950277762,0.0450169815753403,0.0347867255550377,497,632,616,1745
661,ELS,0.0239388307593017,0.1751351923738746,0.0261015397837574,0.0175941731625259,750,217,779,1746
662,AL,0.1320191067350097,0.0490727999837772,0.0280293209095425,-0.597357771805062,75,695,979,1749
663,BIP,0.0070507695500212,0.0454428091918409,0.1047937905669828,0.1099781799419984,868,712,170,1750
664,ABMD,0.0090681704672291,0.2428062147216561,0.0,0.0165829836945386,858,103,791,1752
665,CRL,0.0391925300337831,0.0864521012073106,0.0,0.0301707766536107,555,523,676,1754
666,NOK,0.0387292955347055,0.0634468854694773,0.0361667556797776,0.0387292955347055,562,624,569,1755
667,ASX,0.0255814462164927,0.0932396952516316,0.030512378485242,0.0411906246947928,730,487,539,1756
668,AVB,0.0351089149281589,0.0442820784581002,0.0348757689778703,0.0517178423381696,606,718,432,1756
669,KEX,0.0477173244322238,0.0654095729987424,0.0,0.0296443088757446,464,614,679,1757
670,JBHT,0.0352491785337954,0.1453208003758691,0.0084166841487901,-0.0057021633924565,605,294,861,1760
671,ICE,0.0326915951123856,0.0717866998328734,0.0131843215085845,0.0421484121106897,641,589,530,1760
672,AIN,0.0362945626727629,0.1086510730709465,0.0101786128201161,0.0207821646794446,591,414,757,1762
673,PEAK,0.0282538034317722,0.0251940429825587,0.0606627327449402,0.0778014844222527,697,800,267,1764
674,DOC,0.0282538034317722,0.0251940429825587,0.0606627327449402,0.0778014844222527,697,800,267,1764
675,NYCB,0.1083933106823517,0.0234830805134189,0.0236967684263439,0.0075336547020168,124,812,829,1765
676,SYK,0.0278425296197011,0.1215341814885436,0.0100197918599809,0.0275874163941177,706,360,700,1766
677,NEE,0.0593993527697008,0.0684630097775637,0.0307316487243513,0.0142444685916943,369,603,799,1771
678,FTI,0.0063622132532373,0.098130300693909,0.0049244889059755,0.0510675159881739,871,459,441,1771
679,WY,0.0329800658835425,0.0994751466502006,0.0477994757024883,0.029599510858531,637,454,681,1772
680,NJR,0.0671505253282363,0.0710186004170728,0.0382961736011084,-0.0157082978176378,312,593,878,1783
681,LPX,0.0349036033068222,0.1326860841423948,0.0135300484728693,0.0031374025444334,610,329,844,1783
682,LLY,0.0099867836052255,0.2812456589064939,0.0077549840708236,-0.0060068586221797,854,70,863,1787
683,HES,0.0313389031619728,0.1501663692916043,0.0122226257628823,-0.00376429661714,655,277,855,1787
684,INTU,0.0165799995409899,0.1309295539808253,0.006182726338901,0.0332851836422726,818,331,639,1788
685,ECL,0.024275713230644,0.1234629274090327,0.0109199138506715,0.0289582034238608,745,353,690,1788
686,PWR,0.0237624428236292,0.1028904921023549,0.0015237289253821,0.0364131709555823,753,443,595,1791
687,BLK,0.0453870102910124,0.0577104393667347,0.0250362733975322,0.0313056532268978,484,646,663,1793
688,SNPS,0.0172196743072038,0.1727428249461054,0.0,0.0211618547143901,815,224,755,1794
689,ABT,0.0298817158151186,0.1091068330722719,0.0185670769593853,0.0264147475639848,674,412,713,1799
690,PAC,0.0063540903723901,0.2731761865399983,0.0049927097947586,-0.0003422617762637,872,78,852,1802
691,SSL,0.060127299978961,0.0623623507592442,0.0,0.0127630811479504,365,630,808,1803
692,ADC,0.0283629028566951,0.0343938814061531,0.0475799005770857,0.0647584486808363,695,765,343,1803
693,LDOS,0.013419759280539,0.0639876352395672,0.0135546312331072,0.0646036652801829,839,622,344,1805
694,ASR,0.0068136067379235,0.2318839223861361,0.0039925225931036,0.0081529000777862,869,117,825,1811
695,SAP,0.0157829803256385,0.1225728381271525,0.0146740053881616,0.0339860993269864,824,357,630,1811
696,IR,0.0248728472705603,0.0847614332930504,0.0010349046507848,0.0406295899937752,739,532,549,1820
697,AGI,0.0394180674660609,0.0839957697285212,0.0066259894359616,0.0236640445937122,550,536,738,1824
698,LH,0.0211143539772952,0.0832376536184147,0.0128302533737631,0.0441532459606548,776,538,511,1825
699,VAL,0.170319562719185,0.014952905335532,0.0,-0.0843528594654988,40,844,943,1827
700,SXT,0.0336702740157662,0.0871796832866475,0.0249558184457177,0.0295008764207136,626,521,684,1831
701,R,0.0777514438701659,0.0640315052508751,0.0245127704812345,-0.1687168030778724,248,621,962,1831
702,HAE,0.0271637241378449,0.1098238293633205,0.0,0.0266777911357363,712,410,710,1832
703,JLL,0.0250569719281296,0.0704045245199455,0.0,0.0458673762978983,738,594,500,1832
704,MSA,0.0088277919365734,0.2159370217249794,0.0110738059477136,0.0075484454787015,860,144,828,1832
705,FCX,0.0302725611667909,0.130282067207813,0.0141370239647947,0.0074534714993993,669,333,831,1833
706,BXP,0.0172811551160707,0.0409493582699731,0.0624878901202824,0.0742235219690769,814,735,285,1834
707,ED,0.0796389053788951,0.0533832200303997,0.0346503534320242,-0.0739165386168546,238,668,931,1837
708,TMO,0.0292603253318667,0.086384777014425,0.0025526522349568,0.0338092199455948,682,524,634,1840
709,LHX,0.0307260421011384,0.0601193480390701,0.0217361080226472,0.0412435137249999,665,638,538,1841
710,TFC,-0.0221855856343355,-0.0001093770974301,0.0636691738048622,0.4136361112630797,913,909,20,1842
711,O,0.0219439137785144,0.030862477178727,0.0531245275585489,0.0727031367339642,769,776,300,1845
712,DOW,0.0152194070022915,0.0453447198500312,0.0509552981468912,0.0702573304570979,826,714,308,1848
713,OGE,0.0595728222724601,0.0559962106532317,0.0476239548492891,0.0077324608563821,368,653,827,1848
714,TFX,0.0304183560126287,0.0731053346753682,0.0054545566887332,0.035785156280365,666,583,602,1851
715,VMC,0.0309085121949846,0.1022468559291829,0.0075648351750262,0.0217737418741779,662,446,752,1860
716,ESS,0.0254744010436487,0.0445878611723261,0.0368455911464221,0.0527091141145679,732,715,421,1868
717,WEC,0.050208650865036,0.0537515872545711,0.0370735645445033,0.0197949178704902,445,664,763,1872
718,CS,-1.0002653516001097,0.0037989998068973,0.0383348341702752,1.6952211310583845,980,888,4,1872
719,EXR,0.0296049180167384,0.0443761774150578,0.0385668783071573,0.0474114433054024,677,716,481,1874
720,BURL,0.0266958317476389,0.0975640597993608,0.0,0.0276234488060894,720,463,699,1882
721,DEO,0.0095071090974122,0.1891669939657942,0.0056552713093021,0.0046949944230391,855,186,842,1883
722,IP,0.0229657105196111,0.0415500984353953,0.0511943963666332,0.055181498887399,758,731,395,1884
723,DLB,0.02521786765171,0.0857257364498697,0.0102183268600316,0.0342321325382109,734,527,625,1886
724,GPN,0.0297389543858799,0.0404384016504204,0.0078530586886355,0.0479630585340648,676,738,473,1887
725,ESI,0.0211421562063417,0.0550741633548331,0.0138560786652908,0.049552488043314,775,660,455,1890
726,RCI,0.0261942288391394,0.0737190082644628,0.0296189160018537,0.0374247344898422,724,580,587,1891
727,SR,0.073221229106701,0.0489121544249959,0.055715463986938,-0.0748371458869868,264,696,934,1894
728,DTE,0.0615051097230024,0.0577022020991973,0.0331079760284165,-0.0314349666014486,352,647,897,1896
729,AWR,0.0420098813767745,0.0946093265733717,0.0205793636846624,-0.040643192365998,514,481,903,1898
730,CCI,0.0300445307152318,0.0692226364698681,0.054468213806642,0.0340451340062081,671,601,628,1900
731,IBN,0.0286386950369293,0.025563768492247,0.0036229044097776,0.0531548786947291,690,799,414,1903
732,CIEN,0.0417011519763428,0.0765707229550908,0.0,0.0101680790420562,522,565,817,1904
733,TRMB,0.0236042910826885,0.064124513618677,0.0,0.0420904014776756,755,620,531,1906
734,ST,-0.0006841109783839,0.0807194525984032,0.0125206866838593,0.0476140662724638,884,547,478,1909
735,FIS,-0.1874293865279001,0.0429499551471987,0.0346747181869319,0.090503549581326,968,725,217,1910
736,TECH,0.0222331566177608,0.1190925123785795,0.0039191703113411,0.0168464699935581,766,366,787,1919
737,KBR,-0.0354261498459296,0.1224643125469571,0.0096252180713469,0.0335545796653899,925,358,638,1921
738,SNN,0.0221372272407419,0.121435977190254,0.0275242331092114,0.0152351259717653,767,361,796,1924
739,UDR,0.0352985750144487,0.0272657097590551,0.0432637576915629,0.0413330137431116,603,791,537,1931
740,JWN,0.045705460369955,0.0523082650781831,0.0419535195933169,0.0177364473077437,481,674,777,1932
741,AKAM,0.0303402989053721,0.0774526784480007,0.0,0.0275582363967517,667,563,702,1932
742,ING,0.1505118221041959,-0.0006146956733271,0.061282911511342,-0.2393069810483346,49,914,969,1932
743,ALB,0.0928306606710042,0.016391562583488,0.0110435657802749,-0.0486113236976481,183,838,912,1933
744,IVZ,-0.0119428635659098,-0.0142056128789849,0.0732963979633288,0.1400729044649794,900,933,101,1934
745,OUT,-0.1869675291615479,0.0531473576624782,0.0899216508746292,0.0727192480986132,967,670,299,1936
746,NI,0.0646574256242727,0.0501896397426013,0.0413941491501888,-0.0643315587164645,327,686,924,1937
747,WCN,0.0198415087820264,0.09179805131308,0.0070387934484156,0.0315958560687348,785,495,660,1940
748,CPT,0.0373844228956054,0.0362617785587401,0.0403104094050131,0.0355960728440943,579,756,606,1941
749,DHR,0.0279607148434948,0.0682551762143438,0.0073247212688248,0.033929658377465,705,605,631,1941
750,RBC,0.0268492840516658,0.0790091918892411,0.0029420368422501,0.0308913868436269,716,555,671,1942
751,BX,0.0140675693346938,0.0828100248252547,0.0431717143994922,0.0387642509057917,837,539,568,1944
752,FRC,0.0754688245764567,0.0147082388474256,0.0157736642357999,0.0024929641751982,254,846,847,1947
753,ACM,0.0048070864398169,0.0602130922337717,0.0083568867711066,0.0512905315611062,875,637,436,1948
754,NOC,0.0289890996191514,0.0733194613028148,0.0157353283924966,0.0296094889106119,686,582,680,1948
755,TRP,0.0548170390687241,0.0525539450789192,0.0540103543733254,-0.0160961736895843,398,672,879,1949
756,MTZ,-0.0085078221239212,0.0219624896263641,0.0,0.0842003394953,896,819,236,1951
757,NLY,-0.1715341340738539,-0.0179282948037507,0.1584424204177171,0.2056939558796495,964,939,50,1953
758,NWE,0.0627435534418704,0.0425227088290931,0.0497892887159709,-0.0250992313086976,337,728,891,1956
759,DEI,-0.017850429608689,0.0157859764586761,0.0528209571046007,0.096702670204194,909,841,206,1956
760,NEA,0.0122108537662188,0.005970583595519,0.0473082370494075,0.0853593297434613,846,879,231,1956
761,C,0.0929451676691342,0.0081215690508364,0.0524956885448122,-0.0411948131520111,180,872,905,1957
762,BIIB,0.0310089576655753,0.0553939471604621,0.0,0.0330039358221669,658,656,646,1960
763,CP,0.0402858698514211,0.0591438430019409,0.0072528927896497,0.0168037318096836,539,641,788,1968
764,SWH,-0.020162589844776,0.0510443967020235,0.032850998849051,0.0580372184390818,910,682,377,1969
765,SWK,-0.020162589844776,0.0510443967020235,0.032850998849051,0.0580372184390818,910,682,377,1969
766,ALK,0.04722155171526,0.079032967032967,0.0,-0.089218591325853,471,554,945,1970
767,SJI,0.070840471324085,0.0412920530332961,0.0,-0.1021953974198793,287,732,951,1970
768,EVRG,0.060911211061136,0.0438367511729245,0.0474429451940696,-0.0294685990338164,355,721,895,1971
769,SRE,0.0652838242346569,0.0398230662463841,0.032418991741893,-0.0462612855308349,320,746,907,1973
770,GLOB,0.0156377087886091,0.1165508099760703,0.0,0.0185059733930822,825,377,772,1974
771,STT,0.0778589617925095,0.0078615604993923,0.038849379083711,-0.0050464141902552,247,873,860,1980
772,AMH,0.0292023196982439,0.0289536232088686,0.0256130970645132,0.044042218235583,683,784,513,1980
773,EXC,0.0651072255596201,0.0437496601598608,0.0400767415064156,-0.0756507925853833,323,722,937,1982
774,SE,0.0065682058914068,0.0113671836942344,0.0,0.0795160359859745,870,862,254,1986
775,PTC,0.0146446321887006,0.0817638888789811,0.0,0.0349652671121984,830,544,614,1988
776,APD,0.0365112154288694,0.0887546385737208,0.0237556234287653,-0.0225413342450819,588,512,889,1989
777,ALL,-0.0051163771695276,-0.0034732980024459,0.0280856448880452,0.1077977125983984,890,925,176,1991
778,HMC,0.0404445775445445,0.0644258558408791,0.0088352216975934,0.0050634717101214,535,618,839,1992
779,ROP,0.0238182413176384,0.0692421531246652,0.0049935367940894,0.0331600439555129,752,600,641,1993
780,CCL,-0.0038935646742138,0.0519673742660538,0.0,0.0524578916242057,888,678,427,1993
781,CUK,-0.0038935646742138,0.0519673742660538,0.0,0.0524578916242057,888,678,427,1993
782,AMZN,0.019433571154681,0.1015382835037485,0.0,0.0205781877367414,790,447,758,1995
783,HAS,-0.2101415411151033,0.0428810346749916,0.0547471415783657,0.0728503845281191,973,726,297,1996
784,ISRG,0.0151754504897467,0.1281887570014801,0.0,0.0063267617837119,827,339,835,2001
785,NSC,0.0340638179569905,0.0730650948231676,0.0228397246838059,0.0154750787653542,623,584,795,2002
786,CRM,0.0151069286379518,0.0787528716770594,0.0,0.0346918781922792,828,556,619,2003
787,TW,0.0190458806838854,0.0819499942989926,0.0039624238948903,0.0313014731605882,797,543,664,2004
788,DUK,0.057419460385384,0.0431198285648375,0.043358642804978,-0.0362213076453423,380,724,900,2004
789,SMG,-0.1313370743034055,-0.066060606060606,0.0515189628482972,0.1514125386996904,956,958,90,2004
790,THG,0.0081435967567722,0.0002726322645138,0.0270376640196516,0.0806977378333972,864,895,245,2004
791,FNV,-0.0223239301789098,0.1267501970182228,0.0109515537105556,0.0224770961179797,914,343,748,2005
792,CBRE,0.034341333736082,0.0779587556798322,0.0,0.0079758270036133,621,559,826,2006
793,DXCM,0.0113050990485344,0.1269406392694063,0.0,0.0106871287219663,850,342,816,2008
794,TU,0.0246088258175208,0.0506236872562047,0.0384787228894648,0.0376886654613161,742,684,583,2009
795,AEE,0.0605966497627262,0.04156329198346,0.0348220331101777,-0.0634897189788286,360,730,923,2013
796,RH,0.0250609826546451,0.111028975897187,0.0,-0.0131909008035229,737,402,874,2013
797,SO,0.051925636637559,0.0462880569503591,0.0396363951697665,-0.0201381618951499,426,708,885,2019
798,STE,0.0173226881121526,0.0893570930178622,0.0091857570336598,0.0280719519482859,813,511,696,2020
799,XEL,0.0518225380929306,0.0442945898300443,0.0319538179545342,-0.0154209359542486,427,717,876,2020
800,CNP,0.0508705245135352,0.0490920755348525,0.0296790955449742,-0.0290688711505915,435,694,893,2022
801,REG,0.0309006971277016,0.0273015930027279,0.038692134353363,0.0384651408601426,663,790,571,2024
802,TSLA,0.0190179606436877,0.1141774752793116,0.0,0.0055244519317652,798,391,837,2026
803,EDR,0.0502611168903218,0.017045014494479,0.007682627329315,0.0220067552271966,442,836,750,2028
804,UMC,0.0185899957304335,0.117104717978679,0.0140197578241264,-0.0025112062735976,802,373,854,2029
805,RPM,0.0470514237489383,9.047091937315578e-05,0.0210258061191518,0.0317158310916017,475,897,657,2029
806,CMS,0.052454218762123,0.0403304813532754,0.034240127016087,-0.0156712153009724,414,741,877,2032
807,STAG,0.0272554083234134,0.0411401106036103,0.0378161105492533,0.0374213668149211,711,733,588,2032
808,PRGO,-0.0029168888784768,0.0164700524786398,0.0343825405596843,0.0697756567938016,887,837,310,2034
809,FE,0.0524607520263084,0.0522348493580138,0.0431301645515748,-0.0937343200905638,413,675,947,2035
810,VEEV,0.0157888609400309,0.09072921450107,0.0,0.0265841103642572,823,503,711,2037
811,ANSS,0.0158810742776516,0.0973229372568714,0.0,0.021955090424643,822,464,751,2037
812,PNW,0.061543203361399,0.037876508728766,0.0474234962214338,-0.0783679269164518,351,751,939,2041
813,LNT,0.0541648367735324,0.0479069294858768,0.0351339481774264,-0.0760465062524559,401,703,938,2042
814,DD,0.0122216162136872,0.0484289501889772,0.0188091540309938,0.0454193396877455,845,699,502,2046
815,HEI,0.0185719553879264,0.0957681040277218,0.0012594634708162,0.0183743157968721,803,472,773,2048
816,NDAQ,0.0360750949999475,0.0677951538064959,0.0150227732719328,0.0016351317847001,594,606,849,2049
817,FR,0.0394490948602016,0.0673047374409139,0.0243123191454741,-0.0252387734211631,549,609,892,2050
818,RTX,0.0266286303699404,0.0309361642978767,0.026995347032312,0.0393136931001593,721,775,562,2058
819,H,0.0160878362688094,0.0434359805510534,0.0034369468392456,0.0438027905682584,820,723,516,2059
820,ELP,0.0193898518170983,0.0741131930044353,0.0064412599987816,0.0283299606095637,792,577,694,2063
821,AEP,0.0523924853044546,0.0417882877166264,0.0417697256147647,-0.0591832689166709,416,729,920,2065
822,KKR,0.051929196879028,0.0373604076377046,0.0085573109208874,-0.0222924438793436,425,752,888,2065
823,ZBRA,0.0210778730367583,0.1051156271899089,0.0,-0.0064800217781926,777,426,866,2069
824,FRT,0.0282821797152344,0.0499429760248649,0.0428668027961007,0.0292040939220416,696,688,687,2071
825,X,0.0818501038991043,-0.0161182815245712,0.0,-0.0435314519061158,231,937,906,2074
826,KNX,0.0233682298353631,0.0308170456724462,0.0098088905832562,0.0411829417227562,757,778,540,2075
827,WPP,0.002753038917442,0.0947725627696675,0.0105433410715081,0.0254606225969958,879,477,720,2076
828,QRVO,-0.0062773654429796,0.0172223069451153,0.0,0.0630181540735545,892,833,352,2077
829,POR,0.0538126955666646,0.0458597464342313,0.0422476864317235,-0.2213873177260152,402,710,968,2080
830,UNF,0.0331739528313197,0.0580189912391553,0.0070716318225607,0.0140059907920953,634,645,802,2081
831,LXP,0.0082879535781957,0.000735113399007,0.0527681080770412,0.0665137535853282,862,892,328,2082
832,PUK,0.0552852055197451,-0.0034095467308463,0.017323347761331,0.0195009543279524,395,924,764,2083
833,ASH,0.0411176611904717,0.0313696881269378,0.017555855339752,0.0168628610500249,526,773,786,2085
834,TEVA,-0.0478499207351939,0.0138639856557377,0.0,0.0720744781020273,936,849,304,2089
835,IDA,0.052380475053638,0.0399749191580243,0.0327975833865397,-0.0690083855767047,417,745,928,2090
836,HXL,0.0169411387586649,0.0827249673403519,0.0067636334495331,0.0238650478823576,816,540,735,2091
837,RNG,-0.0512807398925674,-0.1359703497573468,0.0,0.1069931486647393,937,974,180,2091
838,NWSA,0.013256463638143,0.0171181899374813,0.0154807025036032,0.0527589458887168,840,834,418,2092
839,NWS,0.013256463638143,0.0171181899374813,0.0154807025036032,0.0527589458887168,840,834,418,2092
840,EFX,0.0179422564685815,0.0909852840853717,0.0063108835332366,0.0169617333753049,809,499,785,2093
841,TD,0.0763671535252721,0.0084104796385001,0.0412575282215461,-0.475584204285654,251,871,977,2099
842,PLD,0.0242162046674972,0.0345438189175843,0.0255569476379325,0.0370555788911457,747,763,589,2099
843,SPGI,0.0187221634368154,0.073810223266745,0.0081775786222495,0.025431057493953,800,579,721,2100
844,RBA,0.0184900090970793,0.0655125989576479,0.0294049345640719,0.0293879756889,804,613,685,2102
845,PHG,-0.0238216447839388,-0.0054448179536953,0.0001022388188151,0.0762701588361303,916,929,274,2119
846,BSX,0.0189647530599861,0.0775750753236433,0.0003333415478214,0.0202743091407133,799,562,760,2121
847,EIX,0.0513866169089361,0.0359075997813012,0.0445569812572154,-0.0747607710110819,431,758,933,2122
848,PCG,0.0606224767506352,0.0246438588721582,0.0,-0.1334715611792576,358,806,959,2123
849,SUI,-0.0120782832830374,0.0350445415342714,0.0288860148395534,0.0489861700018372,901,762,460,2123
850,KRG,0.0094726543535695,0.0194163006378786,0.0419897571166501,0.0502710005243225,856,824,448,2128
851,D,0.0507239740732826,0.0398197644164813,0.0568037282375326,-0.0931805000152629,439,747,946,2132
852,MMM,-0.1381688547846324,-0.2587081597369838,0.0654005830152849,0.1000464974244693,958,978,199,2135
853,PANW,0.0058017198319013,0.057262404636584,0.0,0.0347179559283575,873,649,618,2140
854,DNB,-0.0093313203358818,0.0266015938716253,0.0170941847004134,0.0501905910832115,899,793,450,2142
855,AWK,0.0370572900207936,0.0534337584822538,0.020883981240532,-0.0337598192986044,582,667,899,2148
856,XYL,0.0245391432844009,0.0528510821888257,0.0120479537636057,0.0228064944153874,743,671,745,2159
857,AMT,0.0147425279893677,0.0583021285066087,0.0293131111703918,0.0290646360138259,829,643,688,2160
858,NEP,0.071798951448113,-0.0013435700575815,0.2660151151152589,-0.1931391793954241,276,919,965,2160
859,TRNO,0.029058154573574,0.0400219041695212,0.0260642189870998,0.0242933746767405,684,744,732,2160
860,VTR,-0.0020459738089705,0.0282508745107125,0.0361306900457608,0.0466953212123852,886,787,490,2163
861,LYG,0.0447308603410272,0.0088386941289463,0.0135257601507391,0.0111007904326175,488,869,814,2171
862,EC,0.011096517510387,0.0961688975161493,0.0029351842737485,-0.0044808742823659,851,470,856,2177
863,CTVA,0.0216333757955784,0.0288765458618467,0.0129211591486516,0.03455453494423,771,785,621,2177
864,NOW,0.0120024338414695,0.0760327279984035,0.0,0.0187490358794532,847,567,768,2182
865,BDX,0.0200506710560615,0.0457530505645982,0.0150515145259114,0.0285762596250473,784,711,692,2187
866,AEG,-0.0144997627599039,-0.001305653043574,0.0400161050468858,0.0605911873989283,905,918,365,2188
867,MS,0.059857322591907,0.0119493152438243,0.0379616760313811,-0.2433815731402862,366,857,970,2193
868,PPL,0.0370487643245793,0.0454089592155114,0.0352463920060862,-0.0316416473691001,583,713,898,2194
869,PFSI,0.0327531236070452,0.0737017876041036,0.0093842354345315,-0.3664368913925612,640,581,974,2195
870,FMX,0.0083023280220791,0.0921769116644612,0.00237584926181,0.0024912418767708,861,493,848,2202
871,KRC,0.045470522968154,-0.0001944471204649,0.0547233365926262,0.0125908878814103,482,911,809,2202
872,DV,0.011579452597249,0.07582886464178,0.0,0.0166454023482577,848,568,790,2206
873,WRK,-0.1799978605469577,-0.0671053040494044,0.0307055173874222,0.0748590253263211,965,959,282,2206
874,WD,0.0295774246774859,0.0523887121335899,0.0233727693577428,-0.0046061734510361,678,673,858,2209
875,BFAM,0.0136457908238167,0.047610712839837,0.0,0.0303570723472323,838,705,674,2217
876,IFF,-0.1242290172830895,0.0305290227773695,0.0400051338307337,0.0453326940261098,955,779,503,2237
877,EL,0.0143132753694055,0.0878602620087336,0.0131608148277337,-0.0221670805422802,832,519,887,2238
878,GLW,0.0225005421817393,0.0368057565857491,0.0383012671561793,0.0238172692629426,762,754,736,2252
879,AU,-0.0305951449965292,0.0956958393113343,0.0139305553813984,-0.0079417184884607,922,473,867,2262
880,SCHW,0.0403773332313341,0.0189735315349582,0.0181367299061607,-0.0388234394124847,536,826,901,2263
881,TYL,0.0094427347861828,0.0594573564320743,0.0,0.018634659645819,857,639,771,2267
882,AR,0.0357270326048783,0.0291827423359474,0.0,-0.0215452895301991,599,783,886,2268
883,SWX,0.0336478604416024,0.048066533602342,0.0389295547636495,-0.081017199246059,628,701,941,2270
884,GMED,0.0203891001221137,0.0283658901991931,0.0,0.0274168374474151,781,786,705,2272
885,XRAY,-0.0174948443223928,0.0496215306980656,0.0153742571317997,0.0302183674659513,908,690,675,2273
886,MRK,0.0013196726604391,0.0368234524147639,0.0269177067314224,0.0330568962586159,881,753,644,2278
887,FAF,0.0322566630541584,0.0176799567021468,0.0322269059849203,0.0135245879687407,648,832,805,2285
888,COO,0.0190641337677519,0.0498695029888025,0.0001943997325059,0.0139319808295943,796,689,803,2288
889,DIS,0.015888293284125,0.0194336161430864,0.0,0.0330522396823961,821,823,645,2289
890,MAC,-0.0824031195304747,0.0255885264539705,0.0478937219638017,0.040890817335395,946,798,546,2290
891,CUZ,0.0224574180549758,0.0265204533069329,0.0526084433319485,0.0240490868490558,764,794,734,2292
892,GOL,-0.0683485059782147,-0.1036552142495524,0.0,0.057404239282772,942,969,381,2292
893,DNP,-0.0569175431627175,-0.0490478467113992,0.0854965200734807,0.0533158238834794,939,952,412,2303
894,XPO,0.0186015566255004,0.0742121314808539,0.0,-0.0837562152820153,801,576,942,2319
895,AMRC,0.0378314002196365,0.030095597739221,0.0,-0.3765323473308908,574,780,975,2329
896,AJG,0.0200613689588482,-0.0965057831454277,0.0097999632170299,0.0380348656867034,783,966,580,2329
897,NCLH,0.0195377654749285,0.0691906499109689,0.0,-0.0875492422906439,788,602,944,2334
898,PFE,0.0130430524756039,0.023698008471968,0.0569179359329448,0.0295022890587871,842,810,683,2335
899,NGG,0.0114784808086736,0.0628278273672586,0.0086113668250224,-0.0091075980914236,849,628,869,2346
900,KMX,0.0383391908386099,-0.0048665318045148,0.0,-0.000535240078777,567,927,853,2347
901,CAE,-0.0367092060560125,0.0628302366333587,0.0,0.0144660615440698,926,627,797,2350
902,STX,-0.0413052457662123,-0.0688960515713134,0.0454435785178366,0.048879175519185,931,961,461,2353
903,FLR,0.014126457322781,0.0385826771653543,0.0049357501489234,0.0180410177857203,836,749,775,2360
904,HR,-0.0431335793195082,0.0041247054669117,0.0723307190110051,0.0411697038506615,933,886,541,2360
905,EQIX,0.0128544018529242,0.0501157842213198,0.0182258653058872,0.0074554570491265,844,687,830,2361
906,REXR,0.0209120267609828,0.0279356645856667,0.0276454224440806,0.0141440143355491,778,789,801,2368
907,IRM,0.0090179576213143,0.0604935917132433,0.0361067796354775,-0.0113330206588519,859,636,873,2368
908,WELL,0.0073147513114258,0.0260276064798662,0.0271125470565624,0.0268574618431993,867,795,707,2369
909,LAZ,-0.02580537312163,-0.0456881261990455,0.055884895369388,0.044031453167971,917,950,514,2381
910,CCJ,0.0145919164930303,0.0281251368646578,0.0021059685103119,0.0199645038368741,831,788,762,2381
911,ORA,0.0276212354617877,0.0367249399359959,0.0063085277368814,-0.0686055721947452,710,755,927,2392
912,WDAY,0.0181544751878757,0.0106168289900851,0.0,0.0251217973092183,807,863,726,2396
913,CALX,0.010172873987283,0.0339223280117418,0.0,0.0133196136271344,853,766,806,2425
914,DLTR,-0.0327915749562885,0.0403248147378627,0.0,0.0189477760339371,923,742,767,2432
915,MC,-0.0064239904317538,-0.0697955187789935,0.0473752389103868,0.0368734449976828,893,962,591,2446
916,CDAY,0.0051510924451897,0.0362078346028291,0.0,0.009879193722435,874,757,819,2450
917,BIO,-0.0675754567002412,0.0325906222776293,0.0,0.0231424234859581,941,768,743,2452
918,ARES,0.0216157490814906,0.0226511686126152,0.0469689994704562,-0.0136916848687176,772,815,875,2462
919,PNM,0.0246095059223709,0.0336142995141237,0.0352947212991421,-0.1461430715212756,741,767,961,2469
920,HUN,0.0226555844221098,0.0138248847926267,0.0379088491815501,-0.0047105670580624,761,850,859,2470
921,LUV,0.0270606857701529,0.0092443564029548,0.024907469913173,-0.0226378640098698,714,868,890,2472
922,AUY,-0.261708570233604,0.053687562856185,0.0214933367842704,0.004369936710938,974,665,843,2482
923,DLR,0.0236111629679043,0.0185111211244498,0.0378401511113235,-0.0470516694532123,754,827,911,2492
924,PKI,0.0130347964895479,0.0248107139042258,0.0025390923497297,0.0007191892304445,843,804,850,2497
925,AAP,0.0081979304128236,0.0148668486575421,0.0577020161389307,0.0123965610587591,863,845,811,2519
926,PENN,-0.1238110976182282,0.0249481961274032,0.0,0.0186980024974467,953,802,769,2524
927,RKT,-0.008328623793096,-0.0022519476254158,0.0,0.0268385258017437,895,922,708,2525
928,YPF,-0.1948403713179253,-0.0620432513049962,0.0,0.0356415313386448,971,954,604,2529
929,BA,-0.0140714999892215,-0.0187689692849338,0.0,0.0280733390874073,904,940,695,2539
930,ARE,0.0047834560764205,0.0312920284754312,0.0391155617674149,-0.0395895734223406,876,774,902,2552
931,MANU,-0.00921163299199,-0.0361723429160862,0.0,0.0257474746276568,898,946,717,2561
932,ES,-0.0204967372240355,0.0486968480834752,0.0429416470522568,-0.1247067766096819,912,698,955,2565
933,OFC,-0.0270521412504934,-0.0176264729723225,4.197612738102126e-07,0.0267737732478613,919,938,709,2566
934,HDB,0.0192074265952894,0.0189987368003447,0.0025198585656339,-0.0965984031219516,795,825,948,2568
935,CWT,0.0175725248917078,0.0145055138561775,0.0199844267979207,-0.0561693871295308,811,848,918,2577
936,TAL,-0.0003977014359372,-0.0222776892091516,0.0,0.0205780718360864,883,941,759,2583
937,AMD,0.003589445751748,0.0065527158637819,0.0,0.004711672936428,878,877,841,2596
938,CVT,-0.0384403731892883,-0.0406671794855289,0.0,0.0253686527880201,930,947,724,2601
939,FL,-0.1187117828998914,0.0398063474986551,0.0406497923263264,-0.0543196339935866,952,748,917,2617
940,MBLY,-0.000773140088976,-0.0021310946076848,0.0,0.0084759061606259,885,921,824,2630
941,NEM,-0.0724238192489928,0.0131291912418195,0.0406504181821994,0.0027866364407585,943,852,846,2641
942,UGI,-0.3112606304208982,-0.1100022853660394,0.0638270800064158,0.0275616936391341,977,970,701,2648
943,NRG,-0.0171366520750619,0.0232192526303059,0.0323221011910821,-0.0715158301944416,907,814,929,2650
944,TTM,-0.0764647887017587,0.012611158036458,1.0411038202837614e-05,-0.0060260858314058,945,855,864,2664
945,ILMN,-0.0543016646897929,-0.0081957616204191,0.0,0.0131427801703977,938,930,807,2675
946,HUBS,-0.006088460922513,-0.098364887513622,0.0,0.0086586724360288,891,968,823,2682
947,INTC,0.0080219427920065,0.0005687412471945,0.0146665241810042,-0.0678184257709068,865,893,926,2684
948,SNOW,-0.0130293827845126,-0.1993340316629926,0.0,0.0123212650018531,903,975,812,2690
949,MXL,-0.0381233945985341,-0.044539975388287,0.0,0.0122807708713311,928,949,813,2690
950,AES,0.0193349251645215,-0.0053895289152503,0.0344767340283035,-0.3641799157494224,793,928,973,2694
951,WK,-0.0232169748876075,-0.1287202462007734,0.0,0.0124739012068168,915,972,810,2697
952,LUMN,-5.717031199437558,0.0403490355596378,0.0061067530776668,-0.5218498084551666,982,739,978,2699
953,BEP,-0.0067469334493962,0.0138000076668452,0.1311835337100432,-0.1273821053532194,894,851,957,2702
954,GWRE,-0.0160475527561572,-0.0903466461021124,0.0,0.0030082257046274,906,963,845,2714
955,MPW,-0.1893597756723873,0.0049744545443641,0.2094072562896341,-0.0080198089280522,969,884,868,2721
956,TSN,-0.0369862380372636,-0.0132764183920408,0.0382419436496398,-0.0106734977051979,927,932,870,2729
957,GME,0.0014908359206011,-0.0156077565820589,0.0,-0.0530915597993201,880,935,914,2729
958,NEWR,-0.0351284643148866,-0.4301764196358282,0.0,0.0066352914695669,924,981,833,2738
959,ENV,-0.088523550288856,-0.1290330519373163,0.0,0.0091095559094166,948,973,820,2741
960,LNC,-0.1644394633722437,0.0235447016865139,0.0846250961769392,-0.4535205412686614,963,811,976,2750
961,WBA,-0.1409766348620937,-0.0954600307935583,0.0759351419598095,0.0064538004920633,959,965,834,2758
962,CTLT,-0.0295610690913539,-0.0147708894878706,0.0,-0.0410287252043791,921,934,904,2759
963,HCP,-0.0450005540457791,-0.2032281139230895,0.0,-0.0045879002774241,935,976,857,2768
964,HL,-0.0290976124270932,-0.0156550712001917,0.005393608324587,-0.0509353243854653,920,936,913,2769
965,TTWO,-0.1467450519302371,-0.0465419703379032,0.0,-0.0061845972957084,961,951,865,2777
966,S,-0.0428511019461759,-0.2146949761456444,0.0,-0.0110247397273868,932,977,872,2781
967,W,-0.1049219483067474,-0.56855151045701,0.0,-0.0002843413233245,949,982,851,2782
968,TV,-0.2658086883156999,0.0158288373714217,0.0324217467704518,-0.2589487549928271,975,840,971,2786
969,RIG,-0.1956200787401575,-0.0045076099061356,0.0,-0.0539288057742782,972,926,915,2813
970,KMPR,-0.0873199620911857,-0.0638979400231954,0.0257049943531935,-0.0603313225767839,947,956,921,2824
971,AA,-0.1075677461996034,-0.031901509705248,0.0118968935888962,-0.0727032385988103,950,945,930,2825
972,TEO,-0.2842120131096284,-0.0648327914552615,0.0,-0.0302826449852364,976,957,896,2829
973,MU,-0.0763038034692394,-0.0965724755837213,0.0065930253640488,-0.0800189209362828,944,967,940,2851
974,SPR,-0.1818907427589065,-0.0267267140872932,0.0,-0.1103387855295021,966,943,952,2861
975,WDC,-0.1414389632009975,-0.0676493814161621,0.0,-0.1007317352222813,960,960,950,2870
976,BAK,-0.1342455948756865,-0.0623522238910285,0.0002052236654574,-0.1990962731602505,957,955,967,2879
977,MRNA,-0.1240856122285133,-0.275063266497956,0.0,-0.1006846556584776,954,979,949,2882
978,CEA,-0.3354717798420933,-0.0523955268384762,0.0,-0.1291733027621429,978,953,958,2889
979,KEP,-0.8010410416763826,-0.0253157364889634,0.0075282974070141,-2.0603174193197447,979,942,981,2902
980,NIO,-0.1932175677050099,-0.3802156801451961,0.0,-0.1436531229006565,970,980,960,2910
981,LPL,-1.1253666198746497,-0.1147541837967621,0.0,-1.0083417336205311,981,971,980,2932
