,ticker,eps,roce,divYield,fcfYield,eps_rank,roce_rank,fcfYield_rank,overall_rank
0,PBR,0.5272502737700023,0.3665594855305466,0.542769914299835,0.577825874123715,4,37,13,54
1,CVI,0.2525327159581629,0.3712396694214876,0.1487611447711935,0.2252762589691805,13,32,35,80
2,VLO,0.1925256047069078,0.2545248631530379,0.0316408803660928,0.1593593375463063,23,92,73,188
3,BTU,0.2024209503018726,0.1970460155324998,0.0081543984718763,0.3761416157860627,20,167,21,208
4,HRB,0.1131749028044859,0.3675644816252913,0.0363674274543763,0.1537361584252744,102,34,76,212
5,WU,0.1416310100417743,0.2738509983498094,0.0789604193363885,0.1437351129066122,54,77,89,220
6,ERF,0.1406706333246212,0.3679517067590538,0.0149909549975805,0.1190803640228159,55,33,133,221
7,MO,0.113176993863918,0.439506807089648,0.094567587995008,0.1268201714799555,101,21,112,234
8,KB,0.2112773108274206,0.1770902109232539,0.0547266486902204,0.618084642197235,17,208,12,237
9,MPC,0.1595438571742164,0.2016145817846629,0.0207814072819633,0.2015021941606387,41,163,49,253
10,CRC,0.1481976641525616,0.2643406268480189,0.0212837070857402,0.1208704353017346,45,82,131,258
11,CPA,0.1212479583768391,0.2106890905311012,0.0,0.2388934710474607,82,149,33,264
12,CIVI,0.1329957386448424,0.259521428072117,0.1119738490732515,0.1237262533772582,65,88,119,272
13,MLI,0.1147620431742703,0.3016465321929781,0.0127283900703023,0.1179860179580934,97,61,138,296
14,HPQ,0.1239270793771363,0.2761265580057526,0.0393467527535131,0.1124952525636156,79,76,150,305
15,TOL,0.1763697532681411,0.178293778710022,0.0117079290118141,0.1534117644518214,33,206,77,316
16,APA,0.2575106521919523,0.5329439252336449,0.0277804836690442,0.0696316019237082,11,9,296,316
17,PBF,0.3896797866029486,0.1836749789649848,0.0192609770719887,0.1231937919150737,6,190,122,318
18,SHG,0.2021264815825326,0.1413014695351873,0.0706931825972868,0.6452110604563774,21,297,10,328
19,DHI,0.1296107125847148,0.2273876822374293,0.0093185778987092,0.1134916484703589,70,122,148,340
20,ALSN,0.1285946307442438,0.2031388152077807,0.0158593675360657,0.1259195567020158,75,157,114,346
21,BP,0.1455138031631878,0.1560273097993986,0.0459200655825034,0.1695289757437651,49,257,65,371
22,TEX,0.1335550656817625,0.2549773665024236,0.0111381830838844,0.0856247824573616,64,91,218,373
23,OGN,0.2768296515869871,0.1443107221006564,0.0795580816877558,0.1455858773741926,9,285,88,382
24,ACT,0.1431965763006848,0.1638075398142164,0.0458230076967909,0.1359942625921018,53,240,100,393
25,DVN,0.1288399249035506,0.2171174844818993,0.0638869977237248,0.0903976948415891,73,135,202,410
26,WSM,0.0752408782019237,0.3666688965950761,0.0184168488105359,0.1181827349533913,243,36,137,416
27,KBH,0.1401223808475298,0.1231240691652011,0.0134930622947793,0.2486381221520654,56,345,32,433
28,NUE,0.1034345731491225,0.2029524825839077,0.0118061926705075,0.1123814237749151,124,158,151,433
29,SM,0.177985253242366,0.1717501370042287,0.0155844817402293,0.1033797751788679,31,224,179,434
30,GGB,0.1811079286762083,0.1433021189193826,0.0647827454722944,0.1235391143663,27,290,120,437
31,DQ,0.2119057901914312,0.105803757778126,0.0,0.8105087792089676,16,415,8,439
32,YPF,0.4496987143653646,0.1067035277476482,0.0,0.318199446637088,5,412,23,440
33,MTG,0.1303203846930812,0.149548955818174,0.0224768477181183,0.1299573625358154,69,271,110,450
34,TMHC,0.1329310366169098,0.1461211593145188,0.0029411762672021,0.1335903939485449,66,281,105,452
35,VALE,0.1153724796992793,0.1842959800882325,0.0807867336018855,0.1062212524794109,95,188,170,453
36,CIG,0.118849840255591,0.1338953515753779,0.0607900087133314,0.1835898925355794,88,310,55,453
37,BG,0.1473521267460259,0.1242861181792479,0.0251608847720588,0.142096589456823,47,341,90,478
38,CBT,0.1145122537118053,0.1890726096333572,0.0226451198351435,0.0903231484333565,98,177,203,478
39,LEN,0.108672063028391,0.1470021382924115,0.011880084493227,0.1401665378586937,113,277,92,482
40,BMY,0.0752657655283356,0.236525508594318,0.0444935565939469,0.1186526105543893,241,110,136,487
41,EOG,0.1075107454116101,0.2413845109720232,0.0479367110829223,0.0729810235181525,115,103,277,495
42,AGCO,0.1288157430124827,0.2450406917599186,0.0502990616816711,0.0643308943676817,74,100,324,498
43,MRO,0.1057914342976646,0.1436146425605315,0.0170872908678982,0.1398298623213663,117,288,93,498
44,CRI,0.0848472250065431,0.1617757269180517,0.0408744663950875,0.1712534489824657,191,246,64,501
45,ARW,0.1295806775984968,0.1723020691277076,0.0024395740211182,0.0892307543371549,71,220,211,502
46,AMG,0.1053064167899336,0.1441330312770575,0.0002347445759918,0.1348842333649038,119,287,103,509
47,DFS,0.1029786757082411,0.1176822517312281,0.0263401238546249,0.2893210412755345,125,362,26,513
48,BHP,0.0853699883163827,0.26819690467217,0.0876626425959109,0.0767609723906612,190,80,259,529
49,NEU,0.0743427889093973,0.2483896031638699,0.0162567496917217,0.101044051962341,249,95,186,530
50,SIG,0.1800039670173382,0.1342098734805259,0.0161701490607875,0.0936002859095586,28,309,194,531
51,MCK,0.0703136125376281,0.3050198426512567,0.0057672963092661,0.090874418900457,277,58,199,534
52,VIPS,0.0965196641833166,0.1677279651978016,0.0,0.1136556919225883,155,235,147,537
53,AB,0.0753782743415154,0.3935760562973516,0.0844958316371243,0.0742837680111773,240,28,270,538
54,GL,0.0827624979365016,0.1777384677859571,0.0071713772027203,0.1221606542776199,207,207,124,538
55,BBWI,0.0898748508057004,0.3078581696214662,0.018630094358357,0.0671502302147374,176,56,308,540
56,OC,0.0886652981370649,0.2032985526758667,0.0139373545566623,0.0884428935430756,181,156,214,551
57,MAIN,0.1209872535893505,0.1422505046020529,0.0766956405053927,0.1044504717763236,83,293,177,553
58,ICL,0.1000580448007282,0.1369539291413953,0.0768119455659245,0.1280199095342895,135,307,111,553
59,PII,0.0929155239332316,0.1756315422191207,0.027220478670177,0.1016748633016389,166,209,184,559
60,MPLX,0.1067581612374379,0.1277392714938799,0.089581186211455,0.1212987967420279,116,331,129,576
61,WMS,0.0722578943736714,0.2851775922433407,0.005644564653589,0.0770758378125915,260,68,257,585
62,SU,0.1492762939287298,0.1099288084923108,0.0494708296576344,0.115317961602809,44,400,141,585
63,BYD,0.0977344073788631,0.1704783956840468,0.010026705330225,0.0852095771594965,148,227,220,595
64,TPR,0.0906305796871308,0.2010874226026105,0.0274312427621412,0.0765905860390176,172,164,260,596
65,MSM,0.0603673162644108,0.2553087616073907,0.031080374828951,0.1067739222733389,340,90,168,598
66,DKS,0.081702872424491,0.2027068807648553,0.027418642660433,0.0828363864884795,212,160,226,598
67,RDN,0.1360113364617586,0.108893956331451,0.0329041898538468,0.1157228098258566,60,402,140,602
68,CPG,0.113919697686426,0.0967532581431653,0.0423278694367064,0.1948000862419825,100,454,50,604
69,SKM,0.1788104394644594,0.0755861331989232,0.1285524402600652,0.3072208385198528,29,551,24,604
70,INGR,0.0884273005194244,0.1635434412265758,0.0266794654755339,0.1019045562751065,182,242,183,607
71,EXP,0.0854678625296141,0.1889363902600859,0.006943499964056,0.0799204327124809,189,178,240,607
72,HP,0.1005055254284397,0.1417828552683871,0.0466423430792714,0.1014598764439108,131,295,185,611
73,GIL,0.0935752208774535,0.2307069378020433,0.0231135600771875,0.0593805784764105,165,115,346,626
74,MAS,0.0599835639749813,0.3675027262813522,0.0169777268078966,0.0772915967519032,345,35,255,635
75,EME,0.0617749902959091,0.2840511282067539,0.0031896885611182,0.0801473198095174,328,69,239,636
76,GEF,0.0977820728329442,0.1205814995519267,0.0317138404371882,0.1186614853782862,147,354,135,636
77,PGR,0.0417025551150389,0.9288725792096668,0.0029665409235175,0.1110454492022612,490,2,154,646
78,MTH,0.115808833500041,0.2224262739395764,0.0061974941706652,0.0497536474904067,93,128,425,646
79,MKL,0.1050811073838622,0.1048705585345818,0.0018951934640336,0.1330945937068985,120,419,108,647
80,G,0.0982303371803085,0.1808763222232129,0.0155632968336906,0.0672294773486065,145,198,307,650
81,EBAY,0.11901351687308,0.1191228070175438,0.0227102048821779,0.0847331507914592,87,356,221,664
82,PSX,0.1162571410679595,0.1328024142845167,0.0311897276535851,0.0764164900163024,91,317,261,669
83,AMAT,0.061921769575331,0.3276961938605129,0.0088059692730378,0.0685872109327689,325,47,298,670
84,TX,0.087614112326323,0.1103791216534849,0.0737461980748,0.140493635811764,184,398,91,673
85,HIG,0.100006510008439,0.0946333352445387,0.0219263474419461,0.1599545018305904,137,468,71,676
86,CINF,0.1126732940327905,0.0962815685942721,0.0277556568046049,0.1243502333492653,105,457,117,679
87,HAL,0.0809021292777997,0.2140498034076015,0.017664756051559,0.0637587288735958,214,142,326,682
88,MUR,0.0989984560251922,0.1168174040083621,0.0255858631116428,0.1021680694641593,141,368,181,690
89,THC,0.0795483918795892,0.1030485733695652,0.0,0.2113044844853901,221,431,39,691
90,RS,0.0809375636764574,0.1792522825168483,0.0144256560456355,0.0728553187521072,213,202,278,693
91,RNR,0.2744764425399626,0.0552126920315601,0.0118408886019591,0.2048697606208656,10,641,44,695
92,CF,0.0989803402327498,0.1633028874484384,0.0201854988933673,0.0669172005114525,142,243,310,695
93,TNET,0.055317811892887,0.38130081300813,0.1743617430863798,0.0693316575724183,369,30,297,696
94,CAT,0.0680578467595693,0.2621142033821187,0.0168778191818844,0.0644886785985933,288,86,323,697
95,ABEV,0.0673870580035544,0.1821751483982742,0.0553984396008161,0.08692847881647,292,194,215,701
96,CNQ,0.0861176210059549,0.1527145359019264,0.0407000684239245,0.077864638742661,187,265,250,702
97,OMC,0.0748029313244463,0.1783855711694607,0.0322961785132095,0.0771102111826852,244,204,256,704
98,FITB,0.0990386034935998,0.0926388403772266,0.0446917495543702,0.147314125417896,140,477,87,704
99,NVR,0.0661830935296597,0.2914729512268396,0.2126954656093242,0.0612632653109796,300,65,341,706
100,CSCO,0.0589862621823139,0.2130757126858795,0.0294720862818475,0.0890288966276628,349,145,212,706
101,XOM,0.0888874714725768,0.1395365288214507,0.0368805251672249,0.082568339926623,180,300,227,707
102,AYI,0.0674507106076621,0.1682840993921296,0.0032750634052275,0.0996944896091283,290,231,187,708
103,TROW,0.0738866239558717,0.1726665028678906,0.0463345592280993,0.0795333514645471,250,218,241,709
104,PCAR,0.0897432521395655,0.1869490310491832,0.0296218272255138,0.0571038451222783,178,184,359,721
105,BSMX,0.1660754784877787,0.0557874049963975,0.1121429749359611,0.2034418338795182,38,636,47,721
106,SON,0.0864869220540145,0.1151204311494886,0.0359481601658571,0.1092888457285333,186,376,160,722
107,MUSA,0.0726556791723967,0.2294890673186453,0.0043582968469074,0.0585107876093798,257,116,350,723
108,MMP,0.0984795158046129,0.11403282632981,0.0826680613180367,0.0917900542910615,144,386,198,728
109,RRC,0.1207595855587781,0.1661948958124238,0.0107073142474425,0.0515207277889622,84,237,407,728
110,T,0.118237046228386,0.0695861299738995,0.0668039311190381,0.1680033474221532,89,582,66,737
111,HCA,0.0700622298659975,0.2210258058591238,0.0088346306641404,0.0626443478408871,279,130,331,740
112,PAA,0.1161489539511891,0.0642000715819613,0.093391313380265,0.2047243350944536,92,604,45,741
113,CMC,0.1304583237437719,0.0825540344205211,0.0113706440728381,0.1118974194484038,68,524,152,744
114,NTAP,0.0920799664638112,0.1602897181546213,0.0312233481258763,0.0627358013269922,168,249,329,746
115,TLK,0.075250422439749,0.1932628268979121,0.0403872931995994,0.0612714602943303,242,173,340,755
116,HOG,0.1347108320743169,0.0843110495426716,0.0183615302837552,0.104377797573888,62,517,178,757
117,MTDR,0.1240202596786414,0.1723468067071516,0.0113125607697425,0.0466161056154452,78,219,460,757
118,DVA,0.0708413205312633,0.1068955656317179,0.0,0.1532470677848961,273,411,78,762
119,WES,0.0908815939227705,0.1154765265902972,0.0869887361789058,0.0858188162261466,171,374,217,762
120,RIO,0.0827961321674605,0.1632381120190295,0.0532601884195138,0.0664641053012603,206,245,312,763
121,LOW,0.0623176970030867,0.4406527624204064,0.0203622632474583,0.0496868185761765,321,20,426,767
122,KSS,0.109159779614325,0.0629112924453803,0.0757575757575757,0.2035123966942149,110,611,46,767
123,SWKS,0.0621868786571886,0.1525444412805597,0.0256391160275669,0.1025248265041135,323,267,180,770
124,COP,0.0782963328227547,0.1749322035870995,0.0398949006251199,0.0622897812554488,227,211,333,771
125,MOH,0.0519719050647169,0.2339381320642474,0.0,0.0751710964180781,394,113,264,771
126,SNA,0.0649453421131265,0.197764753986643,0.0228410282419422,0.0680349187678999,307,166,301,774
127,QCOM,0.0581611459418526,0.1880614314691393,0.0278420751176291,0.0792075672540524,353,180,242,775
128,WRB,0.0714706704388351,0.1034547481779871,0.0259450269738543,0.1516156046361009,267,428,81,776
129,AAL,0.0831289488791611,0.097692457800761,0.0,0.1220640405074787,202,450,125,777
130,LRCX,0.0535346428284807,0.3545219903779786,0.0107748216424674,0.055509900800223,377,40,364,781
131,SEAS,0.0687352551628028,0.2076457987354858,0.0,0.0587223942892859,285,153,348,786
132,RDY,0.0579514361431073,0.406030447433897,0.006402471887557,0.0514473785397204,355,24,409,788
133,DE,0.0963402640325953,0.2454976754518191,0.0135232694053229,0.0390535341410904,158,99,535,792
134,BXMT,67.13119915394677,0.0223821513544374,116.24230480500104,124.93174565916767,1,800,1,802
135,CVE,0.0968122181309587,0.1147049575516193,0.0241736032617093,0.0728035419870193,153,378,281,812
136,FLT,0.0467066014824365,0.1956084845510068,0.0,0.0926297570326244,449,169,196,814
137,PRI,0.0779412247514125,0.1159983855895872,0.0126677925941485,0.0890280270859317,229,372,213,814
138,OLN,0.0662276434932275,0.1226839126919967,0.0145349673898652,0.1062491725142327,299,347,169,815
139,LMT,0.0607796547097276,0.2395056167121822,0.0268414197677641,0.0547104724258516,334,105,377,816
140,CB,0.0964429140257461,0.0710381281062263,0.0148916063526683,0.1473777627269819,156,575,86,817
141,PM,0.0534747865662684,0.2969091236093625,0.0545082810973713,0.053953889991283,378,62,381,821
142,EPD,0.0956896417519576,0.1117871774040206,0.0743964477901608,0.0744310427437949,161,392,269,822
143,AIT,0.0620364411343361,0.2147769302420167,0.0095622345131806,0.0568033872617166,324,139,360,823
144,BBY,0.0783505844568476,0.2446868801360158,0.0505711669217848,0.0426161519003804,226,101,498,825
145,FOX,0.0767832110627316,0.1140694912445451,0.0185296046067447,0.0894254831021161,235,384,207,826
146,HMC,0.108833972417794,0.0464680566778781,0.0356658913227316,0.2500303033365636,112,685,29,826
147,FOXA,0.0767832110627316,0.1140694912445451,0.0185296046067447,0.0894254831021161,235,384,207,826
148,FANG,0.1125948421319504,0.1699326962406574,0.051729860654959,0.0432037478877289,106,228,492,826
149,FIX,0.0439196725461511,0.2626185483982948,0.0041256771293561,0.0739780803408335,470,85,274,829
150,SEM,0.0841665175982792,0.0861449619525408,0.0220894289341307,0.1219709519723259,196,509,126,831
151,ABM,0.0963484216571928,0.1102050702405942,0.0220455003791826,0.0731143812575673,157,399,276,832
152,GILD,0.0555879477871679,0.1842462385681974,0.037375903463605,0.0728187397226078,368,189,280,837
153,UL,0.0585853335847743,0.1941102424671295,0.0394030846949437,0.0658193172799787,351,172,314,837
154,VC,0.1384737683385142,0.155902004454343,0.0022794035940496,0.0404594137943807,58,258,523,839
155,EQT,0.1086200906765228,0.0995520180479759,0.0142933065347956,0.0726006627516147,114,443,284,841
156,MFG,0.5835540886683741,0.0119364178458961,0.2200243890039757,9.12219307933254,2,837,2,841
157,RF,0.1140911981446152,0.0668632982816106,0.048684045495653,0.1109006053324707,99,594,155,848
158,CVX,0.076190892606764,0.1310218246183089,0.040418361111436,0.0704932443131794,238,322,293,853
159,IHG,0.0483852237977884,0.3987800228745711,0.0158058397739442,0.0523205553333419,430,26,399,855
160,MCHP,0.047926141183811,0.2351396424609672,0.0148916503396808,0.0671398611891722,435,111,309,855
161,SYF,0.1383748009471068,0.0256414784466773,0.0276996920573297,0.5313023523407013,59,782,14,855
162,AZO,0.0539486163958725,0.4648081046590444,0.093841825350119,0.0457489761699565,375,15,468,858
163,AGO,0.1691047653219443,0.0531512259338489,0.0153315551780382,0.1054902527921736,36,650,173,859
164,SAN,0.1735435292559682,0.015723563529772,0.0354263199393051,1.0485156585662818,34,823,4,861
165,THO,0.0605988136207943,0.1076411509522851,0.015538493616588,0.1252287401590118,338,408,116,862
166,SAIC,0.0696306553558454,0.1782964388835418,0.0115321211176347,0.053865223954522,280,205,382,867
167,CTRA,0.0837836165649232,0.1011566771819137,0.0458876423032502,0.080380712753671,198,439,234,871
168,SKX,0.0560311111579783,0.1333199920359929,0.0,0.0931569745848163,364,313,195,872
169,DAL,0.178174563135996,0.1169059416423156,0.0049482195880684,0.0441087386717664,30,367,478,875
170,CSL,0.0487347261024564,0.1818466238474704,0.0101800581107945,0.0776808925834307,427,195,254,876
171,LYB,0.0682021726618333,0.1022780569514237,0.051942052027224,0.1100461735806592,287,435,156,878
172,AFG,0.0845081151595656,0.0574898785425101,0.0678445431562709,0.1882586884657928,194,631,54,879
173,RHI,0.0440858728544323,0.2616409056146441,0.0220790718612273,0.0633717936160864,467,87,327,881
174,LKQ,0.0729992075374489,0.1153813451237139,0.0235531631157153,0.0778346251307415,255,375,251,881
175,BC,0.0618977156444856,0.1640987852804573,0.016490352407665,0.0654166390600499,326,239,317,882
176,BERY,0.0799744712032809,0.0777153558052434,0.0166777632886973,0.1216032189396357,217,543,128,888
177,FBHS,0.0511725406502265,0.1146217798158297,0.0147761501803373,0.133567289044522,403,379,106,888
178,SBS,0.0798724187539356,0.091406020479789,0.0154444587685606,0.0996446915406248,218,483,188,889
179,ENB,0.0835163921997767,0.0703937294368422,0.1029014762881435,0.1257939520696039,200,578,115,893
180,SNX,0.0684473890739174,0.085058196068629,0.0142344924608483,0.1372817191121471,286,513,96,895
181,VZ,0.0730874639329664,0.0881595684825949,0.06938085843473,0.1177303491697896,254,503,139,896
182,GPK,0.0951675172071558,0.1553692056836711,0.0161903245041219,0.0447537425317192,163,259,475,897
183,AON,0.0429775172605688,0.3365290867728306,0.0081965701795702,0.0533531347271413,477,43,383,903
184,CCZ,0.0846006757938048,0.1037963074265514,0.0262026787648345,0.0712574316976542,192,425,288,905
185,CMCSA,0.0846006757938048,0.1037963074265514,0.0262026787648345,0.0712574316976542,192,425,288,905
186,AFL,0.0943184949731977,0.1047113501414493,0.0195560562661749,0.0645795232806397,164,421,322,907
187,KMB,0.0428492434387946,0.2250816208949491,0.0385740354766473,0.0674316892211416,479,125,304,908
188,GIB,0.0509520251845202,0.2098209562745994,2.9610758305399836e-05,0.0563878794868905,405,150,361,916
189,BDC,0.0744018591959855,0.126709881163331,0.0026045048770487,0.0621878407963446,247,335,334,916
190,ABG,0.1281404240395263,0.1469994645578483,0.0,0.036304681134518,76,278,567,921
191,HSBC,0.1480837771714507,0.0118054599346315,0.076744560675775,0.2228587537629753,46,839,36,921
192,OKE,0.0780113404255294,0.0938567330024136,0.0539536874924966,0.0843778168724417,228,472,223,923
193,HD,0.0428172440250957,0.3978538017059524,0.0237031603158144,0.0507428026992253,480,27,417,924
194,AM,0.0618961821293585,0.1074501649405167,0.072486188598802,0.0990682535722825,327,409,189,925
195,CVS,0.0819176425312002,0.0805856724854725,0.0307485686011168,0.1020534388916378,211,532,182,925
196,PYPL,0.0624587475859017,0.1491988130563798,0.022476911519373,0.0620762870495773,319,272,336,927
197,TGS,0.0351538695626514,0.228848573924116,0.0,0.0814467235629061,580,119,230,929
198,CTSH,0.0557381304130677,0.1943234323432343,0.0154944661684492,0.0527755675077636,367,171,393,931
199,ULTA,0.0474883864867565,0.4442319599982215,0.0,0.0447126806491559,439,19,476,934
200,DCI,0.0462026519395069,0.2384191450275557,0.0147312803285384,0.0549074994063706,456,106,373,935
201,SLB,0.0559700598132573,0.1686823679185232,0.0175380844097216,0.0605243687488114,366,230,343,939
202,SIVB,0.1220704173073003,0.018441473093547,0.0119004055150059,0.1933998417745445,81,810,51,942
203,TKR,0.0688875320826672,0.1295952982013253,0.0164309262008899,0.0624724789808304,283,328,332,943
204,IBP,0.0473341694488339,0.2270475258425592,0.0122559954543349,0.0541128420535295,442,123,379,944
205,PAGP,0.0636604774535809,0.0585367921329264,0.0671971706454465,0.6954424885459368,313,624,9,946
206,AOS,0.0447078187075945,0.3338622939257692,0.0147392826677032,0.0480090967328948,465,44,438,947
207,RE,0.165097334619304,0.0,0.018890755808645,0.2986444833220864,40,884,25,949
208,MOS,0.0978477033130632,0.0698414852472193,0.0295332238688926,0.0843998388608172,146,581,222,949
209,KEYS,0.0483820395982047,0.2047030449201085,0.0,0.0554768514598147,431,154,366,951
210,STM,0.0889658926612878,0.2198523379819524,0.004711326065891,0.0307609450759522,179,131,641,951
211,AXP,0.0607329849007384,0.0894251543866215,0.0129095668883824,0.1232646060870493,336,497,121,954
212,BWA,0.0743760739905084,0.1085532472393786,0.0154702233900257,0.0672359708874196,248,404,305,957
213,EXPD,0.0394104078238581,0.3333808612267091,0.0105754085060311,0.0530723977739301,527,45,388,960
214,NVS,0.0702818847850368,0.1328121813608864,0.0343363686273025,0.0553972701285424,278,316,369,963
215,GPC,0.06739926859944,0.1722703448112651,0.0269630043890893,0.0472495328852519,291,221,453,965
216,PNC,0.0898303160407022,0.0407282286359834,0.0463484491870098,0.1628315391695124,177,719,70,966
217,ADM,0.0830231919739146,0.160048337689346,0.0171976611945966,0.0413011685418621,205,251,511,967
218,JBL,0.053311706247024,0.2284143260514192,0.0029327955759365,0.0458819574546514,381,120,467,968
219,SYY,0.0468024209726388,0.2127729345707693,0.0263340360632552,0.0548442851279697,448,147,374,969
220,CNC,0.0667214960973219,0.0611371935315597,0.0021730168973221,0.1791257337860744,295,617,57,969
221,MTB,0.1197328354982107,0.0178321540493131,0.0422843432186311,0.1593962483520507,85,813,72,970
222,SUN,0.06171884844643,0.1108270951250684,0.0736260217801464,0.0781904382247377,329,395,247,971
223,BNS,0.1091220180200848,0.0075642917700254,0.0798460973960729,0.4606686865997699,111,852,16,979
224,FHN,0.1127716733729227,0.0226062313718464,0.0461395809675168,0.152248045099899,103,798,79,980
225,SEE,0.0645533385187654,0.1544205495818399,0.022279972515698,0.0514007847690404,310,262,410,982
226,UNM,0.1436731049243275,0.0225586558061614,0.0310109186590833,0.1195224147524394,52,799,132,983
227,WIT,0.0560933252399587,0.1537394184803137,0.0162171486733392,0.0572137091018,363,264,358,985
228,CE,0.1153326632092662,0.053762486126526,0.0179471746320541,0.0783202932303742,96,645,245,986
229,WMB,0.0746469063085722,0.0887236361305211,0.0511656523580933,0.0791553070670641,245,499,243,987
230,CM,0.1115579106022199,0.0078275630578805,0.0504969841584823,0.2487998246463923,107,851,31,989
231,AMCR,0.0711450000271545,0.140370473796891,0.0490819036446877,0.0498965410495788,271,299,424,994
232,CPB,0.0622107887138898,0.1333875559170394,0.032410515798495,0.056047715239903,322,312,362,996
233,MFC,0.1015854893117827,0.0063041440947221,0.0552648863691411,0.6355275980612847,129,856,11,996
234,WFC,0.1045336384246213,0.0116243959730461,0.0323834748645912,0.2203933016163864,123,841,37,1001
235,HPE,0.1000490116639855,0.0592271271015848,0.0305828830716084,0.0790510709443836,136,622,244,1002
236,LEA,0.0689640391326466,0.0972829879379285,0.0219118929576042,0.0750232376800215,282,453,267,1002
237,BKNG,0.033099257350674,0.5303305484925536,0.0215002403774721,0.0540129872225151,612,11,380,1003
238,SNV,0.0988333563054697,0.0232779401835527,0.0458099391322458,0.1645346660898865,143,795,69,1007
239,KR,0.0646906715692868,0.0898772026591575,0.0237956444404585,0.0894130308057934,309,492,209,1010
240,HSY,0.0485824885170658,0.2938091911835386,0.023199905063445,0.0405008507203327,429,63,522,1014
241,PKG,0.0524812514295688,0.1466050395892695,0.0307878120318001,0.0578034483858345,386,279,354,1019
242,NFG,0.1001254569691397,0.1010372295873613,0.0369741027257922,0.0477056546316729,134,440,445,1019
243,ASGN,0.047211944169777,0.1155689573083637,0.0,0.0897737378878112,445,373,204,1022
244,ALLE,0.0483072484025041,0.2191967324710687,0.0141864550730521,0.0461618487695283,432,133,463,1028
245,BAM,0.1388859340622893,0.213020101755088,0.0,0.001819750137145,57,146,825,1028
246,WCC,0.084177083512024,0.1204883272649389,0.0147351132470427,0.0440843798562644,195,355,479,1029
247,ALV,0.0519802117298886,0.208517570397952,0.0239662861459527,0.0435653823719763,393,151,488,1032
248,GWW,0.0440538512929371,0.4061114629512349,0.0094418314416792,0.0382008792512839,468,23,543,1034
249,F,0.0882464176156658,0.0317733832424219,0.1014011630987464,0.1356481625276924,183,753,101,1037
250,ITUB,0.0994873650473146,8.656195789111675e-05,0.0310978780700683,0.3237599244416959,138,879,22,1039
251,TAP,0.0713408600735001,0.0645439246045102,0.0266673022110554,0.1058196443813377,268,603,171,1042
252,PAYX,0.0409641810284837,0.4288335794136258,0.0309079257101832,0.0409405068726206,503,22,517,1042
253,WHR,0.0715592355747887,0.1097066769587032,0.0571283710202055,0.0544504786286334,266,401,378,1045
254,OXY,0.0653590909502077,0.0724020968239284,0.0237907091058756,0.1056725782482958,303,571,172,1046
255,VIV,0.0571190141761489,0.0786639482528806,0.0435271598915252,0.1132817875931115,358,540,149,1047
256,GFI,0.0543414102687176,0.2078267986322188,0.0285344558683882,0.0402480315782383,373,152,526,1051
257,BAC,0.0974563811021951,0.0127575295171476,0.0333994393767922,0.1653321868655078,150,833,68,1051
258,CHTR,0.077150635501192,0.0937385709700774,0.0003724630197555,0.0590861790430459,232,473,347,1052
259,AVGO,0.0392022855472542,0.2476014421901735,0.0212825928851554,0.0490877645969843,530,96,429,1055
260,BKH,0.0725381433887098,0.0568918710656408,0.0465051941405115,0.1075622812720457,258,634,165,1057
261,UBS,0.291016769855445,0.0178502453960993,0.0,0.0802582958300625,8,812,237,1057
262,COF,0.0972123159948096,-8.903668979394685e-06,0.0230548545606679,0.3901621374917527,151,888,18,1057
263,UNH,0.0453213690265085,0.1804071119139612,0.0136909778824996,0.0520058710217948,461,199,402,1062
264,POOL,0.0336514265866961,0.2811562253744588,0.0107702393170766,0.053261300221357,605,72,385,1062
265,CMA,0.1190690734913459,-7.350238882763689e-05,0.0532499602220094,0.1483970972684424,86,893,84,1063
266,SQM,0.1170079803379941,0.309165907044967,0.0855197776664004,-0.0752214880571243,90,54,919,1063
267,ESNT,0.1243069560450834,0.0,0.0189596909419898,0.1354835613169453,77,884,102,1063
268,CFG,0.1017875429178858,3.702716981472869e-05,0.0587430595944018,0.1765456823370545,128,881,60,1069
269,YUM,0.0428861837741453,0.4648768671780379,0.0182071587970385,0.0353938573665144,478,14,577,1069
270,DECK,0.043080378337317,0.3170505672415744,0.0001281186588505,0.0380435728974704,476,49,547,1072
271,ZION,0.1049049914677376,0.0156939676311917,0.0435047170498559,0.1218749165581069,121,824,127,1072
272,IPG,0.0872038372228912,0.1659169240410008,0.0380365608280109,0.0298036421098628,185,238,651,1074
273,WTM,0.1338727584172928,-0.0109022899370495,0.0006835608245973,0.1369750731918349,63,915,97,1075
274,IBM,0.0497463036094136,0.1038666930379746,0.0400516760598318,0.0803752260796724,418,423,235,1076
275,ALLY,0.0957268815217105,0.0057013865814359,0.0448602444778212,0.1786901788405263,160,858,58,1076
276,TEL,0.0487754925367112,0.1335729607513479,0.0185142576382804,0.06128857700948,426,311,339,1076
277,HII,0.0657359003733335,0.0954417695221801,0.0193056976133138,0.0654463149091338,302,461,315,1078
278,DOV,0.0488694562850432,0.1544121228518116,0.0131463585498008,0.052889010543236,425,263,391,1079
279,OTIS,0.0379034363859294,0.6008796041781198,0.0145305492261849,0.0401409792166777,547,5,528,1080
280,CNA,0.1046299217958627,-0.0022869826962853,0.0683350609571319,0.1905914343086462,122,907,53,1082
281,AN,0.1514292722526583,0.2228636390480127,0.4570017093074057,-0.0741055796147814,43,126,915,1084
282,PBA,0.0707324585341719,0.0716739803381297,0.0628865720864062,0.0802112452071071,275,573,238,1086
283,RY,0.0963390561901869,0.0098587652696299,0.0359772139982062,0.1513843881139157,159,845,83,1087
284,EXPE,0.034951375742545,0.1479866112181762,0.0,0.0808661692211456,585,273,231,1089
285,ADP,0.0373440201733009,0.5450301094668064,0.0208347235644477,0.0397956791764719,553,8,530,1091
286,CL,0.03479811615708,0.3545314109165808,0.0238896632226214,0.0459940317902275,589,39,464,1092
287,VRSN,0.0383546169557805,1.7851917930419268,0.0,0.037904269202875,542,1,550,1093
288,BBDO,0.078846531808997,0.0013446955309586,0.0493943611664979,0.9656017608957462,223,869,5,1097
289,BBD,0.078846531808997,0.0013446955309586,0.0493943611664979,0.9656017608957462,223,869,5,1097
290,GRMN,0.0522391919225725,0.1497569822191007,0.022634015358895,0.0478482814910904,391,270,441,1102
291,EMN,0.0833604674452198,0.0909015509662436,0.0350598833997792,0.0504452045725547,201,486,418,1105
292,ORI,0.0713226199965649,0.0517117755297735,0.0328255626612991,0.1048988216588302,269,660,176,1105
293,KMI,0.0606733293138204,0.0668192291415226,0.064175177680741,0.1052077052844414,337,595,174,1106
294,WYNN,0.0709957642849478,0.0800396311592741,0.0082407308760845,0.0680264636066083,272,535,302,1109
295,GPI,0.1442911087871243,0.1867549920279401,0.0060441089452053,-0.0292371777944655,50,185,875,1110
296,GOOGL,0.0415246737028335,0.2629406883816107,0.0,0.039105050463831,495,83,533,1111
297,ARMK,0.102479489257165,0.0728744221272136,0.0174238908034331,0.050815450220985,127,569,415,1111
298,ORLY,0.0404911189464041,0.4592844034133589,8.627684053182934e-08,0.0349907805534508,512,16,584,1112
299,RZA,0.083091996236598,-7.252382925818484e-05,0.0201742208157593,0.3796254063093353,203,891,19,1113
300,RGA,0.083091996236598,-7.252382925818484e-05,0.0201742208157593,0.3796254063093353,203,891,19,1113
301,INFY,0.041353765910408,0.3627999620601347,0.023541543357921,0.0351527818909674,497,38,581,1116
302,GOOG,0.0411593107893905,0.2629406883816107,0.0,0.0387609770758005,499,83,538,1120
303,ITW,0.0371832831805411,0.3725906114543945,0.0203080833062475,0.0387802655829518,554,31,537,1122
304,AXS,0.0798190609568707,0.000412924138704,0.0390353839374425,0.2597229160372977,220,875,28,1123
305,ENLC,0.0367278250857813,0.0944512610770279,0.0420713495890473,0.1383972846345884,559,470,95,1124
306,VOYA,0.0787347216847265,0.0046815998355981,0.0205340154153766,0.2063479585913313,225,863,41,1129
307,CNHI,0.1441950982180867,0.1727483799424749,0.0327190901903545,-0.0175150519978106,51,216,862,1129
308,MAR,0.0451344803288694,0.21572130415364,0.0085935582072806,0.0397909560602877,463,138,531,1132
309,V,0.0360176186688577,0.3115680776249611,0.0078215763114042,0.0410700525271709,566,53,515,1134
310,DGX,0.0548123159551334,0.1106742033259605,0.0201534744846743,0.0554541463527345,371,396,367,1134
311,K,0.0493028391903136,0.1425054445601742,0.0414745229781818,0.0501841728035999,422,292,423,1137
312,WF,0.0826235368478982,-2.5780305152758938e-05,0.0340344624785905,0.213564394443917,210,890,38,1138
313,CSX,0.0532305804024633,0.1391083379459568,0.0126377851722671,0.0468257164886272,382,303,456,1141
314,DRI,0.0495375886318726,0.1447236907070001,0.0297558506722461,0.0480190211424955,421,284,437,1142
315,EPR,0.0474573593791265,0.0683914079339505,0.0746623949942229,0.1239467883884885,441,587,118,1146
316,L,0.0904543653342942,-0.0277387951197926,0.0035954664045012,0.2031753910333067,173,928,48,1149
317,MGM,0.0712817582487874,0.0403411812912945,0.0,0.1097743320810382,270,722,159,1151
318,NXPI,0.0465922355620273,0.1816026084379013,0.0167578795049694,0.0417614353071156,451,196,508,1155
319,SLF,0.0826659814797887,0.011582799968333,0.0465382522120737,0.1345207715375563,209,842,104,1155
320,BBVA,0.1565188841188465,0.035747844186738,0.0,0.0547689224139523,42,741,376,1159
321,HUM,0.043689404924767,0.1432191291934332,0.0075653409090295,0.0522552665572645,471,291,400,1162
322,PSA,0.0399885041243036,0.1674934226427251,0.042910775829214,0.0518489122520887,521,236,405,1162
323,CI,0.0580868798825831,0.0496323706088711,0.0163102199515386,0.1151838981405212,354,670,142,1166
324,APTV,0.1157604704833338,0.0794637851062745,0.0012608356213297,0.0390071020348878,94,536,536,1166
325,BOH,0.0601592135920154,0.1081085005208789,0.0420519235113121,0.0503072032680744,343,407,419,1169
326,CDW,0.0356413026765414,0.2143294315660622,0.0103764183740904,0.0468149140019228,572,140,457,1169
327,NSP,0.0386715226532847,0.304964717144105,0.019003611618122,0.0357356531848348,539,59,573,1171
328,EVR,0.0392008744339505,0.1305565905618228,0.019619540583072,0.0654234282960639,531,324,316,1171
329,FMS,0.0442307596004779,0.0538136554972716,0.0291289224427959,0.172333027992247,466,644,62,1172
330,ITT,0.0416001031236661,0.1824651098521486,0.0097083797302002,0.0435863687052102,492,193,487,1172
331,SBUX,0.0393766481363632,0.2920766957542711,0.0232164220967409,0.0350862212549275,528,64,582,1174
332,CHRW,0.0314471679622838,0.1741563243412902,0.0282011734283781,0.0626599782143277,630,215,330,1175
333,TXT,0.0567584278999613,0.1033819522359352,0.0009860313207376,0.0532456913198334,361,429,386,1176
334,CZR,0.0776213500189609,0.0805841700352066,0.0,0.0508587725951207,231,533,414,1178
335,WEX,0.0316476169617456,0.1206623282179417,1.1870824066671296e-10,0.090681225045302,626,353,200,1179
336,SCCO,0.0364468570424331,0.2733490689061603,0.0464738003950273,0.0385403120919181,561,78,540,1179
337,CHH,0.0453231993988114,0.2582643589427515,0.009898423905189,0.0312542774254868,460,89,631,1180
338,ACN,0.0332349734099591,0.2650685469580564,0.0136749741593467,0.0435105189920479,610,81,489,1180
339,TDC,0.0142781541018142,0.2132269099201824,0.0,0.0817539468732915,809,143,229,1181
340,UHS,0.0671473092946536,0.0952226600864697,0.0051899674972204,0.0490878501158341,294,462,428,1184
341,KEY,0.0719937066035039,4.265544354552047e-05,0.0678244743700022,0.2055580392267575,262,880,43,1185
342,FFIV,0.0406663662931396,0.1251652738460495,0.0061737612459624,0.0617000297305128,510,338,338,1186
343,HE,0.1291603285933596,0.0202907085779177,0.0737524176542379,0.0662568956217925,72,803,313,1188
344,OGS,0.0652675599633287,0.0580487240933797,0.0406719821882606,0.0770282079421208,304,626,258,1188
345,DPZ,0.0355719049950449,0.726814533115634,0.0116334117769346,0.0332660812650197,573,3,612,1188
346,ACI,0.0826946610966348,0.0,0.0163807406151248,0.1368990142764759,208,884,98,1190
347,MGA,0.072951869465321,0.11715074780292,0.0313939619525442,0.0361451554682852,256,364,570,1190
348,CCK,0.0408333254162052,0.1236961137265762,0.0104351831619191,0.059888877277101,504,342,345,1191
349,PNR,0.0514982500767263,0.1316778595222402,0.0120082638688624,0.0449234775038987,400,320,473,1193
350,AMP,0.0624241769716625,0.0408423338476484,0.0134324324469539,0.1099261426249815,320,718,158,1196
351,BSAC,0.0715607354885383,0.0095920815958378,0.0599223453729622,0.1474948212082267,265,846,85,1196
352,UPS,0.0496088532722762,0.1718846956619845,0.0397284972836416,0.0375690182801376,420,223,554,1197
353,IGT,0.0280206265508013,0.1141130870953032,0.028739104154668,0.1151360360196388,677,382,143,1202
354,WBS,0.099468398352065,-0.0009756455258808,0.0337893864954145,0.1075835589905712,139,902,164,1205
355,ROST,0.0396010561062444,0.228158155675032,0.0096083876042429,0.0370058995145818,524,121,561,1206
356,PSO,0.05453192270379,0.089798985534473,0.0222167092496922,0.0604467608806561,372,493,344,1209
357,BKR,0.056006018557218,0.0967270601987142,0.0226560630910825,0.0529794452435238,365,455,389,1209
358,BCE,0.047583570990338,0.0919058044891615,0.0771261769299867,0.0707550668946034,438,479,292,1209
359,BEN,0.0732966905232394,0.038370231133389,0.0504226100529715,0.0821889374138589,252,733,228,1213
360,LII,0.0369355822414772,0.4514659377177467,0.0096016239888876,0.0302257120223849,558,17,647,1222
361,A,0.040526160290115,0.1473799126637554,0.0086608326426455,0.0481738389255076,511,276,436,1223
362,KLAC,0.0498006082460854,0.3867263855079352,0.0026392016909909,0.0129443352637878,417,29,779,1225
363,ABBV,0.0176989662427977,0.1798802518839682,0.0383568589826948,0.0802950016961964,788,201,236,1225
364,MMC,0.0397268913718078,0.1870727820081459,0.0137288351971796,0.0406365060304807,523,183,521,1227
365,RH,0.0640663128644731,0.1632614536243849,0.0280309660727184,0.0278792357453772,311,244,673,1228
366,KHC,0.0625132744912996,0.0653204053364438,0.0430257738617876,0.0648780498485887,318,601,320,1239
367,GD,0.0463004923673271,0.1106102454531241,0.0199448274813101,0.0531582726847804,455,397,387,1239
368,VSH,0.0968782887650273,0.1370173120544028,0.01664181239838,0.010857895541193,152,306,787,1245
369,BK,0.0801367916987668,-6.520945276227242e-06,0.0362639711673969,0.1144253885120553,215,887,144,1246
370,PG,0.0388769657880525,0.2131581112691453,0.0238759172269627,0.036576663506046,536,144,566,1246
371,JNJ,0.0353062457124926,0.1801922886638741,0.0293284291083378,0.0454702781961723,577,200,469,1246
372,FN,0.0522739978731354,0.1680532901400288,0.0,0.0318475124933364,390,234,623,1247
373,MT,0.0383083467593181,0.0676803237788989,0.0153816974474302,0.1263883649338983,544,590,113,1247
374,TRV,0.0676210664649293,-0.0003676470588235,0.0205282274657826,0.1743316761989536,289,898,61,1248
375,MCD,0.0390025944913818,0.2383064368870187,0.0208755620997704,0.0334102023589799,534,107,611,1252
376,TPL,0.0335609428522626,0.444559993048791,0.008271159705719,0.0312978161508838,607,18,630,1255
377,WTS,0.0376658605607255,0.1872242067661273,0.0066824208930703,0.0403963121084316,550,182,524,1256
378,HI,0.1929069042183528,0.0268048018418023,0.0207568777050816,0.046626787275526,22,776,459,1257
379,AWI,0.0509226140093162,0.1586710873536775,0.0106714503889049,0.0340621774673576,406,254,598,1258
380,FAST,0.0311205268705258,0.4021201599326599,0.0273968413177062,0.0339469712590264,634,25,600,1259
381,PRU,0.0657980582485244,-0.0001608881023248,0.0488196203885756,0.1721645334396681,301,896,63,1260
382,NNN,0.0501019875587531,0.0653402222375504,0.0516494613958255,0.0782050216670643,415,600,246,1261
383,ALE,0.0705099889626613,0.0258894581675587,0.0443719274937023,0.0896284400371183,276,781,205,1262
384,TPX,0.0407326296248714,0.1602435746221576,0.0085980041343453,0.042005178499324,508,250,504,1262
385,TT,0.0359691069819237,0.2169675523301145,0.0121508367229315,0.0371242984211376,567,136,560,1263
386,BAX,0.1357737159262159,0.0179120929591696,0.0299560984686606,0.0528576891068175,61,811,392,1264
387,SNY,0.0478831803625331,0.0897917277794074,0.0394947565434671,0.0621151256369527,436,494,335,1265
388,RHP,0.0489645553428944,0.0942103937435613,0.0276906811160854,0.0551104356301521,424,471,372,1267
389,E,0.0463705401851819,0.0949671895682541,0.0297545113553958,0.0576725656737548,453,464,355,1272
390,AVT,0.1659990283121323,0.1442430225111728,0.0228972568267985,-0.1956204228973128,39,286,948,1273
391,POST,0.0524494392975639,0.0552419429225007,0.0,0.0778647002914051,387,640,249,1276
392,BRO,0.0435954327812013,0.1219612607818132,0.0067559148560414,0.0471061046226283,472,350,454,1276
393,CNS,0.0345596471245491,0.2340443825631609,0.0301133219208754,0.03594847098206,592,112,572,1276
394,CW,0.0415647916915748,0.1270445742149865,0.0035465767692172,0.0472997666027948,494,332,452,1278
395,COO,0.0757971583537125,0.0498695029888025,0.0007729145991201,0.0553922129369415,239,669,370,1278
396,CBOE,0.040151722252597,0.1681663193786702,0.011786065042626,0.0394450856907572,517,232,532,1281
397,HST,0.0533209743961327,0.0767019105917269,0.0394142878306548,0.0572840197904399,380,546,357,1283
398,MTD,0.0297641988652917,0.5297357106756442,0.0007257867244966,0.0324725221769948,651,12,622,1285
399,BCO,0.0215834951480204,0.1060609313609721,0.0097457971249898,0.1229791622059956,750,413,123,1286
400,MSI,0.0317169922291884,0.3134210526315789,0.0109311342439976,0.0332388139745327,625,51,613,1289
401,TSM,0.050677097030793,0.1994629370617912,0.0176310696027976,0.0227170480651951,409,165,718,1292
402,NE,0.0723100936849227,0.1264627477286679,0.0148256834303345,0.0247218766370613,259,336,701,1296
403,TSCO,0.0469189754822235,0.2109395871014819,0.0190527586566042,0.0245839996766802,446,148,703,1297
404,CNI,0.0513116656162,0.1385022359387793,0.0188918150206489,0.0344631951463117,401,305,591,1297
405,GSK,0.0411367077880545,0.1843319187073305,0.0187569363635873,0.0334235750777943,500,187,610,1297
406,KO,0.0419011122019409,0.1525791830788323,0.0310992761088141,0.0381192963069179,488,266,544,1298
407,PEP,0.0386310589967879,0.2046101557053218,0.0284475133586661,0.0337351235938447,540,155,604,1299
408,WSO,0.0342647571786349,0.2514659972415879,0.0244459589313732,0.0335808509301432,597,94,608,1299
409,CLF,0.038238095876994,0.0482571815524984,0.0,0.1553482541769609,545,680,74,1299
410,BABA,0.0392827154594957,0.0733724600476861,0.012300304814612,0.0892703122569912,529,564,210,1303
411,FDX,0.071678949331332,0.066778144840056,0.0212402123270337,0.0476596438026304,264,596,446,1306
412,NTRS,0.0632228031328034,0.0118013017847777,0.0378720178072686,0.1113264892516392,316,840,153,1309
413,GIS,0.0512537133699655,0.1110971734403746,0.0254480347928519,0.0412792060608331,402,394,513,1309
414,GGG,0.0339030455427678,0.2776521645327696,0.0105972661590126,0.0312076613537537,601,75,633,1309
415,URI,0.0615233295171102,0.1743349125364431,0.0103046500758856,0.0160914979017524,330,214,766,1310
416,FTNT,0.0248800509722403,0.3493036526455549,0.0,0.037530336516237,715,41,556,1312
417,FRO,0.1470596158879829,0.1320102336403522,0.1431421423980554,-0.1736814537774141,48,319,946,1313
418,PAG,0.0965450708604766,0.1171975352309324,0.0173344786362667,0.0053717633425977,154,363,812,1329
419,LVS,0.0324340262420757,0.1332680341092417,0.008101865687005,0.0523300832898356,618,314,398,1330
420,RL,0.0649298218808655,0.1329682779456193,0.02463283657734,0.0240365803213075,308,315,708,1331
421,AEL,0.0474726366486666,-1.700427331221906e-05,0.0098483228310953,0.8770982833241566,440,889,7,1336
422,ETSY,0.0270775435724665,0.1417189847763036,0.0012525987422262,0.0585982559614512,691,296,349,1336
423,FNB,0.0976358540513472,0.0,0.0366386091491653,0.067439198159178,149,884,303,1336
424,TJX,0.0351399757975315,0.2814231877632454,0.0134512371620625,0.0263901419154131,581,70,687,1338
425,MKC,0.038911142067747,0.098633672695987,0.0239264075159449,0.0556510515556052,535,446,363,1344
426,LW,0.0634842129505529,0.1709628653383983,0.009193223820077,0.0067769350131574,315,225,807,1347
427,ROK,0.0386726950075184,0.1613850057211084,0.0164132001346463,0.0367390602571425,538,247,564,1349
428,HON,0.0403773052940042,0.1831526543525799,0.0203741969979466,0.0306933174389381,514,192,643,1349
429,MA,0.0277462147545621,0.5555682859761687,0.0053484887396467,0.0287722918343645,681,7,666,1354
430,ASB,0.0570344519063864,0.0051160428499903,0.0439657452620592,0.1187496592696826,360,860,134,1354
431,DAR,0.0800316992378777,0.0552534958198627,0.0,0.0422888217386005,216,639,501,1356
432,KGC,0.057108937425296,0.0793707820264975,0.0202069336322855,0.0466007833418993,359,537,461,1357
433,CAJ,0.0835689112762145,0.0947405444835459,0.0408751558935468,0.0253747552752155,199,465,694,1358
434,CLX,0.0075444007325129,0.3038728897715988,0.0295193666245303,0.0470892126257516,843,60,455,1358
435,LYG,0.1767277111758359,0.0088386941289463,0.0534390936174551,0.0438582506672633,32,848,484,1364
436,AMGN,0.0433481359333524,0.1002640867423376,0.0294021300152379,0.0474912806808903,474,442,450,1366
437,AXTA,0.0354738686668233,0.1005201382472709,0.0,0.0580264403697401,575,441,353,1369
438,SF,0.0666051863485039,0.0248530600911422,0.0255268300061299,0.0724044732173472,297,787,285,1369
439,PB,0.0666400470524032,0.0,0.0326933798838707,0.0982756181400897,296,884,190,1370
440,JCI,0.0505515090349954,0.0895436164067013,0.0267931199860981,0.0459857426700175,411,496,465,1372
441,TRGP,0.0421848943238345,0.1135004671441918,0.021764797566499,0.042083023050413,484,388,502,1374
442,TXN,0.0416929889684578,0.2525492627807634,0.0291850922779204,0.0086396070842472,491,93,796,1380
443,EMR,0.2371126988101369,0.0750914779657421,0.0214888428152314,0.0049148104602449,14,553,814,1381
444,JHX,0.0530721740103905,0.196044211751018,0.0134338940463801,0.0008085214009395,385,168,828,1381
445,OHI,0.0315386684951332,0.0903981174248315,0.0838496484761581,0.0754965504721328,628,490,263,1381
446,SRC,0.0531054153627323,0.0403042881490174,0.0667388854333165,0.0739853689317266,384,724,273,1381
447,WTW,0.0412638067524015,0.1111786148238153,0.0137676397884789,0.0431412121781032,498,393,493,1384
448,MAA,0.0352462984025713,0.1545056578778168,0.0417878970281387,0.0381157673656573,579,261,545,1385
449,EDU,0.0325132188709112,0.0458884263596588,0.0023610176587455,0.1517964950914694,617,688,80,1385
450,UNP,0.042561475143498,0.1464224679972914,0.0211706475357139,0.0318460449694177,482,280,624,1386
451,BUD,0.0402397417664862,0.0753223867771112,0.0227003074222847,0.0649968642987224,515,552,319,1386
452,BCS,0.0533983878449775,-0.0007685110932905,0.0229372424684929,0.1320592189221863,379,900,109,1388
453,HIW,0.0613777648451275,-0.0005550148857658,0.0881191797502167,0.1099450906422241,332,899,157,1388
454,APH,0.0313393620859843,0.1913905650642679,0.0081371808403753,0.0350438437350485,631,174,583,1388
455,VMW,0.0253389263633097,0.1072906717605858,0.0433885725399139,0.0742426685682971,709,410,271,1390
456,CHE,0.0306596386219932,0.2366406048854968,0.0026441799239441,0.0307649467833757,642,109,640,1391
457,CACI,0.0482118808801145,0.1012157121742615,0.0012813143644305,0.0406435422635722,433,438,520,1391
458,BMO,0.0579147000486392,0.0050222399997253,0.0358633297208412,0.1050027345211755,356,861,175,1392
459,FMC,0.1669645105909165,0.0980963753863444,0.0367031330508219,-0.0657371432920573,37,449,908,1394
460,PPG,0.0358016150756936,0.1029952389561863,0.0168577683584762,0.0524902419456232,569,432,395,1396
461,PXD,0.089928586338793,-0.0418264514402925,0.0606200258135835,0.0712409336402739,175,931,290,1396
462,AME,0.034400496314107,0.1406362429330135,0.0060337376792446,0.04188890732293,594,298,505,1397
463,JBT,0.1830693815987933,0.0739892183288409,0.0040221216691804,0.0060017596782302,26,560,811,1397
464,REGN,0.0395908043627552,0.136464487065361,0.0,0.0367268398626166,525,308,565,1398
465,SHW,0.0296510453768486,0.2261644464859899,0.007741693319466,0.0326883908238157,654,124,620,1398
466,CFR,0.0858008211856795,0.0344402043613374,0.0342928939295504,0.045946405533314,188,745,466,1399
467,SWN,0.2159075375561065,-0.0949132722666147,0.0,0.0479794527902458,15,947,439,1401
468,MDLZ,0.0499752592737412,0.1050441024857764,0.0217678080321196,0.0362998354313401,416,418,568,1402
469,LAD,0.1101216884269235,0.1185213907199172,0.0058097773270799,-0.1173288932550245,108,361,937,1406
470,VRTX,0.0341488305398248,0.19549805033676,0.0,0.0309345232874296,598,170,638,1406
471,WWE,0.0323791270797903,0.3069006608168129,0.0059096873044402,0.0208080586601719,620,57,734,1411
472,ABC,0.0455648118015007,0.1705134085125763,0.0104103206942742,0.0220830055560768,458,226,727,1411
473,IEX,0.0361740819893669,0.1385673544707263,0.0115725506381014,0.0380370987937178,565,304,548,1417
474,KMX,0.0439470605861998,0.0440308235810913,0.0,0.0780213943663415,469,700,248,1417
475,MAN,0.0224378070985338,0.1150229500062027,0.0364614365351174,0.0682230621239203,742,377,299,1418
476,BR,0.0319939604169869,0.1604688624601569,0.0167935313955323,0.0379554103836789,623,248,549,1420
477,WMT,0.0347279034842357,0.1688418841884188,0.0137469748819036,0.0338524853769353,590,229,601,1420
478,NVO,0.0266537791339074,0.7082323535707135,0.0101180717917239,0.0222994441490281,694,4,725,1423
479,AEM,0.0735683342106463,0.0658377289011927,0.0242021628006167,0.0354892319252985,251,597,576,1424
480,FUL,0.0346865267798054,0.0881066219704254,0.0103875742178354,0.0620599810874576,591,504,337,1432
481,SJR,0.0452105881396952,0.091719298245614,0.0350322881920152,0.0434944794275864,462,481,490,1433
482,IBN,0.0400061230571116,0.0429297293002985,0.0022069876998659,0.0896214205002048,520,708,206,1434
483,ANET,0.0279470334828689,0.2808501717015876,0.0,0.0267722737478687,678,73,683,1434
484,J,0.0383408050960364,0.0960500593681853,0.0073954585250511,0.048217157198873,543,458,435,1436
485,CUBE,0.0391709336389558,0.0803801868476661,0.0421710470205453,0.055274848030215,532,534,371,1437
486,FSS,0.0337904707437639,0.1578577946234295,0.0051093596169096,0.0352288198796166,603,255,580,1438
487,FNF,0.0373921810562676,0.0002033166020712,0.0361626509248236,0.4895699682202623,552,877,15,1444
488,MSCI,0.0254320371296954,0.3460489543871154,0.0097644336282472,0.0253564446000933,708,42,696,1446
489,AU,0.0363378637411411,0.0456120892832385,0.0248369910419247,0.0949433746233184,563,691,193,1447
490,MSFT,0.0284380337363167,0.2875738645407972,0.0077814439819664,0.0233738071124976,668,67,714,1449
491,SCI,0.051524266708726,0.0605047320633334,0.0161081836132709,0.0486410895021026,399,618,433,1450
492,KWR,0.029489102090047,0.0946362574524832,0.0082780189551033,0.0628292484484965,657,467,328,1452
493,IT,0.0245508312872869,0.2786617219456902,0.0163830879368597,0.0292844417505093,721,74,658,1453
494,NYT,0.0287975419660259,0.1454934675393098,0.0086080222005879,0.0418788508388011,666,282,507,1455
495,PAYC,0.0284360016836841,0.2714072317210457,0.0054102065717299,0.0240484591630218,669,79,707,1455
496,NNI,0.02772945497585,0.0612340037250909,0.0119419152394029,0.108712356980879,682,616,161,1459
497,GS,0.0638384322144621,0.026430049701147,0.0314019718819142,0.0554425839194647,312,779,368,1459
498,FCN,0.0406887863207572,0.1551763607795623,0.1232578986574322,0.0259003725389561,509,260,691,1460
499,CMI,0.0214996273836688,0.0921892995497853,0.0269403494154543,0.0805285363091703,752,478,233,1463
500,VLY,0.0904442951104377,-0.0009009697538898,0.0434973938557671,0.0529394973408106,174,901,390,1465
501,WAT,0.032912355414368,0.2198456508448445,0.0799038116357629,0.0226600998702326,615,132,720,1467
502,AVY,0.0306797560453147,0.1749088071747289,0.0156570444867441,0.0329914116201009,641,212,616,1469
503,CTAS,0.0276183922555006,0.2463903172835864,0.009218020777604,0.0259525934985674,685,98,690,1473
504,ODFL,0.0277773372329828,0.3302658052412216,0.003923758250318,0.0181930844617463,680,46,749,1475
505,FDS,0.0275793736232028,0.1810386134813953,0.0081647783267072,0.034448930551296,686,197,593,1476
506,RYN,0.0350757389405011,0.1053510041704171,0.0343695458599781,0.0438717144212662,582,416,483,1481
507,HLT,0.0237353489865983,0.1905128863772583,0.003286752970975,0.0353429955549786,727,175,579,1481
508,PDI,0.0357333332681289,0.020032247817643,0.153051756955856,0.1331554936765488,571,804,107,1482
509,PH,0.0410091350694705,0.0726176882898823,0.0138615135473202,0.0511730781537558,502,570,411,1483
510,M,0.020554598298549,0.1140825998645903,0.0354322123051179,0.0610765206585458,758,383,342,1483
511,TREX,0.0228263914787572,0.3187699949680773,3.334202003869423e-06,0.0248243564595426,736,48,699,1483
512,GHC,0.0635339123863114,0.0295821569838861,0.0095795428378351,0.0515072579528712,314,763,408,1485
513,CHD,0.0322725918393566,0.1479460488023281,0.0113825380163956,0.0344722192182003,621,274,590,1485
514,SID,-0.0125825025577768,0.0963902683305935,0.157411612413592,0.1140584722487289,887,456,145,1488
515,NU,0.0254680541961527,0.0356007642557758,0.0,0.2102655237427992,707,742,40,1489
516,COST,0.0260115008453675,0.2291378385247522,0.0051717081305713,0.0278842296888118,704,117,672,1493
517,PEG,0.0838266557645135,0.0806628141143507,0.0371872444807849,0.0157318070318887,197,531,768,1496
518,MMS,0.0354432764526054,0.0903504768781742,0.0149125430055763,0.0489932231645751,576,491,430,1497
519,NKE,0.0306831730114344,0.178815207780725,0.0121764386783049,0.0294848952488577,640,203,657,1500
520,INCY,0.0421259124878438,0.111973196807927,0.0,0.0316509512782892,485,391,625,1501
521,VAC,0.0687840789229604,0.0699809251311397,0.0287051667946213,0.0308715944772342,284,580,639,1503
522,FISV,0.0374987062457444,0.0846035787784715,0.0258628625866998,0.0477900721710758,551,516,443,1510
523,ADI,0.0407989176204324,0.0838521151706974,0.0206679965600378,0.0437726563986469,506,520,485,1511
524,FICO,0.0194886978059533,0.5323233904138231,0.0184731295651191,0.0210910488944973,768,10,733,1511
525,CPRT,0.0289694066657723,0.23803728036816,0.0001102144438853,0.0198375232664469,663,108,741,1512
526,NOV,0.1233362645879599,0.0712270007901569,0.0098122506570481,-0.0173887986327436,80,574,861,1515
527,MNST,0.0267593168601045,0.2291370399865897,0.0,0.0242198045516912,693,118,705,1516
528,NYCB,0.3243899443688416,0.0234830805134189,0.0709175994639548,0.0225460576330492,7,792,721,1520
529,FLS,0.0345523300953653,0.0908828348105237,0.0194194149454548,0.0478131511057102,593,487,442,1522
530,CLH,0.0398153766749528,0.1145745484097152,0.0,0.0326234334367998,522,380,621,1523
531,TRI,0.0404533341431,0.1281871108884195,0.0133893781306225,0.0269738929440021,513,330,681,1524
532,FLO,0.0260560445916836,0.1186891687661071,0.0412145163104097,0.0465052766451118,702,360,462,1524
533,IPGP,0.0427653230153401,0.0932216388081176,0.0461849386946188,0.0362443722773172,481,475,569,1525
534,ADBE,0.0193082241758815,0.3089000371609067,0.0,0.0246937531740917,771,55,702,1528
535,MKTX,0.0234021593177072,0.2224295138627157,0.0099445234018373,0.0279015805052372,731,127,671,1529
536,MET,0.0313027545888439,0.0023906005601833,0.0349924328863883,0.2489739371638661,632,868,30,1530
537,DG,0.0468069034343009,0.1434885126268996,0.0095653519966372,0.0082139708706251,447,289,798,1534
538,NVDA,0.0191029189658157,0.5984354865056174,0.000253550167725,0.0173447571698691,772,6,757,1535
539,CR,0.0382023659491071,0.1520492901151888,0.0085541053883698,0.02252730371911,546,268,722,1536
540,ATO,0.056249402876086,0.0504218503772565,0.0273255307042284,0.0415123034042534,362,665,509,1536
541,TTC,0.0387314959309021,0.1597729717698557,0.0166696975207613,0.0184788119803788,537,252,747,1536
542,PFG,0.0323863378296227,0.0026915763369815,0.0325058637875946,0.1917819979564179,619,867,52,1538
543,RLI,0.0501851848825301,0.0040127857961579,0.0230805621128202,0.0755129603980106,413,865,262,1540
544,LEG,-0.0383518677331551,0.0950799252646875,0.0671157685330214,0.1074861556205531,912,463,166,1541
545,ROL,0.0203213168266751,0.2889015148325392,0.0123504150076856,0.0231686381312751,761,66,715,1542
546,WAB,0.0357792748001958,0.0886686311277792,0.0053998169330356,0.0445594649352131,570,500,477,1547
547,TMUS,0.0432182395949763,0.0763892607387258,0.0038816911118729,0.0402615029916889,475,548,525,1548
548,HWM,0.0339789783387344,0.1391716797778806,0.003242438455853,0.0302923702313946,600,302,646,1548
549,VRSK,0.0174581586294063,0.3148246028875845,0.0055920664359817,0.0236043170140752,790,50,712,1552
550,ABB,0.0425414155720488,0.147530836907025,0.0291859893500359,0.0090239366364952,483,275,794,1552
551,UA,0.1004421632469818,0.0810844090838445,0.0,-0.0513443944461959,132,528,895,1555
552,UAA,0.1004421632469818,0.0810844090838445,0.0,-0.0513443944461959,132,528,895,1555
553,WAL,0.101201771030993,0.0834141394152278,0.0240256142466989,-0.0620463239059064,130,521,905,1556
554,ZTS,0.0256910406220045,0.2475598935226264,0.0075845563611037,0.0177667136724698,705,97,754,1556
555,NFLX,0.0247107644633172,0.1744110813239094,0.0,0.0316458706970713,717,213,626,1556
556,ADT,-0.0268570355463741,0.0748165236870823,0.0206830264114401,0.1368560193698658,903,556,99,1558
557,IDXX,0.0181292843309674,0.4752809115318201,0.0,0.0165811203992627,784,13,763,1560
558,ATR,0.0343965679434413,0.1262330183176117,0.0125360362831336,0.031053358938446,595,337,634,1566
559,TRQ,0.2057608973002174,0.0635853712443756,0.0,-0.1271275602617258,19,608,939,1566
560,WNS,0.028966210785976,0.1393654537791748,0.0,0.0337553776026453,664,301,602,1567
561,WLK,0.0266131251297913,0.0675253494107974,0.0122787070014277,0.0723388077640675,695,591,286,1572
562,ATI,0.0602301884026097,0.1163672654690618,0.0023458690711824,-0.0168316105857341,342,370,860,1572
563,VTRS,0.0041849240673452,0.0514456964876804,0.0440373362552825,0.1778860502556591,854,661,59,1574
564,CAH,0.0105338184001995,0.0748635567912676,0.0211887151728151,0.0951676007190441,827,555,192,1574
565,VMI,0.0290385957577492,0.1058534403448223,0.0100215791527789,0.042503720254472,661,414,500,1575
566,RSG,0.0331474413905051,0.1046030800020602,0.0122191694692555,0.0380439178570286,611,422,546,1579
567,LYV,0.0260542834319101,0.1169833649728081,0.0,0.04142269354808,703,366,510,1579
568,DLTR,0.0479376811332284,0.118971745340987,0.0002759814501293,0.0107128283329797,434,358,788,1580
569,WPC,0.0506552117496842,0.0012489005429123,0.0655439682761777,0.0680667384734203,410,871,300,1581
570,JKHY,0.029976403664973,0.2024719293272347,0.0120378668972786,0.0142729790310344,649,161,772,1582
571,KIM,0.0496646352941972,0.0322731334874433,0.0499065544818797,0.0509684332131288,419,751,413,1583
572,TR,0.0407896395274187,0.1034994335540165,0.0111284815996774,0.0300956284767157,507,427,649,1583
573,STOR,0.0365138495940296,0.0308600462152152,0.0488928865715621,0.075100374423858,560,758,266,1584
574,VNO,0.0195508017327072,0.0490929713735961,0.0354310328252075,0.1139769078926488,766,673,146,1585
575,ETN,0.0333150773335291,0.1301939058171745,0.0142764113247161,0.0296812699550118,609,326,652,1587
576,STN,0.0280473817935196,0.1188298587760591,0.0071896821083025,0.0376082193674579,676,359,553,1588
577,GM,0.2059401543239501,0.0520549325659644,0.0121404435796779,-0.0748355651142625,18,657,917,1592
578,OSK,0.0300135176862123,0.0702399818881593,0.0167930722879152,0.0555051597923283,648,579,365,1592
579,PBH,-0.0263417294776969,0.1081943267395633,0.0,0.0710285119729331,902,406,291,1599
580,EW,0.0301807206228109,0.1878229143710668,0.0036563779476722,0.0135473214718051,645,181,775,1601
581,MLM,0.037727979684924,0.1123868758517069,0.0056161078494112,0.0283419787503908,549,389,668,1606
582,HSIC,0.0417057071752616,0.0904942965779467,0.2105336179520419,0.0313795344852329,489,489,629,1607
583,AER,0.1853545280531453,0.0479431555036652,0.0,-0.0573867800289371,25,682,901,1608
584,TER,0.025167986687053,0.1847783752577494,0.0038068969059609,0.0238689037289108,713,186,709,1608
585,RJF,0.0798319186924532,0.0989261174276192,0.0162969126715473,-0.1692583578028034,219,445,945,1609
586,NWL,-0.1079460536814612,0.0615152169220807,0.0511909120551259,0.1797246151500617,939,614,56,1609
587,RCL,0.0463083360189621,0.1122425184609405,0.0,0.0158272450742475,454,390,767,1611
588,CBU,0.0472312941543225,-0.0014054873836653,0.0340483197648978,0.0751249098638024,443,904,265,1612
589,RMD,0.0278393522393182,0.1888599949108778,0.0080109057696256,0.0173476884652305,679,179,756,1614
590,FTV,0.0330674746058752,0.0749776793095466,0.0038956830790012,0.047580803723723,613,554,448,1615
591,STWD,0.0519718744755611,0.0247432060319022,0.0921104885712268,0.0482255078130911,395,788,434,1617
592,HOLX,0.0264058947129573,0.0842662632375189,0.0,0.0521748051236284,700,518,401,1619
593,SBAC,0.0181627622941701,0.124683869261009,0.0133904640350394,0.0426273239535169,782,340,497,1619
594,MCO,0.0223619819033539,0.183220590661607,0.0078482624726145,0.0265226742425591,744,191,685,1620
595,TDY,0.0414318165945348,0.082370825432149,0.0,0.0337367349305391,496,525,603,1624
596,CDNS,0.0140148984466731,0.3124431180711926,0.0,0.0167815359750518,813,52,760,1625
597,MDU,0.1028722887023476,0.0630432392267465,0.0400160742989819,-0.0464185072731241,126,610,891,1627
598,ENPH,0.0231820061375678,0.1563694610503258,0.0,0.0309690742544263,734,256,637,1627
599,QSR,0.0334013710841804,0.1038172781918564,0.0282972886507193,0.0343854932231705,608,424,595,1627
600,GE,0.0664807777736941,0.0571013381593845,0.0041300683586864,0.0251310101825672,298,633,697,1628
601,MHK,-0.0667095747673654,0.0777174474059087,0.0,0.1078709955127111,926,542,162,1630
602,APO,0.0919733349051291,0.0857042754242964,0.018842961817298,-0.324375938440915,169,511,953,1633
603,TDG,0.0269143639679618,0.1589364363003643,0.0007879397771822,0.0256287780157171,692,253,692,1637
604,EGP,0.0240973261062917,0.1300267825606075,0.0271182207816414,0.0345053142662307,725,327,589,1641
605,CMG,0.019389376402275,0.2221088415490914,0.0,0.0192948388779504,770,129,743,1642
606,ETR,0.1099240809895826,0.0491113683886049,0.0435782013942776,-0.0194178533827947,109,672,864,1645
607,IQV,0.0315036662797608,0.1031203566121842,0.0,0.0347978640792645,629,430,586,1645
608,BMI,0.0204836951706553,0.2018031663108085,0.0064266216559523,0.0217038949866484,759,162,730,1651
609,WST,0.0223800922630052,0.2140798682585426,0.0021497560818862,0.0156328753674008,743,141,769,1653
610,LHX,0.0265934283982457,0.0854836384604295,0.0216353315782338,0.0477279421158723,697,512,444,1653
611,SPG,1.4957369431375004e-07,0.0910558283334387,0.0523107852609179,0.0672333755940306,863,484,306,1653
612,COTY,0.0466448862032742,0.0547819603417701,0.0012574477390493,0.0369799776688295,450,643,562,1655
613,STR,-0.0086803638743636,0.0442089804456332,0.0847629550688612,0.1543440400802206,882,698,75,1655
614,ALGN,0.0212135751475526,0.1636254606581626,0.0,0.0289833491836272,753,241,663,1657
615,ZBH,0.0401246214316417,0.0744118672711177,0.0078721059039226,0.0349679806304659,519,557,585,1661
616,EPAM,0.0237406120793275,0.1421902968981502,0.0001689972433868,0.030408062770255,726,294,644,1664
617,WM,0.0316154377194401,0.125013113263629,0.0155881672088906,0.0250288881945567,627,339,698,1664
618,LIN,0.0306595195664956,0.1232678895136264,0.0122756779422555,0.0272913742487373,643,344,678,1665
619,GNRC,0.0253214731516272,0.091678395533717,0.0217646795064939,0.044887640865734,710,482,474,1666
620,HASI,0.0492978880008937,0.0325020083086598,0.0529247784951947,0.0430023347931147,423,750,494,1667
621,CAG,0.0408178180643087,0.0624293801350223,0.0372471546350435,0.0378084294884732,505,612,551,1668
622,ADSK,0.0165259227155921,0.2028412156087034,0.0,0.0228371470639308,795,159,717,1671
623,ORCL,0.0290175027788959,0.1228278253993926,0.0125174879681277,0.0289048863386156,662,346,664,1672
624,DISH,0.2574148887836534,0.0439150790147522,0.0,-0.8746947041914797,12,701,961,1674
625,MTN,0.0286388593568288,0.1048558882089673,0.033573345461533,0.0346735173450999,667,420,587,1674
626,CARR,0.0275278875458245,0.0885426709344028,0.0126518089536035,0.0436283347464587,688,501,486,1675
627,AZN,0.0283030436109265,0.1160859770180087,0.0212973868044604,0.0312117695034348,672,371,632,1675
628,BRX,0.0433590742866419,0.0612783950277762,0.0448087019591541,0.0346257781615558,473,615,588,1676
629,SAM,0.0180214956476717,0.0985283389381976,0.0,0.047520970503652,785,447,449,1681
630,AVB,0.0350254821765394,0.0442820784581002,0.0347928902737968,0.0515949401663729,583,697,406,1686
631,KEX,0.0477173244322238,0.0654095729987424,2.1404142208367402e-10,0.0296443088757446,437,599,653,1689
632,CRL,0.0390218992058581,0.0864521012073106,0.0021044944081469,0.0300394234443357,533,507,650,1690
633,ICE,0.0326337338820982,0.0717866998328734,0.0131609864262685,0.0420738131512018,616,572,503,1691
634,NOK,0.0384765393709135,0.0634468854694773,0.0359307232320861,0.0384765393709135,541,609,541,1691
635,MPWR,0.0138921198809142,0.218160344248234,0.0060410018558654,0.0188739863142228,814,134,744,1692
636,KOS,0.0692304699626736,0.084807031408271,5.382286443332624e-05,-0.0542874919317175,281,514,898,1693
637,EQR,0.0349449490166847,0.0464075016242919,0.0415454543262742,0.0502295526078953,586,686,421,1693
638,TEF,-0.0439262729977828,0.0320420142106889,0.0845531510506649,0.2702549172778388,918,752,27,1697
639,HTZ,0.1894178169596595,0.0425403319540657,0.0,-2.2225843847149664,24,710,964,1698
640,HDB,0.0486015330539819,0.0273052836090274,0.0084749655858693,0.0425326453389967,428,772,499,1699
641,BAH,0.0220941591930341,0.0960220457375132,0.0191623996745189,0.0428153135817504,746,459,495,1700
642,BIP,0.0070507695500212,0.040165105572313,0.1047937905669828,0.1211764609920322,845,725,130,1700
643,BAP,0.1127496075423844,0.0434804622194729,0.0291157599486552,-0.0494318058748719,104,704,893,1701
644,AL,0.1320191067350097,0.0490727999837772,0.0280293209095425,-0.597357771805062,67,675,959,1701
645,AIN,0.0362945626727629,0.1086510730709465,0.0101786128201161,0.0207821646794446,564,403,735,1702
646,ABMD,0.0089819970550604,0.2428062147216561,0.0,0.0164253981822172,836,102,764,1702
647,ASX,0.0252766638083136,0.0932396952516316,0.0301488479750706,0.0406998714479811,711,474,519,1704
648,HAE,0.0274614343013781,0.0927107341671969,0.0016695645883351,0.0387566955257108,689,476,539,1704
649,JPM,0.0954144621084136,0.0160838242599683,0.0259235732839355,0.0224961083470414,162,820,723,1705
650,NEE,0.0592618813505469,0.0684630097775637,0.0306605246604334,0.0142115017794129,347,586,773,1706
651,FTI,0.0063622132532373,0.098130300693909,0.0049244889059755,0.0510675159881739,847,448,412,1707
652,ELS,0.0227924699587466,0.1751351923738746,0.0248503476643983,0.0167507864891737,739,210,761,1710
653,DOC,0.0282538034317722,0.0251940429825587,0.0606627327449402,0.0778014844222527,674,784,252,1710
654,WY,0.0329544825530473,0.0994751466502006,0.0477623966442259,0.0295765498956432,614,444,654,1712
655,JBHT,0.0349079954000995,0.1453208003758691,0.0083352175503428,-0.0056469711282391,587,283,845,1715
656,SYK,0.0275450201814921,0.1215341814885436,0.0099127260621546,0.0272926329507612,687,351,677,1715
657,STZ,-0.0008938548710438,0.1310454503549368,0.0136446365639609,0.0399680820909627,870,321,529,1720
658,PEAK,0.0282399159471929,0.02337537554313,0.060632915422555,0.0777632429544174,675,793,253,1721
659,LPX,0.0349036033068222,0.1326860841423948,0.0135300484728693,0.0031374025444334,588,318,819,1725
660,NJR,0.0671505253282363,0.0710186004170728,0.0382961736011084,-0.0157082978176378,293,576,857,1726
661,BLK,0.0449717405373559,0.0577104393667347,0.0248072032953245,0.031019221253956,464,629,636,1729
662,CP,0.0531981748379487,0.0591438430019409,0.0095775680189533,0.0221896130340107,383,623,726,1732
663,ATHM,0.0769268479045143,0.0441540458642302,0.0,0.0079828369783795,233,699,800,1732
664,ECL,0.0241486152556144,0.1234629274090327,0.010862741526846,0.0288065897933694,724,343,665,1732
665,INTU,0.0164628263993575,0.1309295539808253,0.0061390321598275,0.0330499526624685,796,323,614,1733
666,SSL,0.0603123317234296,0.0623623507592442,0.0385472030912663,0.0128023574030031,341,613,780,1734
667,ADC,0.0283629028566951,0.0343938814061531,0.0475799005770857,0.0647584486808363,671,746,321,1738
668,PWR,0.0231874741923834,0.1028904921023549,0.0014868599746131,0.035532098617227,733,433,575,1741
669,HES,0.031165703762183,0.1501663692916043,0.0121550754904606,-0.0037434926371363,633,269,840,1742
670,CME,0.0420759549178649,0.0946755508525952,0.0,0.0093144033802355,486,466,792,1744
671,ABT,0.0297279505536343,0.1083825981506745,0.0184715345393541,0.0262788226194017,652,405,688,1745
672,LLY,0.0099524765771734,0.2812456589064939,0.0077283438164055,-0.0059862236033987,830,71,846,1747
673,SNPS,0.0168813722551875,0.1727428249461054,0.0,0.020746103594675,794,217,736,1747
674,AGI,0.0401409480848227,0.0839957697285212,0.0067475021986037,0.0236640445937122,518,519,711,1748
675,LDOS,0.0133225146480713,0.0639876352395672,0.0134564092676499,0.0641355227781526,818,607,325,1750
676,SAP,0.0156091000339154,0.1225728381271525,0.0145123426169361,0.0336116761988077,800,348,607,1755
677,ASR,0.0068136067379235,0.2318839223861361,0.0039925225931036,0.0081529000777862,846,114,799,1759
678,LH,0.0209938382582467,0.0832376536184147,0.0127570213339585,0.0439012297165872,755,522,482,1759
679,IR,0.0246174292790289,0.0847614332930504,0.0010242772680628,0.040212366820245,719,515,527,1761
680,JLL,0.0247144934350761,0.0704045245199455,0.0,0.0452404613634091,716,577,472,1765
681,SXT,0.0336702740157662,0.0871796832866475,0.0249558184457177,0.0295008764207136,604,506,656,1766
682,TMO,0.0291094989126303,0.086384777014425,0.0025394942337457,0.0336349456159783,659,508,605,1772
683,FCX,0.0300837510139835,0.130282067207813,0.0140488512581535,0.0074069841511701,646,325,806,1777
684,MSA,0.0088277919365734,0.2159370217249794,0.0110738059477136,0.0075484454787015,838,137,803,1778
685,R,0.0777514438701659,0.0640315052508751,0.0245127704812345,-0.1687168030778724,230,606,944,1780
686,BXP,0.0172439986703151,0.0409493582699731,0.0623535340610929,0.0740639329688444,792,717,272,1781
687,MDT,0.0310019554825778,0.0669743702455523,0.0298305138438003,0.0377831176450789,636,593,552,1781
688,OGE,0.0593949044359072,0.0559962106532317,0.0474817230279374,0.0077093673943919,346,635,802,1783
689,TFX,0.0302106541482603,0.0731053346753682,0.005417312019985,0.0355408089634666,644,566,574,1784
690,ED,0.0792741122251412,0.0533832200303997,0.0344916343782273,-0.073577957277642,222,649,914,1785
691,VAL,0.170319562719185,0.014952905335532,0.0,-0.0843528594654988,35,825,926,1786
692,O,0.0219209257125842,0.030862477178727,0.0530688752189366,0.0726269741807642,748,757,283,1788
693,DOW,0.0151485691417731,0.0453447198500312,0.0507181296223711,0.0699303217257743,803,693,294,1790
694,CHK,0.0002198976274458,0.2405450926351248,4.4270419415517305e-05,5.008829794240254e-05,860,104,830,1794
695,ESS,0.0254739443126849,0.0445878611723261,0.0368449305412001,0.0527081690919764,706,694,394,1794
696,EXR,0.0296042369427215,0.0443761774150578,0.0385659910224876,0.0474103525845256,655,695,451,1801
697,WEC,0.0501291816487254,0.0537515872545711,0.0370148852717199,0.0197635868830409,414,646,742,1802
698,VMC,0.0307466877537744,0.1022468559291829,0.0075252287644257,0.0216597433876246,639,436,731,1806
699,SMFG,0.5539182015199113,0.0118636296299289,0.2073132569143892,-4.25783623902652,3,838,965,1806
700,TFC,-0.0221855856343355,-0.0001093770974301,0.0636691738048622,0.4136361112630797,897,895,17,1809
701,IX,0.105659811795763,0.0250563842478783,0.0411263623391802,-0.0646112215784208,118,785,907,1810
702,GPN,0.0296739530803764,0.0404384016504204,0.0078358940277556,0.0478582242692078,653,720,440,1813
703,DLB,0.02521786765171,0.0857257364498697,0.0102183268600316,0.0342321325382109,712,510,597,1819
704,RCI,0.0261442398528051,0.0737190082644628,0.0295623913529952,0.0373533132408158,701,562,558,1821
705,ESI,0.0211421562063417,0.0550741633548331,0.0138560786652908,0.049552488043314,754,642,427,1823
706,BURL,0.026595080345415,0.0975640597993608,0.0,0.027519196530761,696,451,676,1823
707,TGT,0.0355014788856167,0.1137283877641495,0.0234463004438821,-0.019283177380317,574,387,863,1824
708,DEO,0.0094778049302251,0.1891669939657942,0.0044698485490429,0.0046805228418144,833,176,815,1824
709,IP,0.022820982467067,0.0415500984353953,0.0508717734161703,0.054833749538925,737,714,375,1826
710,CIEN,0.0415869749033858,0.0765707229550908,0.0813259081792912,0.0101402390077263,493,547,789,1829
711,CCI,0.0300445307152318,0.0692226364698681,0.054468213806642,0.0340451340062081,647,584,599,1830
712,CS,-1.0002653516001097,0.0037989998068973,0.0383348341702752,1.6952211310583845,964,866,3,1833
713,DTE,0.0615051097230024,0.0577022020991973,0.0331079760284165,-0.0314349666014486,331,630,878,1839
714,AWR,0.0420098813767745,0.0946093265733717,0.0205793636846624,-0.040643192365998,487,469,885,1841
715,TRMB,0.0234905811296607,0.064124513618677,0.2345586970235705,0.0418876376006254,730,605,506,1841
716,ST,-0.0006841109783839,0.0807194525984032,0.0125206865088501,0.0476140662724638,868,530,447,1845
717,SR,0.073221229106701,0.0489121544249959,0.055715463986938,-0.0748371458869868,253,676,918,1847
718,SJM,-0.0055159444021803,0.0896598921928226,0.0259907916957064,0.0433179861595107,876,495,491,1862
719,FIS,-0.1874293865279001,0.0429499551471987,0.0346747181869319,0.090503549581326,955,707,201,1863
720,UDR,0.0352622150281528,0.0272657097590551,0.0432191930133535,0.0412904378653985,578,774,512,1864
721,KBR,-0.0354261498459296,0.1224643125469571,0.0096252180713469,0.0335545796653899,909,349,609,1867
722,JWN,0.045705460369955,0.0523082650781831,0.0419535195933169,0.0177364473077437,457,655,755,1867
723,SNN,0.0220865119435122,0.121435977190254,0.0274611764468764,0.0152002230485768,747,352,771,1870
724,TECH,0.0215908394799235,0.1190925123785795,0.003805945261909,0.0163597745334866,749,357,765,1871
725,CPT,0.0371294957072388,0.0362617785587401,0.0400355296948133,0.0353533405490852,555,738,578,1871
726,WCN,0.0197955372973097,0.09179805131308,0.007151269057668,0.0315226505262365,764,480,627,1871
727,AKAM,0.0297766300897591,0.0774526784480007,1.0880182899300083e-07,0.0270462533566839,650,545,680,1875
728,AEG,-0.0852229008113575,-0.0040589168547648,0.0138850970102406,0.2288962399352851,933,909,34,1876
729,DHR,0.0277123758339845,0.0682551762143438,0.00725966520588,0.0336283049320455,683,588,606,1877
730,ALB,0.0924767302781804,0.016391562583488,0.0110014605798321,-0.0484259859572116,167,819,892,1878
731,TRP,0.0548170390687241,0.0525539450789192,0.0540103543733254,-0.0160961736895843,370,653,858,1881
732,NOC,0.0288937407388253,0.0733194613028148,0.015683567443837,0.0295120892760375,665,565,655,1885
733,OUT,-0.1869675291615479,0.0531473576624782,0.0899216508746292,0.0727192480986132,954,651,282,1887
734,ACM,0.0047557935590774,0.0602130922337717,0.0082677165841607,0.0507432480555223,853,620,416,1889
735,BIIB,0.0308172814162689,0.0553939471604621,0.0,0.0327999279771123,638,638,619,1895
736,FRC,0.0746440286794462,0.0147082388474256,0.0156012744627311,0.0024657186650868,246,827,824,1897
737,IVZ,-0.0119062129543528,-0.0142056128789849,0.0730714638178912,0.1396430446091026,885,918,94,1897
738,NEA,0.0122108537662188,0.005970583595519,0.0473082370494075,0.0853593297434613,823,857,219,1899
739,NWE,0.0630764431928884,0.0425227088290931,0.0500534488250947,-0.0252323968118092,317,711,873,1901
740,AMH,0.0291658851580964,0.0289536232088686,0.0255811406506755,0.0439872685608631,658,765,481,1904
741,MTZ,-0.0085078221239212,0.0219624896263641,0.0,0.0842003394953,881,801,224,1906
742,DEI,-0.017850429608689,0.0157859764586761,0.0528209571046007,0.096702670204194,893,822,191,1906
743,SWK,-0.020162589844776,0.0510443967020235,0.032850998849051,0.0580372184390818,894,662,351,1907
744,SE,0.0062692735537085,0.0113671836942344,0.0,0.0865022163353428,848,843,216,1907
745,SWH,-0.020162589844776,0.0510443967020235,0.032850998849051,0.0580372184390818,894,662,351,1907
746,AMX,0.0038515049552922,0.1680638596365067,0.0015417349661622,0.0029295403269552,856,233,821,1910
747,ALK,0.04722155171526,0.079032967032967,0.0,-0.089218591325853,444,538,928,1910
748,QRVO,0.0098581374814006,0.0298506878917364,0.0,0.065395790672967,831,762,318,1911
749,EVRG,0.0607790826206564,0.0438367511729245,0.0473400320808503,-0.0294046758255001,335,702,876,1913
750,NI,0.0600668783260993,0.0501896397426013,0.0384552477369805,-0.059764147313956,344,666,903,1913
751,C,0.091723830717965,0.0055654488959862,0.0518058740466009,-0.0406534967096312,170,859,886,1915
752,NLY,-0.1715341340738539,-0.0179282948037507,0.1584424204177171,0.2056939558796495,951,923,42,1916
753,GLOB,0.0152815073657736,0.1165508099760703,0.0043214612252566,0.018084437595052,802,369,751,1922
754,SRE,0.0650323806088939,0.0398230662463841,0.0322941285170019,-0.0460831080802536,306,728,890,1924
755,SJI,0.070840471324085,0.0412920530332961,0.0526289738652637,-0.1021953974198793,274,715,935,1924
756,CUK,-0.0038935646742138,0.0519673742660538,0.0010523147768145,0.0524578916242057,873,658,396,1927
757,CCL,-0.0038935646742138,0.0519673742660538,0.0010523147768145,0.0524578916242057,873,658,396,1927
758,PTC,0.0144287033588902,0.0817638888789811,0.0048449040259582,0.0344497192230974,808,527,592,1927
759,EXC,0.0650419224246555,0.0437496601598608,0.0400365441729087,-0.0755749141575143,305,703,920,1928
760,STT,0.0768502246616697,0.0078615604993923,0.0383460483136932,-0.004981033079923,234,850,844,1928
761,ROP,0.0236408242500955,0.0692421531246652,0.0049563409892918,0.0329130417659002,728,583,618,1929
762,APD,0.0364456362363614,0.0887546385737208,0.0237129550436216,-0.0225008468912515,562,498,869,1929
763,TW,0.0188782303206242,0.0819499942989926,0.0039275448669052,0.0310259435889669,774,526,635,1935
764,NSC,0.0339889195006207,0.0730650948231676,0.0227895054122935,0.0154410526466968,599,567,770,1936
765,CRM,0.0149534029404117,0.0787528716770594,0.0027911090594772,0.0343393184545527,804,539,596,1939
766,DXC,-0.0988923497716879,-0.0618314880840683,0.0003494429320554,0.1677326073866085,936,936,67,1939
767,TU,0.0245074854229394,0.0506236872562047,0.0383202655542989,0.0375334616227657,722,664,555,1941
768,DUK,0.057419460385384,0.0431198285648375,0.043358642804978,-0.0362213076453423,357,706,881,1944
769,ISRG,0.0149121942137634,0.1281887570014801,0.0,0.0062170082217113,805,329,810,1944
770,CBRE,0.0338885566741516,0.0779587556798322,0.0,0.0078706688421711,602,541,801,1944
771,ALL,-0.0051163771695276,-0.0034732980024459,0.0280856448880452,0.1077977125983984,875,908,163,1946
772,HAS,-0.2101415411151033,0.0428810346749916,0.0547471415783657,0.0728503845281191,958,709,279,1946
773,AMZN,0.0190853523806551,0.1015382835037485,0.0,0.0202094592488928,773,437,738,1948
774,XEL,0.0518225380929306,0.0442945898300443,0.0319538179545342,-0.0154209359542486,397,696,855,1948
775,THG,0.0081435967567722,0.0002726322645138,0.0270376640196516,0.0806977378333972,841,876,232,1949
776,SO,0.0516418899892663,0.0462880569503591,0.0394198028464344,-0.0200281172946299,398,687,865,1950
777,DXCM,0.0102556245187645,0.1269406392694063,0.0233066879645274,0.0096950215903149,828,333,791,1952
778,REG,0.0308505891202711,0.0273015930027279,0.0386293918932927,0.0384027664885849,637,773,542,1952
779,PHM,0.0001452606614395,-9.034012183065883e-05,0.0062404163259327,0.0921902921073529,861,894,197,1952
780,FNV,-0.0223239301789098,0.1267501970182228,0.0111523921859489,0.0224770961179797,898,334,724,1956
781,CNP,0.0507055368566216,0.0490920755348525,0.0295828377516822,-0.028974592489498,408,674,874,1956
782,EDR,0.0502611168903218,0.017045014494479,0.007682627329315,0.0220067552271966,412,817,728,1957
783,AEE,0.0604586166214999,0.04156329198346,0.0347427119821466,-0.0633450957136722,339,713,906,1958
784,RPM,0.0465732974782316,9.047091937315578e-05,0.0208121464789676,0.0313935417572108,452,878,628,1958
785,STAG,0.0272554083234134,0.0411401106036103,0.0378161105492533,0.0374213668149211,690,716,557,1963
786,SMG,-0.1313370743034055,-0.066060606060606,0.0515189628482972,0.1514125386996904,946,940,82,1968
787,VFC,0.0133485668160016,0.172116692047907,0.0791168015276891,-0.0932630134261486,817,222,930,1969
788,DD,0.0121864032237098,0.0484289501889772,0.0187549609896811,0.0452884772285387,824,678,471,1973
789,CMS,0.0518840642103608,0.0403304813532754,0.0338679517224339,-0.0155008760042227,396,723,856,1975
790,FE,0.052369356987935,0.0522348493580138,0.0430550248920773,-0.0935710198813468,389,656,931,1976
791,LNT,0.0541006857627465,0.0479069294858768,0.0350923367109707,-0.0759564393283511,374,683,921,1978
792,VEEV,0.0155035747674115,0.09072921450107,0.0,0.0261037667139384,801,488,689,1978
793,ANSS,0.0157805749519525,0.0973229372568714,0.0,0.0218161532378531,798,452,729,1979
794,UMC,0.0186274341627456,0.117104717978679,0.0137484005959305,-0.0024626010136223,778,365,838,1981
795,NDAQ,0.0358274081092953,0.0677951538064959,0.0149196288727093,0.0016239051834241,568,589,827,1984
796,PRGO,-0.0029168888784768,0.0164700524786398,0.0343825405596843,0.0697756567938016,872,818,295,1985
797,TSLA,0.0173208054757718,0.1141774752793116,0.0,0.0050314520606665,791,381,813,1985
798,RTX,0.0264542475320712,0.0309361642978767,0.0268185626780528,0.0390562396271612,699,756,534,1989
799,PNW,0.0613474401227007,0.037876508728766,0.0472726464654308,-0.0781186457879874,333,734,922,1989
800,HEI,0.0183419869687389,0.0957681040277218,0.0012438680842584,0.0181467946624952,780,460,750,1990
801,FR,0.0394261421826169,0.0673047374409139,0.0242981735022177,-0.0252240887387636,526,592,872,1990
802,ELP,0.0193898518170983,0.0741131930044353,0.0064412599987816,0.0283299606095637,769,559,669,1997
803,H,0.0156598420541499,0.0434359805510534,0.0033455117115683,0.0426374790474355,799,705,496,2000
804,FRT,0.0282821797152344,0.0499429760248649,0.0428668027961007,0.0292040939220416,673,668,659,2000
805,AEP,0.0521372324093447,0.0417882877166264,0.0415662261371362,-0.0588949317506583,392,712,902,2006
806,KNX,0.0232761004455558,0.0308170456724462,0.009770218971821,0.0410205777217976,732,759,516,2007
807,ASH,0.0411176611904717,0.0313696881269378,0.017555855339752,0.0168628610500249,501,754,758,2013
808,POR,0.0538126955666646,0.0458597464342313,0.0422476864317235,-0.2213873177260152,376,689,950,2015
809,ZBRA,0.0209421753912467,0.1051156271899089,0.0,-0.0064383039209576,756,417,848,2021
810,LXP,0.0082879535781957,0.000735113399007,0.0527681080770412,0.0665137535853282,839,872,311,2022
811,IDA,0.052380475053638,0.0399749191580243,0.0327975833865397,-0.0690083855767047,388,727,911,2026
812,HXL,0.0169411387586649,0.0827249673403519,0.0067636334495331,0.0238650478823576,793,523,710,2026
813,UNF,0.0318993970665034,0.0580189912391553,0.0067999370639671,0.0134678753496336,624,627,777,2028
814,SPGI,0.0186928091510882,0.073810223266745,0.0081647570816063,0.0253911844028681,776,561,693,2030
815,EFX,0.0177974440677052,0.0909852840853717,0.0062599482343404,0.0168248348008473,787,485,759,2031
816,RBA,0.0186902403695154,0.0655125989576479,0.0297233652808964,0.0291712565532669,777,598,660,2035
817,TEVA,-0.0478499207351939,0.0138639856557377,0.0,0.0720744781020273,921,829,287,2037
818,NWSA,0.0130497080018357,0.0171181899374813,0.0152392563242913,0.0519360862086481,819,815,403,2037
819,NWS,0.0130497080018357,0.0171181899374813,0.0152392563242913,0.0519360862086481,819,815,403,2037
820,TD,0.0763845250825487,0.0084104796385001,0.0412669132448383,-0.4756923874228175,237,849,958,2044
821,PLD,0.0235347757777965,0.0345438189175843,0.0248377910775971,0.0360128580218881,729,744,571,2044
822,RNG,-0.0512807398925674,-0.1359703497573468,0.3538507602608651,0.1069931486647393,922,956,167,2045
823,BSX,0.018828688893857,0.0775750753236433,0.000330949961725,0.0201288494577769,775,544,739,2058
824,EIX,0.0511196734444741,0.0359075997813012,0.0443255164195155,-0.0743724033694659,404,740,916,2060
825,KRG,0.0094726543535695,0.0194163006378786,0.0419897571166501,0.0502710005243225,834,806,420,2060
826,SUI,-0.0120392581351116,0.0350445415342714,0.0287926836122851,0.0488278948160477,886,743,432,2061
827,X,0.0720422587815891,-0.0161182815245712,0.0,-0.0383152124916608,261,921,882,2064
828,D,0.0507179102389642,0.0398197644164813,0.0567969375945873,-0.0931693606847172,407,729,929,2065
829,BX,0.0140635584886214,0.0885100958466386,0.0431594055850114,0.017870298694526,812,502,753,2067
830,PVH,0.0349596367965877,0.0651386543418362,0.0017619377826623,-0.0437693257098995,584,602,888,2074
831,NMR,0.0587556816669075,0.0286704408552741,0.0362605117540411,-0.725637671171668,350,767,960,2077
832,PCG,0.0585242245151127,0.0246438588721582,0.0,-0.1288518719709952,352,789,941,2082
833,DNB,-0.0093313203358818,0.0266015938716253,0.0170941847004134,0.0501905910832115,884,777,422,2083
834,AWK,0.0370572900207936,0.0534337584822538,0.020883981240532,-0.0337598192986044,556,648,880,2084
835,PHG,-0.0230354181879837,-0.0054448179536953,9.88644557424194e-05,0.0737528839838448,899,912,275,2086
836,TRNO,0.029058154573574,0.0400219041695212,0.0260642189870998,0.0242933746767405,660,726,704,2090
837,AMT,0.0147078461482498,0.0583021285066087,0.0292441519888311,0.028996261370813,806,625,662,2093
838,XYL,0.0244077759759575,0.0528510821888257,0.0119834565136474,0.0226844026311855,723,652,719,2094
839,VTR,-0.0020459738089705,0.0282508745107125,0.0361306900457608,0.0466953212123852,871,769,458,2098
840,CHT,0.0039660225038009,0.1025557491545403,0.0039186243085842,0.0046076680755042,855,434,817,2106
841,CTVA,0.0215452499495225,0.0288765458618467,0.0128685234392386,0.0344137733887612,751,766,594,2111
842,NEP,0.071798951448113,-0.0013435700575815,0.2660151151152589,-0.1931391793954241,263,903,947,2113
843,NOW,0.0119175491003792,0.0760327279984035,0.0,0.01861643718511,825,549,746,2120
844,BDX,0.0199039717165227,0.0457530505645982,0.0149413911672549,0.0283671834100037,763,690,667,2120
845,PANW,0.0051390051213335,0.057262404636584,0.003024731692975,0.0307522180469704,851,632,642,2125
846,MMM,-0.1155198804181796,-0.2587081597369838,0.0546799605524793,0.0836466324972237,940,961,225,2126
847,PPL,0.0369920492988442,0.0454089592155114,0.0351924360897112,-0.0315932096714453,557,692,879,2128
848,RBC,0.0246377992215894,0.0390251306749446,0.003384556701706,0.0263965863285895,718,731,686,2135
849,MS,0.0592027467676942,0.0119493152438243,0.0375465422716211,-0.2407200492541835,348,836,951,2135
850,DV,0.011579452597249,0.07582886464178,0.0011179892945039,0.0166454023482577,826,550,762,2138
851,KRC,0.045470522968154,-0.0001944471204649,0.0547233365926262,0.0125908878814103,459,897,782,2138
852,BFAM,0.0136457908238167,0.047610712839837,0.0004765354380088,0.0303570723472323,815,684,645,2144
853,NCR,0.0181516095032146,0.0556124189696349,0.0048404292008572,0.0211768777537504,783,637,732,2152
854,WD,0.0295774246774859,0.0523887121335899,0.0233727693577428,-0.0046061734510361,656,654,842,2152
855,PFSI,0.0310419587664822,0.0737017876041036,0.0088939623868738,-0.347292643278733,635,563,955,2153
856,WRK,-0.1796448069035286,-0.0671053040494044,0.0306452905894254,0.0747121944053608,952,941,268,2161
857,IFF,-0.1242290172830895,0.0305290227773695,0.0400051338307337,0.0453326940261098,943,760,470,2173
858,EL,0.0141942955242733,0.0878602620087336,0.0130514148707284,-0.0219828155336162,810,505,868,2183
859,GLW,0.0222124095111931,0.0368057565857491,0.0378107969132014,0.0235122751280272,745,736,713,2194
860,CAE,0.0228560429592614,0.0578768712300666,0.0,-0.0017344729502088,735,628,837,2200
861,TYL,0.0092782502900359,0.0594573564320743,0.0,0.0183100595514484,835,621,748,2204
862,SCHW,0.040222968767861,0.0189735315349582,0.0180673923259624,-0.0386750155589143,516,807,883,2206
863,GMED,0.0201146485693926,0.0283658901991931,0.0,0.0270477876333929,762,768,679,2209
864,MRK,0.0013144913779089,0.0368234524147639,0.0268120227631012,0.0329271086800583,858,735,617,2210
865,XRAY,-0.0174948443223928,0.0496215306980656,0.0153742571317997,0.0302183674659513,892,671,648,2211
866,SWX,0.0336478604416024,0.048066533602342,0.0389295547636495,-0.081017199246059,606,681,924,2211
867,FAF,0.0322566630541584,0.0176799567021468,0.0322269059849203,0.0135245879687407,622,814,776,2212
868,PUK,0.0265477497722958,0.0101144415510862,0.0126088510942567,0.0277713935493756,698,844,674,2216
869,DIS,0.0158709290291697,0.0194336161430864,0.0,0.0330161170160765,797,805,615,2217
870,CUZ,0.0224574180549758,0.0265204533069329,0.0526084433319485,0.0240490868490558,741,778,706,2225
871,AR,0.0343736117026617,0.0291827423359474,0.0177073222812858,-0.0207291051715099,596,764,866,2226
872,MAC,-0.0824031195304747,0.0255885264539705,0.0478937219638017,0.040890817335395,932,783,518,2233
873,GOL,-0.0683485059782147,-0.1036552142495524,0.0,0.057404239282772,928,952,356,2236
874,TM,0.0095094128060976,0.0728859247173391,0.0028240572355699,-0.0029124123107057,832,568,839,2239
875,DNP,-0.0569175431627175,-0.0490478467113992,0.0854965200734807,0.0533158238834794,924,934,384,2242
876,XPO,0.0186015566255004,0.0742121314808539,0.0,-0.0837562152820153,779,558,925,2262
877,AMRC,0.0378314002196365,0.030095597739221,0.0,-0.3765323473308908,548,761,956,2265
878,PFE,0.0128922657417819,0.023698008471968,0.0562599251129107,0.029161222133252,821,790,661,2272
879,AJG,0.0196588608721226,-0.0965057831454277,0.0096033383280425,0.0372717402465689,765,949,559,2273
880,NCLH,0.0195377654749285,0.0691906499109689,0.0407804325442435,-0.0875492422906439,767,585,927,2279
881,STX,-0.0413052457662123,-0.0688960515713134,0.0454435785178366,0.048879175519185,914,943,431,2288
882,EQIX,0.0128005279224489,0.0501157842213198,0.0181494790989228,0.0074242105719024,822,667,805,2294
883,HR,-0.0431335793195082,0.0041247054669117,0.0723307190110051,0.0411697038506615,917,864,514,2295
884,FLR,0.014126457322781,0.0385826771653543,0.0049357501489234,0.0180410177857203,811,732,752,2295
885,REXR,0.0208886246801765,0.0279356645856667,0.0276144852031638,0.0141281861535087,757,771,774,2302
886,WDAY,0.0178847773658525,0.0160568570676493,0.0,0.0247485948922115,786,821,700,2307
887,WELL,0.0072714297908798,0.0260276064798662,0.0269519733453921,0.0266983988709237,844,780,684,2308
888,IRM,0.0089557140344464,0.0604935917132433,0.0358575640626018,-0.0112547980850189,837,619,853,2309
889,LAZ,-0.02580537312163,-0.0456881261990455,0.055884895369388,0.044031453167971,901,933,480,2314
890,NGG,0.0134513262507305,0.0483923079684564,0.0079647314977612,0.0028399447095315,816,679,822,2317
891,CCJ,0.0145258203937047,0.0281251368646578,0.0020964292353372,0.0198740718617995,807,770,740,2317
892,ORA,0.0276212354617877,0.0367249399359959,0.0063085277368814,-0.0686055721947452,684,737,910,2331
893,CALX,0.010172873987283,0.0339223280117418,0.0040511107390789,0.0133196136271344,829,747,778,2354
894,STE,0.0055817310912436,0.0269262183364549,0.0095696205903114,0.0205985329623213,849,775,737,2361
895,CDAY,0.0051510924451897,0.0362078346028291,0.0,0.009879193722435,850,739,790,2379
896,MC,-0.0064239904317538,-0.0697955187789935,0.0473752389103868,0.0368734449976828,879,944,563,2386
897,BIO,-0.0675754567002412,0.0325906222776293,10.613707927444835,0.0231424234859581,927,749,716,2392
898,ARES,0.0203736241220829,0.0226511686126152,0.0442699781994044,-0.0129049074386288,760,797,854,2411
899,PNM,0.0246095059223709,0.0336142995141237,0.0352947212991421,-0.1461430715212756,720,748,943,2411
900,HUN,0.0226555844221098,0.0138248847926267,0.0379088491815501,-0.0047105670580624,740,830,843,2413
901,EBR,0.0283876119633257,0.0233059894468731,0.0159523443067891,-0.2606734065862819,670,794,952,2416
902,AUY,-0.261708570233604,0.053687562856185,0.0214933367842704,0.004369936710938,959,647,818,2424
903,LUV,0.025157981301939,0.0092443564029548,0.023156163434903,-0.0210461391966759,714,847,867,2428
904,LUMN,-0.0057241696303474,0.0403490355596378,6.114378125249735e-06,-0.0005225014034304,877,721,835,2433
905,DLR,0.0228119136612206,0.0185111211244498,0.0365592436616716,-0.0454589476444681,738,808,889,2435
906,AAP,0.0081737250083031,0.0148668486575421,0.0575316437922583,0.0123599586774287,840,826,784,2450
907,PENN,-0.1238110976182282,0.0249481961274032,0.0013391812599522,0.0186980024974467,941,786,745,2472
908,BA,-0.0140714999892215,-0.0187689692849338,0.0,0.0280733390874073,889,924,670,2483
909,ARE,0.0047834560764205,0.0312920284754312,0.0391155617674149,-0.0395895734223406,852,755,884,2491
910,AIZ,7.090117314428163e-08,0.0205824595798935,1.680661271575734e-08,1.0324535034052902e-07,865,802,831,2498
911,OFC,-0.0270521412504934,-0.0176264729723225,4.197612738102126e-07,0.0267737732478613,904,922,682,2508
912,ES,-0.0204967372240355,0.0486968480834752,0.0429416470522568,-0.1247067766096819,896,677,938,2511
913,TV,-0.0006666681679111,0.0185028400854827,6.691217022963452e-05,-0.0005872404387374,867,809,836,2512
914,CWT,0.0175725248917078,0.0145055138561775,0.0199844267979207,-0.0561693871295308,789,828,899,2516
915,HBAN,0.000104481492807,0.0125246360226333,5.537358460405107e-05,0.0001347923718069,862,835,829,2526
916,AMD,0.0035651479651208,0.0065527158637819,0.0,0.0046797785350122,857,855,816,2528
917,CVT,-0.0384403731892883,-0.0406671794855289,0.0,0.0253686527880201,913,930,695,2538
918,AIG,7.41433617477811e-08,0.0074647263767781,2.088144088751672e-08,7.19453153385688e-08,864,853,832,2549
919,BCH,0.0006048909645886,0.0004545606742428,0.0004216654731535,-5.491779247008024e-05,859,874,833,2566
920,MBLY,-0.000773140088976,-0.0021310946076848,0.0,0.0084759061606259,869,905,797,2571
921,FL,-0.1244028662420382,0.0398063474986551,0.0425985572283343,-0.0569237357652962,944,730,900,2574
922,ENV,-0.088523550288856,0.0066775287464394,0.0,0.0091095559094166,935,854,793,2582
923,NEM,-0.0724238192489928,0.0131291912418195,0.0406504181821994,0.0027866364407585,929,832,823,2584
924,UGI,-0.3112606304208982,-0.1100022853660394,0.0638270800064158,0.0275616936391341,961,953,675,2589
925,RKT,-0.0005409724938856,-0.0022519476254158,0.0,0.0017432536990349,866,906,826,2598
926,NRG,-0.0171366520750619,0.0232192526303059,0.0323221011910821,-0.0715158301944416,891,796,912,2599
927,TTM,-0.0764647887017587,0.012611158036458,1.0411038202837614e-05,-0.0060260858314058,931,834,847,2612
928,ILMN,-0.0527729191742515,-0.0081957616204191,0.0,0.0127727737191771,923,913,781,2617
929,HUBS,-0.006088460922513,-0.098364887513622,0.0,0.0086586724360288,878,951,795,2624
930,INTC,0.0079800428059134,0.0005687412471945,0.0145899184041804,-0.0674641984758071,842,873,909,2624
931,MXL,-0.0381233945985341,-0.044539975388287,0.0,0.0122807708713311,911,932,786,2629
932,SNOW,-0.0130293827845126,-0.1970189104345782,0.0,0.0123212650018531,888,958,785,2631
933,WK,-0.0232169748876075,-0.1287202462007734,0.0,0.0124739012068168,900,955,783,2638
934,AES,0.0181672260323945,-0.0053895289152503,0.0323945717204144,-0.3421859039836568,781,911,954,2646
935,BEP,-0.0067469334493962,0.0138000076668452,0.1335892841531657,-0.1273821053532194,880,831,940,2651
936,GWRE,-0.0160475527561572,-0.0903466461021124,0.0,0.0030082257046274,890,945,820,2655
937,MPW,-0.1899192022625824,0.0049744545443641,0.2094072562896341,-0.0080198089280522,956,862,849,2667
938,MANU,-0.009099910070897,-0.0141326854377719,0.0,-0.0241180300145991,883,917,871,2671
939,TSN,-0.0362548717483911,-0.0132764183920408,0.0374857470237995,-0.0104624398409709,910,916,850,2676
940,NEWR,-0.0351284643148866,-0.4301764196358282,0.0,0.0066352914695669,908,964,808,2680
941,GME,-0.0451358458271879,-0.1740968269176576,0.0,0.0075394593955986,920,957,804,2681
942,GPS,-0.0416976302534885,-0.0084870848708487,0.0454132606721162,-0.0161010651473866,915,914,859,2688
943,LNC,-0.1644394633722437,0.0235447016865139,0.0846250961769392,-0.4535205412686614,950,791,957,2698
944,TAL,-0.0289365494286478,-0.0230250611028225,0.0,-0.0229672290262006,905,925,870,2700
945,WBA,-0.1409766348620937,-0.0954600307935583,0.0759351419598095,0.0064538004920633,948,948,809,2705
946,CTLT,-0.0295610690913539,-0.0147708894878706,0.0,-0.0410287252043791,907,919,887,2713
947,HCP,-0.0450005540457791,-0.2032281139230895,0.0041463157607791,-0.0045879002774241,919,959,841,2719
948,HL,-0.0290976124270932,-0.0156550712001917,0.005393608324587,-0.0509353243854653,906,920,894,2720
949,TTWO,-0.0589586848863523,-0.0944340368843928,0.0056667856639234,-0.0106468470707016,925,946,851,2722
950,S,-0.0428511019461759,-0.2146949761456444,0.0,-0.0110247397273868,916,960,852,2728
951,W,-0.1049219483067474,-0.56855151045701,0.0,-0.0002843413233245,937,965,834,2736
952,RIG,-0.1956200787401575,-0.0045076099061356,0.0,-0.0539288057742782,957,910,897,2764
953,KMPR,-0.0873488848401894,-0.0638979400231954,0.0257135085472222,-0.0603513059535303,934,938,904,2776
954,TEO,-0.2842120131096284,-0.0648327914552615,0.048732909754608,-0.0302826449852364,960,939,877,2776
955,AA,-0.1073800747853034,-0.031901509705248,0.0118761373034436,-0.0725763946321559,938,929,913,2780
956,MU,-0.0763038034692394,-0.0965724755837213,0.0065930253640488,-0.0800189209362828,930,950,923,2803
957,SPR,-0.1818907427589065,-0.0267267140872932,0.0,-0.1103387855295021,953,927,936,2816
958,WDC,-0.1414389632009975,-0.0676493814161621,0.006632542236858,-0.1007317352222813,949,942,934,2825
959,BAK,-0.1342455948756865,-0.0623522238910285,0.0002052236654574,-0.1990962731602505,947,937,949,2833
960,MRNA,-0.1240856122285133,-0.275063266497956,0.0071071521641278,-0.1006846556584776,942,962,933,2837
961,CEA,-0.3354717798420933,-0.0523955268384762,0.0,-0.1291733027621429,962,935,942,2839
962,NIO,-0.1311552398230476,-0.3102574590020672,0.0,-0.0984666692862306,945,963,932,2840
963,KEP,-0.8010410416763826,-0.0253157364889634,0.0075282974070141,-2.0603174193197447,963,926,963,2852
964,LPL,-1.1253666198746497,-0.1147541837967621,0.0,-1.0083417336205311,965,954,962,2881
