,ticker,eps,roce,divYield,eps_rank,roce_rank,overall_rank
0,PBF,0.57541184,0.497484548,0.014721326,6,21,27
1,SWN,0.284601461,0.778613023,0.0,27,3,30
2,DQ,0.634915201,0.44335949,0.0,4,33,37
3,LPX,0.23518711,0.620655412,0.014942827,40,10,50
4,ERF,0.221426368,0.89771845,0.010073994,52,2,54
5,PBR,0.527250274,0.366559486,0.542769914,8,52,60
6,APA,0.232549736,0.390675398,0.014066549,41,44,85
7,RRC,0.196368659,0.523872006,0.006411598,71,17,88
8,ICL,0.229432082,0.384514436,0.123908202,45,47,92
9,SQM,0.171288828,0.712109629,0.098151339,90,5,95
10,MLI,0.197288137,0.463094424,0.016718587,70,26,96
11,VLO,0.230055259,0.360515613,0.031171609,43,56,99
12,NUE,0.219991823,0.373606235,0.015430527,54,49,103
13,CHK,0.415826671,0.296145409,0.102103307,12,93,105
14,SM,0.260930618,0.308645801,0.004608018,29,78,107
15,CF,0.193174129,0.438139308,0.017666253,74,34,108
16,BTU,0.34549882,0.294452377,0.0,16,95,111
17,CIVI,0.251683068,0.301313526,0.108273649,32,88,120
18,CVI,0.204465865,0.359328358,0.153349399,64,58,122
19,AMG,1.735059935,0.265616079,0.001999925,1,121,122
20,E,0.297022318,0.285394955,0.064358044,22,102,124
21,AR,0.199446755,0.359487423,0.013144486,68,57,125
22,AN,0.228008985,0.304253081,0.0,46,82,128
23,PHM,0.244608944,0.293601429,0.013468685,36,96,132
24,MPC,0.241730877,0.282611184,0.021298828,37,105,142
25,MTDR,0.17958165,0.353364137,0.0052129,82,62,144
26,MTH,0.293271421,0.252802701,0.0,24,130,154
27,GGB,0.219691652,0.287836111,0.113286399,55,99,154
28,EC,0.32024605,0.241922689,0.128046653,18,140,158
29,DVN,0.148785055,0.391249515,0.083581829,116,43,159
30,WSM,0.127925495,0.495089978,0.024651005,138,22,160
31,CPG,0.289509786,0.239178408,0.039150373,25,142,167
32,CRC,0.146868396,0.361210543,0.016536709,117,55,172
33,CTRA,0.207846313,0.274721797,0.101852363,61,116,177
34,VALE,0.238719147,0.23571634,0.083897303,39,149,188
35,GPI,0.27054777,0.227559892,0.008532245,28,160,188
36,MRNA,0.118156944,0.449964175,0.0,159,29,188
37,X,0.407952204,0.213497645,0.0,13,178,191
38,PXD,0.143121415,0.322983706,0.114369427,121,71,192
39,DDS,0.114003828,0.450823966,0.03468959,166,27,193
40,NVR,0.113847204,0.449262032,0.301158389,167,30,197
41,EQT,0.141465298,0.319187393,0.016265955,123,75,198
42,FANG,0.181637437,0.26570857,0.065101243,80,120,200
43,OLN,0.172976009,0.274418461,0.015147948,89,117,206
44,BAM,0.168598192,0.267837864,0.280322007,97,119,216
45,COP,0.119548257,0.346916599,0.036645253,155,64,219
46,OXY,0.214324875,0.225297601,0.020294358,57,163,220
47,HRB,0.11245636,0.367564482,0.036136532,169,51,220
48,UMC,0.176627857,0.245690075,0.07584877,86,135,221
49,ARW,0.210451463,0.220672832,0.0,58,166,224
50,MOS,0.23174962,0.209996527,0.012788015,42,189,231
51,PSX,0.22464305,0.210476772,0.0365371,48,186,234
52,EOG,0.1031081,0.400747392,0.018684107,199,40,239
53,STM,0.134202824,0.277801605,0.006581309,129,113,242
54,KBH,0.299521729,0.188530021,0.019237379,21,229,250
55,TMHC,0.301687504,0.186697536,0.0,20,235,255
56,HPQ,0.124926491,0.276126558,0.039664065,148,115,263
57,ABG,0.249494968,0.182112192,0.0,33,238,271
58,LEN,0.181264237,0.205092492,0.017208165,81,193,274
59,TX,0.294627118,0.176731184,0.08835083,23,253,276
60,RHI,0.07905037,0.607008807,0.022743116,272,11,283
61,MTG,0.217642507,0.18824356,0.027904098,56,230,286
62,EXPD,0.080129815,0.51588673,0.012620957,270,19,289
63,CHRW,0.081692141,0.481352823,0.024782097,265,24,289
64,ESNT,0.199454652,0.192662973,0.022102955,67,223,290
65,MUSA,0.102406574,0.296237381,0.004550389,200,92,292
66,DHI,0.129610713,0.227387682,0.009318578,134,161,295
67,XOM,0.120217588,0.238609169,0.03221978,153,143,296
68,CVE,0.125792754,0.22930948,0.018079052,143,156,299
69,CNQ,0.128184488,0.218695826,0.057734003,137,169,306
70,PFE,0.109175473,0.258144814,0.031261101,181,125,306
71,AB,0.078386735,0.448232405,0.103220662,276,31,307
72,TOL,0.255740257,0.161328824,0.017672417,31,284,315
73,PII,0.100746331,0.278441145,0.025044663,205,112,317
74,MAS,0.078287543,0.393268648,0.0239315,277,42,319
75,SU,0.152349591,0.200727536,0.043571614,112,208,320
76,OC,0.150607162,0.198196115,0.016504894,113,211,324
77,TNET,0.083110924,0.342955326,0.0,259,66,325
78,LAD,0.22381643,0.164105035,0.008086733,51,277,328
79,RIO,0.107691198,0.234117523,0.101682341,185,153,338
80,MT,0.321056428,0.142372036,0.011458905,17,322,339
81,TKC,0.141399408,0.19639523,0.015966699,124,215,339
82,VSH,0.138633643,0.196052424,0.018488473,127,217,344
83,DKS,0.106393402,0.230369484,0.016633219,189,155,344
84,BBWI,0.078240757,0.334386391,0.018190976,278,67,345
85,ACT,0.179281897,0.171922223,0.063848825,83,265,348
86,TSM,0.085659946,0.278886788,0.024035827,244,109,353
87,DE,0.097459234,0.245497675,0.013680339,216,137,353
88,CVX,0.105660298,0.224562754,0.032772121,192,165,357
89,TS,0.123026868,0.200739096,0.025597286,150,207,357
90,GIL,0.107339642,0.215606989,0.024532482,188,172,360
91,WLK,0.171237973,0.167104975,0.012879047,91,271,362
92,NNI,0.11936995,0.20070473,0.010727697,156,209,365
93,BC,0.120724188,0.196175022,0.0193658,152,216,368
94,IBP,0.090919782,0.238071476,0.025502773,227,145,372
95,MUR,0.14450178,0.175303827,0.019198934,119,257,376
96,LYB,0.14297916,0.172301976,0.119554444,122,262,384
97,CBT,0.116287022,0.18907261,0.022996085,161,226,387
98,PAG,0.161399842,0.158251343,0.018022982,101,290,391
99,ASX,0.149395839,0.16537715,0.072852326,115,276,391
100,OGN,0.129218442,0.17505626,0.040865156,135,258,393
101,M,0.185644462,0.144106622,0.027286739,79,316,395
102,LII,0.058204948,0.675172343,0.01662664,395,8,403
103,MCK,0.07086177,0.305019843,0.005812258,324,81,405
104,WSO,0.067777509,0.322105813,0.037481148,335,73,408
105,EVR,0.109066182,0.187649473,0.029126658,182,232,414
106,AVT,0.165999028,0.144243023,0.022897257,99,315,414
107,TEX,0.100897585,0.198159943,0.01197318,204,212,416
108,MO,0.06916466,0.301079822,0.079184176,327,89,416
109,WMS,0.07315415,0.285177592,0.005714577,313,103,416
110,SSD,0.087761075,0.212270103,0.011533922,237,182,419
111,UPS,0.076619262,0.247131209,0.033930629,289,133,422
112,POOL,0.062819301,0.354976238,0.01264205,363,60,423
113,BBY,0.074105161,0.263042204,0.041204349,300,123,423
114,HCA,0.084781035,0.213889411,0.009810742,250,177,427
115,AGCO,0.085982645,0.210349585,0.03907687,242,187,429
116,TPR,0.092509132,0.201087423,0.027999826,225,205,430
117,RDY,0.058081102,0.406030447,0.006415943,396,39,435
118,AZO,0.055676954,0.464808105,0.051884468,411,25,436
119,CIG,0.170873178,0.133895352,0.087399209,93,344,437
120,TXN,0.057371222,0.418627694,0.028177408,400,38,438
121,YPF,0.449540933,0.106703528,0.0,11,430,441
122,AMAT,0.061669095,0.327696194,0.008770036,374,70,444
123,CRI,0.086322265,0.198439265,0.040776929,240,210,450
124,BYD,0.107684565,0.171393048,0.008111496,186,266,452
125,MC,0.059578952,0.331594292,0.069210972,385,68,453
126,NVO,0.052137549,0.621765835,0.023759323,445,9,454
127,GFI,0.077102204,0.21870374,0.0,286,168,454
128,PM,0.05767631,0.356558451,0.049797451,398,59,457
129,HD,0.053261172,0.450717165,0.024253216,431,28,459
130,BG,0.107646841,0.165554072,0.023334626,187,273,460
131,GWW,0.05463897,0.397095733,0.013068144,420,41,461
132,CLF,0.159668177,0.127515454,0.0,102,362,464
133,WES,0.114773024,0.153156161,0.069381824,165,300,465
134,HTZ,0.353003098,0.099860302,0.0,15,451,466
135,DOW,0.126117532,0.139430102,0.055214266,142,330,472
136,EXP,0.085467863,0.18893639,0.0069435,245,227,472
137,ASR,0.073355857,0.224895199,0.03312071,309,164,473
138,WU,0.170788395,0.121103052,0.068307856,94,380,474
139,PSA,0.133953555,0.133464361,0.079594265,130,346,476
140,WY,0.081742599,0.197435897,0.070307331,264,213,477
141,CTSH,0.077301091,0.204619097,0.019038347,282,195,477
142,NRG,0.156620788,0.124845335,0.042586488,107,371,478
143,PAC,0.064507378,0.257797861,0.051362661,352,126,478
144,NEU,0.089538436,0.179098012,0.026990167,231,248,479
145,VIPS,0.098335489,0.167727965,0.0,212,270,482
146,ACI,0.139292045,0.130055132,0.389971709,125,357,482
147,ALSN,0.111848791,0.145072775,0.016851042,170,313,483
148,CSL,0.07569632,0.207646982,0.011010374,294,191,485
149,LRCX,0.053677695,0.35452199,0.010803613,427,61,488
150,HP,0.115019353,0.141782855,0.053377882,164,324,488
151,ALB,0.080431698,0.194255801,0.007261372,269,220,489
152,CNS,0.054311093,0.328986719,0.03408756,423,69,492
153,RLI,0.097962417,0.16324423,0.061262801,213,279,492
154,TPX,0.075895393,0.201444385,0.011741552,291,202,493
155,SEE,0.067550744,0.228604612,0.016283082,337,158,495
156,MRO,0.194791012,0.107916525,0.011864347,73,425,498
157,MMM,0.08511269,0.177055128,0.049635564,247,252,499
158,SNA,0.075002048,0.201159768,0.025757531,297,204,501
159,MSM,0.060367316,0.255308762,0.031080375,379,127,506
160,KLAC,0.0500691,0.386726386,0.002653431,463,45,508
161,NTAP,0.093352961,0.160289718,0.031655007,223,287,510
162,GSK,0.084169995,0.172300193,0.059300421,253,263,516
163,TLK,0.075342368,0.193262827,0.040436641,296,221,517
164,THC,0.191678621,0.102865961,0.0,76,441,517
165,SCCO,0.056514045,0.276516828,0.057955544,405,114,519
166,FRO,0.195707183,0.100992915,0.013824838,72,449,521
167,ULTA,0.047797874,0.44423196,0.0,491,32,523
168,SIG,0.106364355,0.138348238,0.019623899,190,334,524
169,OMC,0.078499572,0.174339105,0.034649526,274,259,533
170,CHH,0.053201375,0.287227754,0.008416226,433,101,534
171,LOW,0.047384842,0.419845435,0.017446338,497,37,534
172,CR,0.07247528,0.190915008,0.01869248,315,224,539
173,TER,0.051701001,0.301975434,0.00503721,454,87,541
174,ADM,0.085451658,0.155920602,0.017700701,246,296,542
175,TROW,0.063207068,0.212115526,0.044929397,359,184,543
176,TGS,0.102107157,0.134174738,0.0,201,343,544
177,GEF,0.095943894,0.14078506,0.028347638,219,328,547
178,UL,0.063595907,0.205271596,0.036025475,356,192,548
179,AIT,0.062036441,0.21477693,0.009562235,372,176,548
180,AVGO,0.059633439,0.214888892,0.036480412,384,173,557
181,CNHI,0.093307777,0.138152181,0.019452533,224,336,560
182,LKQ,0.077635602,0.161871608,0.019189305,281,281,562
183,HOG,0.11591971,0.114251444,0.014568765,163,402,565
184,NXPI,0.067343666,0.190173295,0.01969325,340,225,565
185,SID,0.110373903,0.117742279,0.191283949,178,392,570
186,PCAR,0.087340479,0.138659021,0.029137661,238,332,570
187,CSCO,0.0591592,0.213075713,0.029558494,391,180,571
188,MPLX,0.118908359,0.110660173,0.091864546,158,413,571
189,URI,0.081465894,0.148679731,0.0,266,308,574
190,ODFL,0.043198037,0.42717804,0.004218427,539,36,575
191,FLT,0.068726628,0.179713096,0.0,329,246,575
192,MAN,0.086058401,0.138216984,0.032208588,241,335,576
193,JBL,0.05449009,0.228414326,0.002997621,421,159,580
194,GOOG,0.051741036,0.25287535,0.0,452,128,580
195,GOOGL,0.051741036,0.25287535,0.0,452,128,580
196,EMR,0.239519092,0.075091478,0.021706927,38,544,582
197,CARR,0.101580184,0.120325122,0.014630536,202,382,584
198,BDC,0.080782425,0.14407976,0.00283874,268,317,585
199,PKG,0.084903262,0.137255727,0.034652205,249,338,587
200,RH,0.072342981,0.163261454,0.0,316,278,594
201,ORLY,0.039988479,0.530985798,0.0,579,16,595
202,PAYX,0.041168718,0.428833579,0.031062251,563,35,598
203,ITW,0.043776634,0.345739828,0.022249034,534,65,599
204,ABEV,0.062970357,0.181567807,0.053320468,360,242,602
205,OTIS,0.038096454,0.68313172,0.01413795,595,7,602
206,RDN,0.206817747,0.075092298,0.037702912,62,543,605
207,AYI,0.067450711,0.168284099,0.003275063,338,268,606
208,VZ,0.12838943,0.092461814,0.065263822,136,472,608
209,DPZ,0.036546782,0.720650338,0.012729874,606,4,610
210,NOC,0.057930552,0.19715245,0.012447496,397,214,611
211,ADP,0.037524557,0.545030109,0.020935447,599,14,613
212,NSP,0.041421624,0.364837853,0.017689239,560,53,613
213,DECK,0.043376206,0.317050567,0.0,538,76,614
214,IPG,0.071927744,0.155859983,0.035066692,318,297,615
215,IP,0.111551074,0.102217529,0.049916139,171,445,616
216,INFY,0.041353766,0.362799962,0.023541543,562,54,616
217,EME,0.054915342,0.203846869,0.003676194,419,197,616
218,MMP,0.098573575,0.114032826,0.082747018,211,406,617
219,LAZ,0.107793788,0.104821865,0.054838047,184,433,617
220,QCOM,0.058629768,0.188061431,0.028066407,392,231,623
221,FAST,0.040029882,0.386719166,0.026196757,577,46,623
222,ABC,0.060215119,0.180878951,0.013883448,381,244,625
223,NOK,0.174196563,0.076833836,0.014468562,88,539,627
224,SUN,0.131584167,0.087942478,0.099449929,131,499,630
225,MCHP,0.048526959,0.235139642,0.015078337,482,150,632
226,AAPL,0.035983116,0.551446146,0.005573961,620,13,633
227,INGR,0.075891189,0.134178553,0.02791932,292,342,634
228,TREX,0.039043605,0.38366148,0.0,586,48,634
229,SON,0.078405508,0.127066274,0.03144931,275,363,638
230,ALV,0.063417169,0.161717791,0.033582614,357,282,639
231,HES,0.051195243,0.212196,0.010708857,457,183,640
232,TRQ,0.158565065,0.077785186,0.0,104,536,640
233,DVA,0.110631162,0.093585039,0.0,174,467,641
234,GIB,0.051746783,0.209820956,3.01e-05,451,190,641
235,VRTX,0.044918261,0.274002405,0.0,525,118,643
236,BBD,0.127271583,0.086289367,0.0,140,507,647
237,BBDO,0.127271583,0.086289367,0.0,140,507,647
238,AVY,0.050886532,0.210340342,0.01605705,460,188,648
239,DCI,0.04688545,0.238419145,0.014948984,505,144,649
240,FCX,0.063333212,0.157258425,0.015815041,358,293,651
241,AMCR,0.071532711,0.140370474,0.04934938,322,329,651
242,CMC,0.130458324,0.082554034,0.011370644,132,519,651
243,BHP,0.042691135,0.278798342,0.043837628,542,110,652
244,YUM,0.034831976,0.523080603,0.017061096,635,18,653
245,JHX,0.053131792,0.196044212,0.013448985,436,218,654
246,PBA,0.117529171,0.088178328,0.065311566,160,496,656
247,AMX,0.064265907,0.151317184,0.001278857,353,304,657
248,NFG,0.100049077,0.10103723,0.036945897,209,448,657
249,WTS,0.050884418,0.202937766,0.007991787,461,199,660
250,CRH,0.088954417,0.107275683,0.030391654,233,429,662
251,CSX,0.062955924,0.15270911,0.012875287,361,302,663
252,AON,0.040746219,0.295934828,0.00728679,570,94,664
253,WPP,0.076519957,0.122204027,0.040955606,290,378,668
254,REGN,0.052973707,0.186825361,0.0,437,234,671
255,ITT,0.054259921,0.180360721,0.012995769,426,245,671
256,SWKS,0.062537997,0.152544441,0.025783879,368,303,671
257,WWE,0.038338428,0.306900661,0.006997351,593,80,673
258,CCK,0.073169009,0.128845597,0.010668384,312,361,673
259,MXL,0.047195163,0.214846371,0.0,499,175,674
260,KEYS,0.048653849,0.204703045,0.0,480,194,674
261,GM,0.204362083,0.059671187,0.008167077,65,609,674
262,DAR,0.073205392,0.12651552,0.0,311,366,677
263,MAR,0.048819961,0.201934081,0.006645974,476,201,677
264,SBUX,0.039610992,0.292076696,0.023354591,581,98,679
265,KMB,0.042225184,0.252068447,0.034015945,549,131,680
266,GGG,0.040536492,0.280875319,0.012506917,573,108,681
267,BKNG,0.038056958,0.302125896,0.0,596,86,682
268,SYY,0.047019831,0.212772935,0.026456365,503,181,684
269,DOV,0.055142446,0.169800369,0.014883258,417,267,684
270,FBHS,0.052109017,0.1827966,0.009647319,448,237,685
271,ITUB,0.120016312,0.080460864,0.027096808,154,531,685
272,EPD,0.104851334,0.088945794,0.078208782,193,493,686
273,VRSN,0.030396568,1.529764801,0.0,685,1,686
274,CE,0.170926602,0.06206089,0.026803168,92,596,688
275,TSCO,0.043466311,0.234706429,0.016353206,537,152,689
276,LMT,0.044680923,0.225664315,0.023509711,528,162,690
277,RL,0.066176628,0.132968278,0.025105845,346,348,694
278,HUN,0.08328083,0.103083295,0.030958743,256,440,696
279,V,0.035998435,0.311568078,0.00781741,619,77,696
280,CDW,0.046160506,0.212013098,0.011704764,512,185,697
281,UNP,0.054272258,0.16547915,0.024499294,425,274,699
282,AWI,0.061682098,0.140910602,0.013436909,373,327,700
283,GNRC,0.062880449,0.135569388,4.86e-05,362,339,701
284,PKX,0.150094743,0.064479445,0.058165116,114,589,703
285,WIT,0.056211344,0.153739418,0.016251269,407,298,705
286,WAT,0.0344412,0.349957687,0.0,643,63,706
287,SYF,0.191056043,0.055962915,0.030153407,77,631,708
288,CHTR,0.092303292,0.090307871,0.0,226,484,710
289,FOXA,0.073375458,0.114069491,0.017707233,307,404,711
290,FN,0.052273998,0.16805329,0.0,442,269,711
291,FOX,0.073375458,0.114069491,0.017707233,307,404,711
292,CPB,0.062626914,0.133387556,0.032627309,366,347,713
293,BIIB,0.075724822,0.109025295,0.0,293,421,714
294,MRK,0.05168276,0.173219816,0.024960363,455,260,715
295,MA,0.02950066,0.499490897,0.00565355,697,20,717
296,CAJ,0.083278526,0.094740544,0.040733123,257,462,719
297,CLH,0.066539874,0.124226042,0.0,345,374,719
298,GPC,0.048182823,0.186904157,0.020203484,487,233,720
299,DISH,0.309457842,0.043915079,0.0,19,702,721
300,ALLE,0.049444665,0.178367198,0.015535125,471,250,721
301,TJX,0.036163432,0.281423188,0.013843006,616,106,722
302,ANET,0.036365364,0.27857346,0.0,613,111,724
303,LEG,0.070522103,0.114983404,0.052174519,325,400,725
304,ASGN,0.062436015,0.130256378,0.0,369,356,725
305,TTC,0.040116425,0.230968731,0.011374956,576,154,730
306,FL,0.083261712,0.092266158,0.036518295,258,473,731
307,MOH,0.041494828,0.214874519,0.0,558,174,732
308,BSMX,0.166214373,0.055787405,0.112236764,98,634,732
309,UAA,0.100442163,0.081084409,0.0,206,527,733
310,UA,0.100442163,0.081084409,0.0,206,527,733
311,VRSK,0.034241846,0.303000926,0.007007033,649,85,734
312,CIB,0.203965368,0.049092188,0.069476898,66,670,736
313,ABM,0.077144037,0.099212106,0.017377498,285,452,737
314,EMN,0.071861475,0.10984583,0.034526131,319,418,737
315,RJF,0.081754217,0.092049515,0.0,263,474,737
316,KR,0.062342079,0.125456093,0.018947102,370,368,738
317,DFS,0.146235193,0.057791655,0.023406954,118,621,739
318,JLL,0.084758333,0.089664931,0.0,251,488,739
319,TT,0.045666556,0.19515442,0.016124337,521,219,740
320,OKE,0.058576535,0.131633963,0.056854191,393,351,744
321,APH,0.041905803,0.204409451,0.010516654,553,196,749
322,STR,0.465213494,0.037708111,0.337300116,10,739,749
323,SBS,0.079888804,0.09140602,0.0,271,478,749
324,OGE,0.084117233,0.088312776,0.041610042,255,495,750
325,CAT,0.051450024,0.156788066,0.018723051,456,295,751
326,ARMK,0.103266789,0.072874422,0.01755775,197,555,752
327,KT,0.143786018,0.055812719,0.054302798,120,633,753
328,TRGP,0.07155876,0.104830446,0.022727613,321,432,753
329,NSC,0.056516298,0.132713324,0.020169578,404,349,753
330,CHE,0.032758155,0.300047082,0.002889291,664,90,754
331,RBA,0.049895875,0.158612034,0.017984755,465,289,754
332,MAIN,0.087789165,0.082590289,0.070554429,236,518,754
333,PG,0.040002636,0.213158111,0.024567237,578,179,757
334,MTD,0.026096984,0.484308199,0.0,734,23,757
335,TPL,0.0246581,0.685228829,0.013660392,753,6,759
336,DEO,0.048326536,0.165387225,0.022791385,485,275,760
337,ZBRA,0.034586752,0.258995574,0.0,640,124,764
338,PNR,0.064875112,0.110560137,0.01869763,351,414,765
339,ADBE,0.029628873,0.32032358,0.0,692,74,766
340,PAGP,0.481900752,0.032984473,0.06712633,9,758,767
341,PFSI,0.158151085,0.049898788,0.018166652,105,663,768
342,KOF,0.068529062,0.103201294,0.041270812,332,439,771
343,BCH,0.158099717,0.049682287,0.06055378,106,666,772
344,FIX,0.059478538,0.119894776,0.004855317,389,383,772
345,CMI,0.059904123,0.118338807,0.023811262,383,391,774
346,QSR,0.074646073,0.092001939,0.048907785,299,475,774
347,CL,0.026810839,0.368873383,0.025398952,728,50,778
348,IHG,0.035512911,0.23502994,0.022065355,627,151,778
349,DRI,0.049943968,0.144723691,0.029999951,464,314,778
350,ACN,0.033655725,0.265068547,0.013848098,657,122,779
351,IT,0.029972321,0.297149267,0.0,689,91,780
352,AEL,0.285224769,0.033580254,0.017338592,26,755,781
353,LH,0.065385604,0.103878992,0.009978321,348,436,784
354,SNY,0.059171188,0.116458439,0.036700225,390,395,785
355,JWN,0.083077827,0.080799305,0.040352087,260,529,789
356,BERY,0.081905578,0.077715356,0.017080474,262,537,799
357,IDXX,0.019905971,0.594829652,0.0,788,12,800
358,ROST,0.036847014,0.203505812,0.010510253,604,198,802
359,EW,0.032953263,0.240505633,0.0,663,141,804
360,TSLA,0.032636206,0.245483471,0.0,666,138,804
361,FICO,0.019785872,0.53232339,0.018754818,789,15,804
362,NLY,0.198971286,0.038039739,0.175205789,69,737,806
363,WST,0.033460803,0.236942346,0.003089656,659,147,806
364,THO,0.060178371,0.107641151,0.015430685,382,426,808
365,BWA,0.099589877,0.061216492,0.016985138,210,599,809
366,BSAC,0.125235167,0.049727329,0.073498973,147,664,811
367,DGX,0.052129714,0.126528442,0.016807149,446,365,811
368,MSFT,0.028425442,0.287573865,0.007777999,712,100,812
369,VAC,0.064920304,0.094602717,0.018207111,350,463,813
370,HPE,0.101358352,0.059227127,0.030983121,203,611,814
371,UNH,0.040500935,0.18173045,0.012059697,574,241,815
372,WF,0.372306406,0.021626208,0.077620638,14,802,816
373,HSY,0.034357645,0.218113735,0.01618916,646,170,816
374,ZTS,0.030764316,0.245620003,0.008891673,681,136,817
375,TEL,0.049085178,0.133572961,0.018631808,475,345,820
376,CPA,0.10312339,0.057418073,0.0,198,624,822
377,HII,0.062592781,0.097086159,0.020756155,367,455,822
378,DG,0.047045774,0.143488513,0.009614167,502,320,822
379,MPWR,0.026924629,0.293394264,0.008487306,725,97,822
380,CNI,0.046329723,0.146091414,0.018140829,510,312,822
381,SLB,0.045456131,0.153003182,0.011202208,522,301,823
382,WD,0.084282491,0.06891134,0.031591153,252,573,825
383,AIG,0.208692122,0.030272533,0.020532088,60,765,825
384,FMC,0.046846139,0.143711763,0.017014721,506,319,825
385,ROK,0.042312598,0.161385006,0.016541987,547,283,830
386,JNJ,0.038687495,0.181773272,0.025190754,590,240,830
387,ABBV,0.041354061,0.165804863,0.035089459,561,272,833
388,MSCI,0.023177814,0.322294481,0.009928351,763,72,835
389,HAL,0.044191564,0.151144612,0.012228582,531,306,837
390,JBHT,0.053588771,0.111276443,0.009217027,428,410,838
391,SAN,0.206335158,0.027787158,0.039698841,63,776,839
392,HUM,0.042571458,0.153379449,0.00594726,544,299,843
393,CPRT,0.029366562,0.23803728,0.0,699,146,845
394,SHG,0.245027262,0.020593394,0.081334641,35,811,846
395,COF,0.1873937,0.029387186,0.029993176,78,769,847
396,HMC,0.116160287,0.046468057,0.035665891,162,685,847
397,ORAN,0.087240725,0.0596924,0.075654702,239,608,847
398,BIP,0.100371341,0.055548675,0.103510227,208,640,848
399,CTAS,0.028089001,0.246390317,0.009375093,715,134,849
400,ABB,0.042787838,0.147530837,0.02935505,541,309,850
401,UHS,0.065582951,0.086664509,0.005673782,347,504,851
402,BXMT,0.068832676,0.08181218,0.116654169,328,523,851
403,PFG,0.224618685,0.021310318,0.029984326,49,803,852
404,XPO,0.048062481,0.126837463,0.0,489,364,853
405,HI,0.192906904,0.026804802,0.020756878,75,780,855
406,SAIC,0.052122932,0.113425402,0.014420678,447,409,856
407,FTNT,0.021489318,0.307848616,0.0,778,79,857
408,AAP,0.05331103,0.107421933,0.035715815,430,427,857
409,WAL,0.17716414,0.028268226,0.027848936,85,774,859
410,GIS,0.051805199,0.111097173,0.025721854,450,411,861
411,MPW,0.135346589,0.038681939,0.104747002,128,735,863
412,HSIC,0.049505637,0.11702961,0.0,470,394,864
413,MKTX,0.02394614,0.280877047,0.010138524,758,107,865
414,ROL,0.020490652,0.303018467,0.011763979,784,84,868
415,GILD,0.042620433,0.141140679,0.03442491,543,326,869
416,LYG,0.174427459,0.026202722,0.047129603,87,782,869
417,IVZ,0.11058434,0.045300312,0.068654294,176,693,869
418,UNM,0.159634532,0.029716534,0.030877414,103,768,871
419,BAP,0.112741787,0.043480462,0.029113741,168,704,872
420,GD,0.048727869,0.116184748,0.01967801,477,397,874
421,TEF,0.104782096,0.046867417,0.07278995,194,680,874
422,BMO,0.162582083,0.02816034,0.03116647,100,775,875
423,MFG,0.583531265,0.011936418,0.220015784,5,871,876
424,DLTR,0.048130978,0.118971745,0.0,488,388,876
425,PEP,0.035738524,0.176019082,0.024756248,622,254,876
426,G,0.041423693,0.144068859,0.010764529,559,318,877
427,HLT,0.036116147,0.172487644,0.00353967,617,261,878
428,A,0.040801848,0.147379913,0.00871975,569,310,879
429,MSI,0.031575466,0.201235764,0.012278061,676,203,879
430,LDOS,0.047533035,0.119245945,0.013808867,494,386,880
431,MCD,0.031827528,0.200949961,0.021475621,674,206,880
432,SMFG,0.553914841,0.01186363,0.207311999,7,873,880
433,MMC,0.036936333,0.162849098,0.013781491,603,280,883
434,JKHY,0.030049579,0.202471929,0.012067253,686,200,886
435,RKT,0.829262414,0.008248278,0.0,3,885,888
436,STWD,0.168607637,0.023325668,0.114431472,95,793,888
437,PAA,0.125792114,0.035452934,0.094859627,144,746,890
438,K,0.042052672,0.134601136,0.034912479,551,341,892
439,COST,0.026046546,0.229137839,0.005178676,735,157,892
440,TXT,0.057145219,0.088964588,0.001128303,401,492,893
441,CDNS,0.019486909,0.283341184,0.0,792,104,896
442,DB,0.245612064,0.012821305,0.018048597,34,866,900
443,FDX,0.071739587,0.066778145,0.021258181,320,582,902
444,NJR,0.067150525,0.0710186,0.038296174,342,563,905
445,BMY,0.040843505,0.137835313,0.029914462,568,337,905
446,BCE,0.052882148,0.093536122,0.063576585,440,468,908
447,FCN,0.044017619,0.122932171,0.0,532,376,908
448,SHW,0.032991383,0.179122603,0.010101069,661,247,908
449,HDB,1.329161067,-0.00066128,0.231774465,2,908,910
450,BCO,0.067152585,0.069463971,0.014800335,341,569,910
451,SXT,0.046124815,0.115095343,0.022561994,513,399,912
452,HBAN,0.156070211,0.020967054,0.070433831,109,808,917
453,C,0.168598841,0.019226104,0.056820478,96,821,917
454,SPG,0.055419524,0.086644463,0.06715177,412,505,917
455,VMI,0.035599015,0.157373239,0.006501149,626,292,918
456,FSS,0.042825105,0.119660664,0.007754047,540,384,924
457,BCS,0.225194144,0.010233871,0.075140691,47,877,924
458,CACI,0.048662906,0.101215712,0.0,479,447,926
459,ENS,0.049583891,0.096041063,0.00804878,467,459,926
460,NKE,0.031043081,0.178815208,0.012319266,678,249,927
461,VIV,0.063768569,0.068054245,0.089123714,355,576,931
462,SNV,0.138850116,0.021023274,0.042010522,126,805,931
463,NYCB,0.156287975,0.018880216,0.084155064,108,825,933
464,AMGN,0.046369322,0.107921673,0.029695616,509,424,933
465,FFIV,0.040911414,0.125165274,0.0,566,370,936
466,ALLY,0.220134167,0.006970484,0.063445904,53,887,940
467,IGT,0.060733287,0.070999647,0.035172875,377,564,941
468,MNST,0.022282257,0.217349252,0.0,770,171,941
469,CLX,0.007580539,0.30387289,0.029660766,859,83,942
470,NI,0.07203466,0.057338026,0.039112464,317,626,943
471,HON,0.033472659,0.16045067,0.018327056,658,286,944
472,BBVA,0.178183649,0.013953756,0.060643501,84,860,944
473,LNC,0.258460596,-0.00758096,0.059000578,30,915,945
474,PAYC,0.015653909,0.248236616,0.0,814,132,946
475,KNX,0.090700938,0.040993138,0.009207852,228,718,946
476,KO,0.034659857,0.149358562,0.027663956,639,307,946
477,RMD,0.027989492,0.188859995,0.008054109,718,228,946
478,ABT,0.035651958,0.141851431,0.017016058,625,323,948
479,CI,0.059546173,0.071363131,0.012359314,387,561,948
480,SNX,0.066858885,0.06077754,0.011799599,344,605,949
481,NEP,0.208795331,0.005752946,0.118460152,59,890,949
482,AFL,0.096740296,0.039059505,0.021437019,217,732,949
483,DHR,0.042252771,0.114374482,0.004794391,548,401,949
484,FNF,0.109806196,0.028954207,0.047266928,179,771,950
485,SKX,0.057137932,0.074416806,0.0,402,549,951
486,BNS,0.125680388,0.021014329,0.064868115,145,807,952
487,CMA,0.127622065,0.020463532,0.041690614,139,813,952
488,MDU,0.059551241,0.070161045,0.028668049,386,567,953
489,BR,0.032347335,0.160468862,0.016979016,668,285,953
490,KB,0.229712746,-0.001443785,0.075149603,44,909,953
491,NGG,0.067343966,0.05838429,0.03987537,339,617,956
492,IEX,0.033955119,0.151238854,0.010263483,652,305,957
493,AXP,0.067717944,0.057561335,0.01410415,336,622,958
494,FDS,0.028085383,0.181038613,0.008315273,716,243,959
495,NDAQ,0.037180471,0.1299759,0.012657885,601,358,959
496,ORI,0.09421456,0.037313614,0.079569027,221,741,962
497,LLY,0.018929883,0.220307496,0.010718082,796,167,963
498,NYT,0.031903465,0.157707198,0.010418319,672,291,963
499,RCI,0.052462201,0.0817681,0.031539776,441,524,965
500,SF,0.104219627,0.027246363,0.026918885,195,777,972
501,SSL,0.060312332,0.062362351,0.0,380,594,974
502,HST,0.055182947,0.071520856,0.013076528,416,560,976
503,VC,0.033729354,0.143462898,0.0,656,321,977
504,WRB,0.06859673,0.054552734,0.011681881,331,646,977
505,SIVB,0.123165154,0.018441473,0.012007129,149,829,978
506,CW,0.045919565,0.094532372,0.004489649,517,464,981
507,NFLX,0.034254837,0.138522023,0.0,648,333,981
508,SR,0.073221229,0.048912154,0.055715464,310,671,981
509,R,0.224136618,-0.030978436,0.031797928,50,932,982
510,MFC,0.155712379,0.01189482,0.060416316,110,872,982
511,BRO,0.042491096,0.103861617,0.00755833,546,437,983
512,CRL,0.043915179,0.099977961,0.0,533,450,983
513,TD,0.110468621,0.021021395,0.042244154,177,806,983
514,GS,0.094617922,0.031319375,0.030937145,220,763,983
515,CMG,0.023266863,0.193219389,0.0,762,222,984
516,RF,0.111366861,0.02056436,0.037800244,173,812,985
517,VTRS,0.15407682,0.009677419,0.043111267,111,880,991
518,KEY,0.119050551,0.017481171,0.053035561,157,835,992
519,AFG,0.076866925,0.043459491,0.103830267,287,705,992
520,VAL,0.034755985,0.13035358,0.0,638,355,993
521,HSBC,0.129629214,0.013885624,0.056346468,133,861,994
522,ABMD,0.00906817,0.242806215,0.0,856,139,995
523,UBS,0.125308543,0.015671089,0.027397385,146,851,997
524,EXR,0.043624201,0.095635187,0.040817403,536,461,997
525,BUD,0.049387509,0.081300403,0.020205109,472,526,998
526,FITB,0.108258439,0.020041747,0.041028444,183,815,998
527,SJR,0.04542356,0.091719298,0.035197313,523,476,999
528,CHT,0.041834453,0.10234824,0.040996273,556,444,1000
529,ZION,0.122947271,0.01514465,0.036463965,151,853,1004
530,TFC,0.109538218,0.01877093,0.052301874,180,826,1006
531,SKM,0.053199784,0.069301407,0.052711167,434,572,1006
532,EPR,0.062321165,0.055655237,0.093947664,371,637,1008
533,HIG,0.073691866,0.042656702,0.021397032,303,709,1012
534,WM,0.034558335,0.124754384,0.01663062,641,373,1014
535,FLO,0.037639151,0.110317405,0.030735218,598,416,1014
536,WNS,0.030589245,0.139346993,0.0,683,331,1014
537,VLY,0.103610772,0.019340075,0.039915167,196,820,1016
538,CFG,0.110627628,0.016332201,0.047602433,175,844,1019
539,BX,0.054393382,0.061348122,0.118631502,422,598,1020
540,MCO,0.026815921,0.157257391,0.010051091,727,294,1021
541,ASB,0.106302553,0.017586651,0.039091496,191,833,1024
542,EPAM,0.022337221,0.175666561,0.0,769,256,1025
543,WMB,0.051117513,0.069310796,0.051666359,458,571,1029
544,WMT,0.029803378,0.135285664,0.015600844,691,340,1031
545,TGT,0.035701228,0.113728388,0.023578221,624,408,1032
546,FUL,0.041893492,0.091393937,0.009109261,554,479,1033
547,RY,0.08935283,0.021705291,0.03937544,232,801,1033
548,BMI,0.02087368,0.177164196,0.007810365,783,251,1034
549,SCI,0.051845529,0.064998373,0.014676352,449,586,1035
550,POST,0.058568541,0.055241943,0.0,394,642,1036
551,AME,0.036050185,0.109732217,0.006285438,618,419,1037
552,TDG,0.026914364,0.146369554,0.00078794,726,311,1037
553,JBT,0.044721066,0.085791431,0.004482372,527,510,1037
554,SEM,0.052267163,0.061946882,0.021232775,443,597,1040
555,BP,-0.01227594,0.236718808,0.039424131,892,148,1040
556,ADSK,0.017708613,0.181868334,0.0,803,239,1042
557,BEN,0.073416554,0.037827858,,306,738,1044
558,CME,0.044611198,0.082654118,0.043657967,529,517,1046
559,ST,0.049558023,0.067151161,0.008146603,468,578,1046
560,J,0.038524625,0.096050059,0.007430915,591,458,1049
561,OHI,0.067070352,0.043025641,0.099427669,343,707,1050
562,AEM,0.052898892,0.058894193,0.048010166,438,614,1052
563,PPG,0.034371081,0.113961181,0.019095045,645,407,1052
564,AIN,0.030044714,0.126505742,0.008303224,687,367,1054
565,BAC,0.097860598,0.016890151,0.030487231,214,841,1055
566,MLM,0.04116733,0.089068497,0.007556209,564,491,1055
567,FNB,0.096144152,0.016950606,0.039192554,218,840,1058
568,CM,0.111449861,0.007827563,0.050448075,172,886,1058
569,ATR,0.033267194,0.115410972,0.01382764,660,398,1058
570,CBOE,0.017619545,0.175688647,0.01570014,804,255,1059
571,MGA,0.036286356,0.101661604,0.031505384,614,446,1060
572,STT,0.097762284,0.016069534,0.034255566,215,847,1062
573,ALGN,0.021926444,0.159767632,0.0,775,288,1063
574,OUT,0.055371732,0.052901589,0.077048698,413,651,1064
575,ATO,0.056249781,0.05042185,0.027325715,406,659,1065
576,CMCSA,0.036387642,0.096269203,0.032125477,611,456,1067
577,CCZ,0.036387642,0.096269203,0.032125477,611,456,1067
578,AKAM,0.039047356,0.090356217,0.0,585,482,1067
579,OGS,0.055115407,0.05312862,0.033295132,418,650,1068
580,PNC,0.089575415,0.017078112,0.039916738,230,839,1069
581,NVS,0.03515106,0.103573319,0.037935853,632,438,1070
582,TRI,0.034186753,0.109036861,0.015163917,650,420,1070
583,TU,0.048453545,0.064547143,0.035642608,483,588,1071
584,CVS,0.035259397,0.102504746,0.023776169,629,443,1072
585,EDR,0.085976259,0.017702909,0.0,243,832,1075
586,PRI,0.068285791,0.036007723,0.015547806,333,744,1077
587,JNPR,0.045753404,0.071621733,0.026266922,519,559,1078
588,ORCL,0.028978667,0.123753302,0.012500735,703,375,1078
589,ENPH,0.011080286,0.183258308,0.0,842,236,1078
590,RSG,0.036434704,0.093197883,0.014521468,609,469,1078
591,USB,0.08851576,0.016322529,0.046727204,234,845,1079
592,GLW,0.049761177,0.059118566,0.035241198,466,613,1079
593,ADI,0.041101681,0.083852115,0.020821371,565,515,1080
594,PB,0.07786526,0.021090274,0.02867195,279,804,1083
595,GL,0.062659206,0.040845453,0.006823014,365,719,1084
596,JPM,0.0901566,0.013978911,0.034066193,229,859,1088
597,CUZ,0.073661919,0.025717791,0.050647229,304,785,1089
598,LEA,0.044725737,0.070894609,0.025317742,526,565,1091
599,TDY,0.042135549,0.075756395,0.0,550,541,1091
600,CNP,0.056033516,0.046839949,0.02592279,410,681,1091
601,VFC,0.013348567,0.172116692,0.079116802,832,264,1096
602,SLF,0.088143695,0.013230159,0.045375266,235,865,1100
603,FNV,0.02680602,0.124790925,0.007560476,729,372,1101
604,PYPL,0.029432564,0.114142075,0.0,698,403,1101
605,APD,0.036511215,0.088754639,0.023755623,608,494,1102
606,NWE,0.060996271,0.039286611,0.046684479,375,729,1104
607,TMO,0.032195231,0.104682199,0.002107745,670,435,1105
608,MTB,0.084129801,0.015398954,0.037214981,254,852,1106
609,TRV,0.063958404,0.03319833,0.019556599,354,756,1110
610,EA,0.024037417,0.130921958,0.006294087,756,354,1110
611,MMS,0.035443276,0.090350477,0.014912543,628,483,1111
612,EFX,0.02926481,0.11077659,0.0080329,700,412,1112
613,PH,0.041601648,0.072617688,0.014061789,557,556,1113
614,ESI,0.041988449,0.071348672,0.017584906,552,562,1114
615,EVRG,0.052231043,0.048745773,0.037110618,444,673,1117
616,CX,0.093703336,0.003588345,0.0,222,896,1118
617,ING,0.082893713,0.014335602,0.069785044,261,857,1118
618,PENN,0.046390288,0.059595923,0.0,508,610,1118
619,TRMB,0.035777888,0.087981539,0.0,621,498,1119
620,CB,0.057373682,0.040726435,0.014848261,399,721,1120
621,BXP,0.055299487,0.043381813,0.06492677,414,706,1120
622,WBS,0.081275206,0.014709097,0.032986772,267,854,1121
623,TR,0.025916679,0.119265166,0.008405677,736,385,1121
624,NWL,0.036230845,0.086606441,0.070806473,615,506,1121
625,LNT,0.049522859,0.052134831,0.030897644,469,653,1122
626,COTY,0.048705173,0.05478196,0.001312989,478,645,1123
627,BK,0.069691573,0.022293827,0.037269959,326,797,1123
628,STN,0.034345457,0.090409861,0.010873744,647,481,1128
629,BLK,0.048416387,0.054885072,0.027957705,484,644,1128
630,POR,0.053254587,0.044293205,0.036112552,432,697,1129
631,GMED,0.025485562,0.118915115,0.0,740,389,1129
632,ENLC,0.085072763,0.008308041,0.037617555,248,884,1132
633,BABA,0.039533616,0.07337246,0.012378867,582,552,1134
634,KMI,0.062690927,0.028742003,0.061608352,364,772,1136
635,MTN,0.028715415,0.104855888,0.033663091,706,431,1137
636,FLS,0.047081284,0.055594065,0.026086848,500,639,1139
637,ETN,0.03934418,0.072482987,0.020758769,583,557,1140
638,IRM,0.03842049,0.073815277,0.049968206,592,551,1143
639,HWM,0.028604071,0.10475322,0.002683538,709,434,1143
640,AJG,0.029157254,0.102815544,0.011239491,701,442,1143
641,NMR,0.060967007,0.028670441,0.03762521,376,773,1149
642,WEC,0.047656722,0.051640988,0.031039598,493,656,1149
643,FRC,0.075468825,0.014708239,0.015773664,295,855,1150
644,RZA,0.077153491,0.012052933,0.025225623,283,868,1151
645,RGA,0.077153491,0.012052933,0.025225623,283,868,1151
646,CFR,0.068053051,0.019506766,0.025434556,334,818,1152
647,FHN,0.068662979,0.01898047,0.027160023,330,824,1154
648,WFC,0.078597222,0.009569527,0.031559331,273,881,1154
649,PNW,0.05618429,0.034917312,0.044017932,408,749,1157
650,IPGP,0.022871293,0.118813076,0.0,767,390,1157
651,TECH,0.022233157,0.119092512,0.00391917,771,387,1158
652,SRC,0.053143924,0.040304288,0.06678728,435,724,1159
653,SAM,0.016572557,0.132603538,0.0,809,350,1159
654,INTU,0.01658,0.130929554,0.006182726,808,353,1161
655,INCY,0.019104543,0.125301094,0.0,793,369,1162
656,MS,0.076713435,0.011377927,0.037567256,288,874,1162
657,ES,0.048320126,0.04734175,0.029839112,486,677,1163
658,ATI,0.034382675,0.082517161,0.008930565,644,520,1164
659,ED,0.049283674,0.045453758,0.032331277,474,692,1166
660,BOH,0.073516818,0.013316083,0.039210663,305,864,1169
661,NTRS,0.072477556,0.014592674,0.04322071,314,856,1170
662,FISV,0.038972686,0.06514431,0.053314018,587,584,1171
663,VMW,0.025375708,0.107290672,0.043451555,744,428,1172
664,WTW,0.036834282,0.069334903,0.013470614,605,570,1175
665,AVB,0.050118663,0.041523984,0.039240099,462,713,1175
666,CP,0.037450214,0.068253607,0.007528377,600,575,1175
667,VEEV,0.018979777,0.120893179,0.0,795,381,1176
668,AOS,0.027237564,0.097201952,0.020477286,722,454,1176
669,IDA,0.047402516,0.046775177,0.028239769,496,682,1178
670,MKC,0.029852999,0.089099819,0.01736464,690,490,1180
671,DTE,0.047254711,0.046600906,0.029888714,498,683,1181
672,BKH,0.056640437,0.025918376,0.03435317,403,783,1186
673,EXC,0.050909354,0.039120583,0.031296349,459,731,1190
674,CPT,0.054291991,0.029984123,0.032961793,424,766,1190
675,HAE,0.027461434,0.092710734,0.0,720,471,1191
676,APTV,0.034444602,0.074137121,0.002497135,642,550,1192
677,RHP,0.028644642,0.089843225,0.001300182,707,485,1192
678,IQV,0.02838384,0.091047118,0.0,713,480,1193
679,AEP,0.047473844,0.044139566,0.033852275,495,699,1194
680,PCG,0.056146007,0.025569729,0.0,409,787,1196
681,LW,0.012615404,0.129159764,0.008690751,837,360,1197
682,CNA,0.077852538,-0.009380025,0.085515875,280,918,1198
683,ATHM,0.073842062,0.001611784,0.016010864,301,899,1200
684,AXTA,0.033931329,0.07469905,0.0,653,548,1201
685,L,0.071447362,0.009324143,0.00430661,323,882,1205
686,WEX,0.027724389,0.089747366,0.0,719,487,1206
687,DUK,0.049317611,0.038817226,0.04008711,473,734,1207
688,FTV,0.032980038,0.075010446,0.004345225,662,545,1207
689,SYK,0.025501233,0.092900821,0.011366326,739,470,1209
690,SO,0.046049182,0.045062811,0.03786845,516,694,1210
691,HHC,0.047803957,0.040791981,0.0,490,720,1210
692,AEE,0.046742541,0.043864729,0.026548371,507,703,1210
693,TFX,0.031018572,0.07873937,0.005448723,679,534,1213
694,KBR,0.02588838,0.091588785,0.008992806,737,477,1214
695,WAB,0.034808177,0.067180544,0.006103804,637,577,1214
696,ANSS,0.024902225,0.094463206,0.0,750,465,1215
697,FMS,0.074981721,-0.008821764,0.044070534,298,917,1215
698,PVH,0.034959637,0.065138654,0.001761938,633,585,1218
699,LYV,0.026099458,0.089747553,0.0,733,486,1219
700,AA,0.007168833,0.129467697,0.008748407,861,359,1220
701,ETR,0.047700273,0.039267511,0.03739005,492,730,1222
702,INTC,0.073811111,-0.012871129,0.055233994,302,921,1223
703,XEL,0.045267074,0.04405734,0.02638841,524,700,1224
704,STZ,-0.000893855,0.13104545,0.013644637,873,352,1225
705,HE,0.052898765,0.024059335,0.033764026,439,790,1229
706,TRNO,0.046118652,0.041321065,0.025016668,514,716,1230
707,KMX,0.04421578,0.044030824,0.0,530,701,1231
708,BAH,0.022186906,0.096022046,0.01924284,772,460,1232
709,NVDA,0.009165708,0.122013923,0.000835154,854,379,1233
710,RTX,0.034900871,0.060985386,0.021006335,634,600,1234
711,H,0.04610819,0.040221607,0.0,515,725,1240
712,FR,0.04185371,0.045909291,0.024379429,555,687,1242
713,CBU,0.055284414,0.018657856,0.027450118,415,827,1242
714,VOYA,0.065102288,0.004853875,0.015190534,349,893,1242
715,HOLX,0.026626218,0.084266263,0.0,730,514,1244
716,TDC,0.009499924,0.116256158,0.0,851,396,1247
717,ISRG,0.013966451,0.109002394,0.0,828,422,1250
718,WPC,0.039210741,0.049611723,0.054663519,584,667,1251
719,OSK,0.030013518,0.070239982,0.016793072,688,566,1254
720,EBAY,-0.055055561,0.141745582,0.021132001,929,325,1254
721,PNM,0.040471765,0.047061034,0.028520245,575,679,1254
722,XYL,0.017815388,0.097767997,0.01088997,802,453,1255
723,LIN,0.025441111,0.084980769,0.014380025,742,513,1255
724,OFC,0.059517945,0.012077906,0.042531,388,867,1255
725,LHX,0.025338398,0.085483638,0.02061429,745,511,1256
726,MDT,0.031071895,0.06697437,0.029897811,677,580,1257
727,PWR,0.024022499,0.08670169,0.002008017,757,502,1259
728,AMRC,0.032045834,0.06441061,0.0,671,590,1261
729,UAL,0.06037189,0.006903686,0.0,378,888,1266
730,EXPE,0.025647626,0.080126124,0.004881792,738,532,1270
731,PEAK,0.037048502,0.048778462,0.047975259,602,672,1274
732,IBN,0.04087533,0.042929729,0.002254939,567,708,1275
733,DXCM,0.007737724,0.110122734,0.0,858,417,1275
734,ARES,0.036539835,0.049264722,0.06962761,607,669,1276
735,PKI,0.032703896,0.059130452,0.001995733,665,612,1277
736,SJI,0.034820965,0.054953652,0.052705591,636,643,1279
737,MDLZ,0.029582867,0.06492743,0.021612805,694,587,1281
738,DD,0.03101246,0.060928845,0.01905761,680,602,1282
739,CNC,0.025481534,0.075114655,0.0,741,542,1283
740,SBAC,0.015248091,0.093586375,0.010137196,819,466,1285
741,GHC,0.023018733,0.082229825,0.010539086,764,521,1285
742,WCN,0.024492737,0.079515631,0.007122561,754,533,1287
743,CCI,0.028585335,0.067007461,0.044405398,710,579,1289
744,UNF,0.031899397,0.058018991,0.006799937,673,618,1291
745,CHD,0.021138735,0.083470636,0.013023381,780,516,1296
746,AU,0.036396047,0.045612089,0.024876759,610,691,1301
747,AWR,0.022921565,0.077318341,0.01647747,765,538,1303
748,IR,0.028554665,0.062427913,0.001529967,711,593,1304
749,APO,0.053469873,0.011076198,0.025792259,429,875,1304
750,WTM,-0.047733659,0.122509876,0.000750529,927,377,1304
751,SCHW,0.045767596,0.025002058,0.013444192,518,788,1306
752,CAG,0.028241145,0.06242938,0.037387152,714,592,1306
753,ASH,0.042529134,0.031369688,0.018158507,545,762,1307
754,VMC,0.024714862,0.071652357,0.009128526,752,558,1310
755,HXL,0.025428131,0.069870389,0.006784862,743,568,1311
756,SPGI,0.030600376,0.055857309,0.009647409,682,632,1314
757,PSO,0.035198626,0.046364414,0.022690024,630,686,1316
758,ENB,0.028015543,0.060863616,0.068159026,717,604,1321
759,ELS,0.015186827,0.086668654,0.02591042,820,503,1323
760,EL,0.014313275,0.087860262,0.013160815,826,500,1326
761,PBH,-0.026341729,0.108194327,0.0,905,423,1328
762,PEG,0.033789475,0.048004187,0.035362603,654,676,1330
763,REG,0.032322267,0.050053206,0.040494052,669,662,1331
764,SAP,0.01515802,0.085398845,0.025337063,821,512,1333
765,CTVA,0.02707192,0.05860576,0.009865791,723,616,1339
766,RE,0.046209111,0.018595487,0.01973756,511,828,1339
767,AXS,0.048527078,0.014023562,0.039066296,481,858,1339
768,FAF,0.046961099,0.016817127,0.038747371,504,842,1346
769,KRC,0.038790897,0.032439987,0.054806491,589,759,1348
770,PTC,0.014587682,0.081763889,0.0,825,525,1350
771,FRT,0.03260085,0.046536099,0.044443651,667,684,1351
772,AWK,0.029559733,0.05096893,0.016834628,695,658,1353
773,PPL,0.035151822,0.040354793,0.036593232,631,723,1354
774,BURL,0.015634245,0.076533985,0.0,815,540,1355
775,CUBE,0.022001575,0.065383337,0.042758307,774,583,1357
776,PLD,0.03799129,0.031492168,0.029031183,597,761,1358
777,SWX,-0.399947836,0.117238993,0.039579424,968,393,1361
778,EGP,0.029518925,0.049489537,0.030748312,696,668,1364
779,NNN,0.023364909,0.060650559,0.047620566,761,606,1367
780,ESS,0.029618721,0.04831078,0.041051505,693,675,1368
781,ROP,0.021539247,0.063287986,0.005732289,777,591,1368
782,SJM,-0.005515944,0.089659892,0.025990792,880,489,1369
783,WHR,-0.188678911,0.110515501,0.049319555,955,415,1370
784,HAS,0.025205212,0.057372435,0.047722694,747,625,1372
785,COO,0.028624155,0.049705741,0.000222583,708,665,1373
786,EBR,0.039745458,0.023305989,0.0,580,794,1374
787,TRP,0.013931142,0.074701614,0.061423671,829,547,1376
788,RYN,0.030547613,0.04488238,0.047261806,684,696,1380
789,GLOB,0.021200348,0.060886047,0.0,779,603,1382
790,ICE,0.025214564,0.055726526,0.014874151,746,636,1382
791,CAE,0.022910501,0.057876871,0.0,766,620,1386
792,ALE,0.03884243,0.021894476,0.043161543,588,800,1388
793,CAH,0.010574178,0.074863557,0.021269898,844,546,1390
794,EDU,0.028890584,0.045888426,0.0,704,688,1392
795,BRX,0.023790536,0.055779683,0.042595481,760,635,1395
796,CMS,0.045731782,0.010004409,0.029832202,520,879,1399
797,RPM,0.047051424,9.05e-05,0.021025806,501,900,1401
798,FE,0.016953583,0.06223013,0.037206016,806,595,1401
799,STOR,0.028880643,0.044142421,0.042834828,705,698,1403
800,TM,0.009509413,0.072885925,0.002824057,850,554,1404
801,CALX,0.009471033,0.073129065,0.0,852,553,1405
802,TAP,-0.016689504,0.081928075,0.029468384,896,522,1418
803,AIZ,0.040678243,0.015862685,0.022089198,571,850,1421
804,ECL,0.026297335,0.0457172,0.014520503,732,690,1422
805,CIEN,0.020957577,0.055300395,0.0,782,641,1423
806,PHI,0.03817881,0.017798812,0.091887674,594,831,1425
807,T,-0.052104944,0.088012,0.074731255,928,497,1425
808,BFAM,0.021904042,0.052309071,0.0,776,652,1428
809,MET,0.043679779,0.004659406,0.030673905,535,894,1429
810,AES,-0.022963657,0.080540914,0.022328717,903,530,1433
811,NCR,0.018749139,0.055612419,0.00499977,797,638,1435
812,PDI,0.035733333,0.020032248,0.153051757,623,816,1439
813,DV,0.012022734,0.060967775,0.0,839,601,1440
814,FLR,0.014893886,0.057878704,0.007957008,823,619,1442
815,SNN,0.018594273,0.054538844,0.027266042,798,647,1445
816,LUV,0.026995474,0.04069465,0.0,724,722,1446
817,CWT,0.029147549,0.035898858,0.016450085,702,745,1447
818,EIX,0.033994493,0.021907407,0.047402515,651,798,1449
819,F,-0.046098329,0.077984882,0.043035104,926,535,1461
820,AZN,0.015663945,0.053526143,0.020789981,813,649,1462
821,NE,0.01786417,0.050083564,0.0,801,661,1462
822,LUMN,-0.294339177,0.086786993,0.148310438,963,501,1464
823,TEVA,-0.232436384,0.085963672,0.0,958,509,1467
824,TYL,0.012262023,0.056415135,0.0,838,629,1467
825,BSX,0.010545521,0.057522587,0.000830951,845,623,1468
826,SWH,0.015300259,0.051996392,0.042369949,817,654,1471
827,SWK,0.015300259,0.051996392,0.042369949,817,654,1471
828,BDX,0.020050671,0.045753051,0.015051515,785,689,1474
829,ACM,0.004807086,0.060213092,0.008356887,867,607,1474
830,ADC,0.027321854,0.033007564,0.040819052,721,757,1478
831,RBC,0.02489578,0.039025131,0.003420837,751,733,1484
832,ZBH,0.008658883,0.056880018,0.007528813,857,628,1485
833,ADT,0.025097197,0.036813042,0.018423954,749,742,1491
834,PANW,0.00580172,0.057262405,0.0,864,627,1491
835,KWR,-0.00598003,0.058633407,0.01010933,882,615,1497
836,HIW,0.019914271,0.042059341,0.072305466,787,711,1498
837,BAK,-0.041738787,0.066894241,0.068717822,920,581,1501
838,LXP,0.040571938,-0.035721531,0.050797736,572,934,1506
839,FMX,0.009094439,0.050240494,0.006430797,855,660,1515
840,AER,-0.09817252,0.068646643,0.0,942,574,1516
841,AGO,0.033749285,0.012052485,0.017418986,655,870,1525
842,AMT,0.018059385,0.039948983,0.026901918,799,727,1526
843,IX,0.021132084,0.033924569,0.00822532,781,754,1535
844,NOW,0.00416441,0.04867014,0.0,869,674,1543
845,O,0.022404936,0.027129551,0.046732726,768,778,1546
846,NOV,0.019025175,0.034294622,0.009573959,794,753,1547
847,SRE,0.016099602,0.038674918,0.030153511,811,736,1547
848,STAG,0.018044469,0.034868305,0.046198003,800,750,1550
849,EQIX,0.011742911,0.042164557,0.019197241,840,710,1550
850,NEE,0.019540891,0.030860557,0.02017901,791,764,1555
851,BKR,-0.01983112,0.05128538,0.025492253,899,657,1556
852,CZR,-0.058860532,0.05635309,0.0,931,630,1561
853,HASI,0.016366606,0.034545565,0.052133212,810,752,1562
854,GPN,0.001990468,0.044998931,0.009462393,870,695,1565
855,AGI,0.009345838,0.041405378,0.008842019,853,715,1568
856,SUI,0.014079099,0.036241487,0.025260929,827,743,1570
857,TMUS,0.014802796,0.03506506,0.0,824,748,1572
858,BEP,0.0197776,0.025670663,0.131134089,790,786,1576
859,AMH,0.016637559,0.029238998,0.025607577,807,770,1577
860,KEX,0.031653354,-3.24e-05,0.0,675,906,1581
861,ALK,0.010664408,0.034599243,0.0,843,751,1594
862,ARE,0.022152234,0.019091734,0.03217743,773,822,1595
863,FTI,-0.006661307,0.041669829,0.0,885,712,1597
864,CRM,0.001248303,0.04009156,0.0,871,726,1597
865,AMZN,-0.003214286,0.039859152,0.0,878,728,1606
866,AUY,-0.26170857,0.053687563,0.021493337,961,648,1609
867,PUK,0.02654775,0.010114442,0.012608851,731,878,1609
868,NEM,-0.013501686,0.041090111,0.046588823,893,717,1610
869,NU,-0.019155678,0.041503281,0.0,897,714,1611
870,QRVO,0.010167019,0.029850688,0.0,848,767,1615
871,THG,0.024113276,0.013365497,0.022637377,755,862,1617
872,D,0.020012402,0.017578448,0.044474242,786,834,1620
873,REXR,0.013813222,0.024020376,0.0239272,830,791,1621
874,DOC,0.011528937,0.026258912,0.063868457,841,781,1622
875,XRAY,-0.138453287,0.047273289,0.015156991,947,678,1625
876,DIS,0.015888293,0.019433616,0.0,812,819,1631
877,KIM,-0.000947312,0.031730569,0.041784528,874,760,1634
878,ELP,0.010539782,0.023215447,0.020546465,846,795,1641
879,STE,0.005611961,0.026926218,0.009621449,865,779,1644
880,AMD,0.012968967,0.020649883,0.0,836,810,1646
881,RS,0.025155703,0.0,0.0,748,903,1651
882,UDR,0.006977186,0.023628961,0.039171019,862,792,1654
883,DLB,0.023885853,0.0,0.009678592,759,903,1662
884,MTZ,0.00521754,0.022849629,0.0,866,796,1662
885,NWSA,0.013117675,0.01711819,0.015318627,834,837,1671
886,NWS,0.013117675,0.01711819,0.015318627,834,837,1671
887,KGC,0.005842767,0.02077782,0.029404773,863,809,1672
888,KSS,-0.005028051,0.02190561,0.063247592,879,799,1678
889,DEI,-0.019465835,0.025772719,0.071413433,898,784,1682
890,DLR,0.01316136,0.015901295,0.050525988,833,849,1682
891,WELL,0.004661108,0.020053327,0.037348776,868,814,1682
892,AL,-0.022623223,0.024896966,0.029135467,902,789,1691
893,VTR,-0.002273985,0.019734699,0.040018428,875,817,1692
894,PGR,0.009518153,0.016667572,0.003440519,849,843,1692
895,BIO,-0.289639864,0.037316753,5.444138924,962,740,1702
896,DNB,0.000304138,0.017910697,0.008154706,872,830,1702
897,CCJ,0.007182235,0.016149997,0.00416999,860,846,1706
898,SNPS,0.01705498,0.0,0.0,805,903,1708
899,FIS,-0.40769715,0.035129851,0.027768695,969,747,1716
900,ORA,0.013580145,0.005642424,0.005598425,831,892,1723
901,AAL,0.015352277,-0.003470615,0.429017574,816,911,1727
902,MAC,-0.026878276,0.019071967,0.076955322,906,823,1729
903,MKL,-0.00565648,0.016039782,0.002012127,881,848,1729
904,PRGO,-0.028548965,0.017448024,0.031057086,907,836,1743
905,GRMN,0.010469173,0.0,,847,903,1750
906,GE,-0.011103461,0.013326352,0.008913457,890,863,1753
907,KRG,-0.002635575,0.009254169,0.038951173,876,883,1759
908,MGM,0.015067298,-0.044057246,0.000295033,822,939,1761
909,HL,-0.01205228,0.010295026,0.004173184,891,876,1767
910,DNP,-0.006206065,0.002128325,0.077335261,883,898,1781
911,MBLY,-0.00293913,-0.000531314,0.012079107,877,907,1784
912,HR,-0.021797281,0.005910976,0.289407754,901,889,1790
913,KKR,-0.029418469,0.005739273,0.014754561,909,891,1800
914,CDAY,-0.007481307,-0.010136832,0.0,886,919,1805
915,MANU,-0.009167261,-0.014132685,0.0,889,923,1812
916,WDAY,-0.007932828,-0.025084465,0.0,887,930,1817
917,TWTR,-0.006502209,-0.038750598,0.0,884,937,1821
918,PRU,-0.036509133,-0.001559288,0.047181433,914,910,1824
919,HUBS,-0.00811317,-0.061186651,0.0,888,941,1829
920,CTLT,-0.029561069,-0.014770889,0.0,910,924,1834
921,GPS,-0.04169763,-0.008487085,0.045413261,919,916,1835
922,TSN,-0.036254872,-0.013276418,0.037485747,913,922,1835
923,TAL,-0.028933945,-0.023025061,0.0,908,928,1836
924,KMPR,-0.095261937,0.003387287,0.025207093,940,897,1837
925,CINF,-0.029890159,-0.021558984,0.026015509,911,927,1838
926,ENV,-0.025098302,-0.036986143,0.0,904,935,1839
927,ALL,-0.037090697,-0.015065952,0.028035564,915,925,1840
928,GWRE,-0.016047553,-0.090346646,0.0,895,951,1846
929,AEG,-0.085288416,-0.004058917,0.013895771,937,912,1849
930,CVT,-0.038440373,-0.040667179,0.0,917,938,1855
931,LVS,-0.041959969,-0.037271875,0.0,921,936,1857
932,PHG,-0.130723182,-0.005098005,0.033286743,944,913,1857
933,SNOW,-0.015994626,-0.147023158,0.0,894,963,1857
934,RIG,-0.213789969,5.3e-05,0.0,957,901,1858
935,WYNN,-0.075702347,-0.021294629,0.000154208,934,926,1860
936,VNO,-0.095872602,-0.011371494,0.1174385,941,920,1861
937,STX,-0.041305246,-0.068896052,0.045443579,918,948,1866
938,COUP,-0.037241024,-0.092940938,0.0,916,952,1868
939,WK,-0.020453367,-0.215091596,0.0,900,968,1868
940,BAX,-0.094243112,-0.023320024,0.022305371,939,929,1868
941,CS,-1.000265352,0.003799,0.038334834,974,895,1869
942,BA,-0.044589556,-0.075178541,0.0,922,949,1871
943,TV,-0.244532022,-0.005607294,0.020952843,959,914,1873
944,RNR,-0.146270411,-0.028932792,0.012620473,951,931,1882
945,DXC,-0.09889235,-0.061831488,0.0,943,942,1885
946,TTWO,-0.058958685,-0.094434037,0.0,932,953,1885
947,RCL,-0.166779323,-0.033644267,0.0,952,933,1885
948,NEWR,-0.035128464,-0.43017642,0.0,912,974,1886
949,GME,-0.045135846,-0.174096827,0.0,923,966,1889
950,SMG,-0.130869683,-0.066060606,0.051335621,945,944,1889
951,SE,-0.057471989,-0.112501569,0.0,930,961,1891
952,GOL,-0.068362527,-0.103655214,0.0,933,959,1892
953,MU,-0.076303803,-0.096572476,0.006593025,935,957,1892
954,TTM,-0.077412565,-0.101220175,1.04e-05,936,958,1894
955,HCP,-0.045820091,-0.238307932,0.0,925,970,1895
956,SPR,-0.175895303,-0.062604748,0.001356519,953,943,1896
957,ZNH,-0.197684061,-0.046786133,0.0,956,940,1896
958,ETSY,-0.045720325,-0.328753009,0.0,924,973,1897
959,WDC,-0.141438963,-0.067649381,0.0,950,947,1897
960,WRK,-0.179644807,-0.067105304,0.030645291,954,946,1900
961,WBA,-0.140976635,-0.095460031,0.075935142,949,954,1903
962,S,-0.090332519,-0.225452696,0.0,938,969,1907
963,CEA,-0.30845019,-0.066624281,0.0,964,945,1909
964,NIO,-0.131147633,-0.310257459,0.0,946,972,1918
965,ILMN,-0.138728761,-0.44086929,0.0,948,975,1923
966,UGI,-0.31126063,-0.11106879,0.06382708,965,960,1925
967,LPL,-1.417657726,-0.080366042,0.103179491,975,950,1925
968,CCL,-0.577674136,-0.095819748,0.0,972,955,1927
969,CUK,-0.577674136,-0.095819748,0.0,972,955,1927
970,NEA,-0.392244409,-0.168459055,0.073260271,967,964,1931
971,RNG,-0.260767099,-0.25739584,0.0,960,971,1931
972,NCLH,-0.441786383,-0.114920762,0.0,970,962,1932
973,TEO,-0.491679368,-0.179262728,0.002938504,971,967,1938
974,KEP,-1.733864796,-0.171610531,0.003961064,976,965,1941
975,W,-0.38177573,-0.871352785,0.0,966,976,1942
