,ticker,eps,roce,divYield,eps_rank,roce_rank,overall_rank
0,PBF,0.57541184,0.497484548,0.014721326,6,20,26
1,SWN,0.284601461,0.778613023,0.0,27,3,30
2,DQ,0.634915201,0.44335949,0.0,4,32,36
3,LPX,0.23518711,0.620655412,0.014942827,40,10,50
4,ERF,0.221426368,0.89771845,0.010073994,52,2,54
5,PBR,0.527250274,0.366559486,0.542769914,8,54,62
6,APA,0.232549736,0.390675398,0.014066549,41,45,86
7,RRC,0.196368659,0.523872006,0.006411598,71,16,87
8,ICL,0.229432082,0.384514436,0.123908202,45,48,93
9,SQM,0.171288828,0.712109629,0.098151339,89,5,94
10,MLI,0.197288137,0.463094424,0.016718587,70,25,95
11,VLO,0.230055259,0.360515613,0.031171609,44,58,102
12,NUE,0.219991823,0.373606235,0.015430527,54,51,105
13,CHK,0.415826671,0.296145409,0.102103307,12,94,106
14,CF,0.193174129,0.438139308,0.017666253,74,33,107
15,SM,0.260930618,0.308645801,0.004608018,29,79,108
16,BTU,0.34549882,0.294452377,0.0,16,96,112
17,CIVI,0.251683068,0.301313526,0.108273649,32,89,121
18,AMG,1.735059935,0.265616079,0.001999925,1,121,122
19,CVI,0.204465865,0.359328358,0.153349399,64,60,124
20,E,0.297022318,0.285394955,0.064358044,22,103,125
21,AR,0.199446755,0.359487423,0.013144486,68,59,127
22,AN,0.228008985,0.304253081,0.0,47,83,130
23,DHI,0.247287594,0.292830481,0.013361762,34,99,133
24,PHM,0.244608944,0.293601429,0.013468685,37,97,134
25,MPC,0.241730877,0.282611184,0.021298828,38,106,144
26,MTDR,0.17958165,0.353364137,0.0052129,81,64,145
27,MTH,0.293271421,0.252802701,0.0,24,130,154
28,GGB,0.219691652,0.287836111,0.113286399,55,100,155
29,EC,0.32024605,0.241922689,0.128046653,18,140,158
30,WSM,0.127925495,0.495089978,0.024651005,140,21,161
31,DVN,0.148785055,0.391249515,0.083581829,117,44,161
32,CPG,0.289509786,0.239178408,0.039150373,25,142,167
33,CRC,0.146868396,0.361210543,0.016536709,118,57,175
34,CTRA,0.207846313,0.274721797,0.101852363,61,116,177
35,VALE,0.238719147,0.23571634,0.083897303,39,149,188
36,GPI,0.27054777,0.227559892,0.008532245,28,160,188
37,X,0.407952204,0.213497645,0.0,13,177,190
38,MRNA,0.118156944,0.449964175,0.0,162,28,190
39,DDS,0.114003828,0.450823966,0.03468959,167,26,193
40,PXD,0.143121415,0.322983706,0.114369427,122,72,194
41,NVR,0.113847204,0.449262032,0.301158389,168,29,197
42,FANG,0.181637437,0.26570857,0.065101243,79,120,199
43,EQT,0.141465298,0.319187393,0.016265955,124,76,200
44,OLN,0.172976009,0.274418461,0.015147948,88,117,205
45,BAM,0.168598192,0.267837864,0.280322007,96,119,215
46,OXY,0.214324875,0.225297601,0.020294358,57,162,219
47,UMC,0.176627857,0.245690075,0.07584877,85,135,220
48,HPQ,0.111721282,0.376065627,0.036170768,172,50,222
49,ARW,0.210451463,0.220672832,0.0,58,165,223
50,HRB,0.11245636,0.367564482,0.036136532,170,53,223
51,COP,0.119548257,0.346916599,0.036645253,158,66,224
52,MOS,0.23174962,0.209996527,0.012788015,42,188,230
53,PSX,0.22464305,0.210476772,0.0365371,49,185,234
54,EOG,0.1031081,0.400747392,0.018684107,201,41,242
55,STM,0.134202824,0.277801605,0.006581309,131,114,245
56,KBH,0.299521729,0.188530021,0.019237379,21,228,249
57,QCOM,0.096201312,0.426940885,0.02388672,217,36,253
58,TMHC,0.301687504,0.186697536,0.0,20,234,254
59,ABG,0.249494968,0.182112192,0.0,33,237,270
60,LEN,0.181264237,0.205092492,0.017208165,80,192,272
61,TX,0.294627118,0.176731184,0.08835083,23,254,277
62,MTG,0.217642507,0.18824356,0.027904098,56,229,285
63,RHI,0.07905037,0.607008807,0.022743116,274,11,285
64,EXPD,0.080129815,0.51588673,0.012620957,271,18,289
65,ESNT,0.199454652,0.192662973,0.022102955,67,223,290
66,CHRW,0.081692141,0.481352823,0.024782097,266,24,290
67,AMAT,0.084849804,0.40254303,0.011352319,251,40,291
68,MUSA,0.102406574,0.296237381,0.004550389,202,93,295
69,CVE,0.125792754,0.22930948,0.018079052,146,156,302
70,CNQ,0.128184488,0.218695826,0.057734003,139,168,307
71,AB,0.078386735,0.448232405,0.103220662,278,30,308
72,PFE,0.109175473,0.258144814,0.031261101,183,125,308
73,TOL,0.255740257,0.161328824,0.017672417,31,285,316
74,SU,0.152349591,0.200727536,0.043571614,112,206,318
75,PII,0.100746331,0.278441145,0.025044663,206,113,319
76,MAS,0.078287543,0.393268648,0.0239315,279,43,322
77,OC,0.150607162,0.198196115,0.016504894,115,211,326
78,TNET,0.083110924,0.342955326,0.0,261,68,329
79,LAD,0.22381643,0.164105035,0.008086733,51,279,330
80,MT,0.321056428,0.142372036,0.011458905,17,321,338
81,TKC,0.141399408,0.19639523,0.015966699,125,215,340
82,RIO,0.107691198,0.234117523,0.101682341,187,153,340
83,XOM,0.120217588,0.209144663,0.03221978,155,189,344
84,VSH,0.138633643,0.196052424,0.018488473,128,217,345
85,DKS,0.106393402,0.230369484,0.016633219,191,155,346
86,BBWI,0.078240757,0.334386391,0.018190976,280,69,349
87,ACT,0.179281897,0.171922223,0.063848825,82,267,349
88,TSM,0.085659946,0.278886788,0.024035827,245,110,355
89,TS,0.123026868,0.200739096,0.025597286,152,205,357
90,CVX,0.105660298,0.224562754,0.032772121,195,164,359
91,GIL,0.107339642,0.215606989,0.024532482,190,171,361
92,WLK,0.171237973,0.167104975,0.012879047,90,273,363
93,NNI,0.11936995,0.20070473,0.010727697,159,207,366
94,BC,0.120724188,0.196175022,0.0193658,154,216,370
95,IBP,0.090919782,0.238071476,0.025502773,229,144,373
96,MUR,0.14450178,0.175303827,0.019198934,121,258,379
97,LYB,0.14297916,0.172301976,0.119554444,123,264,387
98,PAG,0.161399842,0.158251343,0.018022982,100,291,391
99,M,0.185644462,0.144106622,0.027286739,78,315,393
100,ASX,0.149395839,0.16537715,0.072852326,116,278,394
101,OGN,0.129218442,0.17505626,0.040865156,137,259,396
102,LII,0.058204948,0.675172343,0.01662664,396,8,404
103,MCK,0.07086177,0.305019843,0.005812258,327,82,409
104,AVT,0.165999028,0.144243023,0.022897257,98,314,412
105,WSO,0.067777509,0.322105813,0.037481148,339,74,413
106,EVR,0.109066182,0.187649473,0.029126658,184,230,414
107,TEX,0.100897585,0.198159943,0.01197318,205,212,417
108,SSD,0.087761075,0.212270103,0.011533922,238,181,419
109,MO,0.06916466,0.301079822,0.079184176,330,90,420
110,WMS,0.07315415,0.285177592,0.005714577,316,104,420
111,UPS,0.076619262,0.247131209,0.033930629,291,133,424
112,BBY,0.074105161,0.263042204,0.041204349,303,123,426
113,HCA,0.084781035,0.213889411,0.009810742,252,176,428
114,TPR,0.092509132,0.201087423,0.027999826,226,203,429
115,POOL,0.062819301,0.354976238,0.01264205,367,62,429
116,AGCO,0.085982645,0.210349585,0.03907687,243,186,429
117,RDY,0.058081102,0.406030447,0.006415943,397,39,436
118,SWKS,0.09208651,0.199396717,0.026950036,228,208,436
119,CIG,0.170873178,0.133895352,0.087399209,92,345,437
120,TXN,0.057371222,0.418627694,0.028177408,402,38,440
121,YPF,0.449540933,0.106703528,0.0,11,434,445
122,CRI,0.086322265,0.198439265,0.040776929,241,210,451
123,GFI,0.077102204,0.21870374,0.0,288,167,455
124,MC,0.059578952,0.331594292,0.069210972,386,70,456
125,NVO,0.052137549,0.621765835,0.023759323,447,9,456
126,BYD,0.107684565,0.171393048,0.008111496,188,268,456
127,TSN,0.136424154,0.139964453,0.027512345,129,328,457
128,PM,0.05767631,0.356558451,0.049797451,400,61,461
129,HD,0.053261172,0.450717165,0.024253216,435,27,462
130,CLF,0.159668177,0.127515454,0.0,101,363,464
131,BG,0.107646841,0.165554072,0.023334626,189,275,464
132,GWW,0.05463897,0.397095733,0.013068144,423,42,465
133,WES,0.114773024,0.153156161,0.069381824,166,301,467
134,HTZ,0.353003098,0.099860302,0.0,15,456,471
135,EXP,0.085467863,0.18893639,0.0069435,246,226,472
136,DOW,0.126117532,0.139430102,0.055214266,144,329,473
137,WU,0.170788395,0.121103052,0.068307856,93,381,474
138,ASR,0.073355857,0.224895199,0.03312071,313,163,476
139,CTSH,0.077301091,0.204619097,0.019038347,284,193,477
140,WY,0.081742599,0.197435897,0.070307331,265,213,478
141,PSA,0.133953555,0.133464361,0.079594265,132,346,478
142,NRG,0.156620788,0.124845335,0.042586488,107,372,479
143,NEU,0.089538436,0.179098012,0.026990167,232,248,480
144,PAC,0.064507378,0.257797861,0.051362661,355,126,481
145,ALSN,0.111848791,0.145072775,0.016851042,171,312,483
146,ACI,0.139292045,0.130055132,0.389971709,126,358,484
147,VIPS,0.098335489,0.167727965,0.0,212,272,484
148,CSL,0.07569632,0.207646982,0.011010374,296,190,486
149,ALB,0.080431698,0.194255801,0.007261372,270,220,490
150,LRCX,0.053677695,0.35452199,0.010803613,430,63,493
151,TPX,0.075895393,0.201444385,0.011741552,293,200,493
152,RLI,0.097962417,0.16324423,0.061262801,213,281,494
153,CNS,0.054311093,0.328986719,0.03408756,426,71,497
154,SEE,0.067550744,0.228604612,0.016283082,341,158,499
155,SNA,0.075002048,0.201159768,0.025757531,299,202,501
156,MMM,0.08511269,0.177055128,0.049635564,248,253,501
157,MRO,0.194791012,0.107916525,0.011864347,73,429,502
158,MSM,0.060367316,0.255308762,0.031080375,380,127,507
159,KLAC,0.0500691,0.386726386,0.002653431,464,46,510
160,NTAP,0.093352961,0.160289718,0.031655007,224,288,512
161,TLK,0.075342368,0.193262827,0.040436641,298,221,519
162,GSK,0.084169995,0.172300193,0.059300421,255,265,520
163,THC,0.191678621,0.102865961,0.0,75,446,521
164,ULTA,0.047797874,0.44423196,0.0,491,31,522
165,SCCO,0.056514045,0.276516828,0.057955544,408,115,523
166,FRO,0.195707183,0.100992915,0.013824838,72,454,526
167,SIG,0.106364355,0.138348238,0.019623899,192,335,527
168,LOW,0.047384842,0.419845435,0.017446338,497,37,534
169,OMC,0.078499572,0.174339105,0.034649526,276,261,537
170,CHH,0.053201375,0.287227754,0.008416226,437,102,539
171,CR,0.07247528,0.190915008,0.01869248,318,224,542
172,TER,0.051701001,0.301975434,0.00503721,455,88,543
173,ADM,0.085451658,0.155920602,0.017700701,247,297,544
174,GEF,0.095943894,0.14078506,0.028347638,219,326,545
175,CBT,0.057898185,0.237190083,0.023270084,399,146,545
176,TROW,0.063207068,0.212115526,0.044929397,362,183,545
177,TGS,0.102107157,0.134174738,0.0,203,344,547
178,AIT,0.062036441,0.21477693,0.009562235,375,175,550
179,UL,0.063595907,0.205271596,0.036025475,359,191,550
180,AVGO,0.059633439,0.214888892,0.036480412,385,172,557
181,CNHI,0.093307777,0.138152181,0.019452533,225,337,562
182,LKQ,0.077635602,0.161871608,0.019189305,283,283,566
183,NXPI,0.067343666,0.190173295,0.01969325,344,225,569
184,HOG,0.11591971,0.114251444,0.014568765,165,404,569
185,PCAR,0.087340479,0.138659021,0.029137661,239,333,572
186,SID,0.110373903,0.117742279,0.191283949,180,393,573
187,CSCO,0.0591592,0.213075713,0.029558494,394,179,573
188,URI,0.081465894,0.148679731,0.0,267,309,576
189,MPLX,0.118908359,0.110660173,0.091864546,161,416,577
190,MAN,0.086058401,0.138216984,0.032208588,242,336,578
191,ODFL,0.043198037,0.42717804,0.004218427,543,35,578
192,FLT,0.068726628,0.179713096,0.0,332,246,578
193,AAPL,0.040913478,0.600871346,0.006083955,568,12,580
194,GOOGL,0.051741036,0.25287535,0.0,453,128,581
195,GOOG,0.051741036,0.25287535,0.0,453,128,581
196,JBL,0.05449009,0.228414326,0.002997621,424,159,583
197,V,0.04684762,0.311568078,0.010173416,507,78,585
198,BDC,0.080782425,0.14407976,0.00283874,269,316,585
199,CARR,0.101580184,0.120325122,0.014630536,204,383,587
200,PKG,0.084903262,0.137255727,0.034652205,250,339,589
201,ORLY,0.039988479,0.530985798,0.0,581,15,596
202,RH,0.072342981,0.163261454,0.0,319,280,599
203,PAYX,0.041168718,0.428833579,0.031062251,566,34,600
204,OTIS,0.038096454,0.68313172,0.01413795,596,7,603
205,ITW,0.043776634,0.345739828,0.022249034,537,67,604
206,ABEV,0.062970357,0.181567807,0.053320468,363,241,604
207,HI,0.079344461,0.138688748,0.023548859,273,332,605
208,RDN,0.206817747,0.075092298,0.037702912,62,549,611
209,AYI,0.067450711,0.168284099,0.003275063,342,270,612
210,DPZ,0.036546782,0.720650338,0.012729874,608,4,612
211,NOC,0.057930552,0.19715245,0.012447496,398,214,612
212,ADP,0.037524557,0.545030109,0.020935447,600,14,614
213,VZ,0.12838943,0.092461814,0.065263822,138,477,615
214,EME,0.054915342,0.203846869,0.003676194,422,195,617
215,NSP,0.041421624,0.364837853,0.017689239,563,55,618
216,DECK,0.043376206,0.317050567,0.0,542,77,619
217,MMP,0.098573575,0.114032826,0.082747018,211,408,619
218,IPG,0.071927744,0.155859983,0.035066692,321,298,619
219,INFY,0.041353766,0.362799962,0.023541543,565,56,621
220,IP,0.111551074,0.102217529,0.049916139,173,450,623
221,LAZ,0.107793788,0.104821865,0.054838047,186,438,624
222,FAST,0.040029882,0.386719166,0.026196757,579,47,626
223,ABC,0.060215119,0.180878951,0.013883448,382,244,626
224,GIB,0.059558268,0.181351367,0.0,387,242,629
225,BSBR,0.130513571,0.088532358,0.067535843,134,497,631
226,NOK,0.174196563,0.076833836,0.014468562,87,544,631
227,MCHP,0.048526959,0.235139642,0.015078337,482,150,632
228,EMR,0.074426189,0.13902133,0.028171844,302,331,633
229,SUN,0.131584167,0.087942478,0.099449929,133,502,635
230,TREX,0.039043605,0.38366148,0.0,587,49,636
231,INGR,0.075891189,0.134178553,0.02791932,294,343,637
232,HES,0.051195243,0.212196,0.010708857,458,182,640
233,SON,0.078405508,0.127066274,0.03144931,277,364,641
234,DE,0.059165073,0.179052807,0.010893807,393,249,642
235,UGI,0.158087971,0.079175203,0.043610475,106,538,644
236,ALV,0.063417169,0.161717791,0.033582614,360,284,644
237,REGN,0.056144834,0.186825361,0.0,412,233,645
238,TRQ,0.158565065,0.077785186,0.0,103,542,645
239,VRTX,0.044918261,0.274002405,0.0,528,118,646
240,AVY,0.050886532,0.210340342,0.01605705,461,187,648
241,DVA,0.110631162,0.093585039,0.0,176,472,648
242,BERY,0.126052813,0.087929204,0.003620316,145,503,648
243,DCI,0.04688545,0.238419145,0.014948984,506,143,649
244,AMCR,0.071532711,0.140370474,0.04934938,325,327,652
245,YUM,0.034831976,0.523080603,0.017061096,635,17,652
246,BBD,0.127271583,0.086289367,0.0,142,511,653
247,BBDO,0.127271583,0.086289367,0.0,142,511,653
248,FCX,0.063333212,0.157258425,0.015815041,361,294,655
249,CMC,0.130458324,0.082554034,0.011370644,135,522,657
250,JHX,0.053131792,0.196044212,0.013448985,439,218,657
251,BHP,0.042691135,0.278798342,0.043837628,547,111,658
252,WTS,0.050884418,0.202937766,0.007991787,462,197,659
253,FICO,0.034814181,0.488408257,0.0,637,22,659
254,AMX,0.064265907,0.151317184,0.001278857,356,305,661
255,PBA,0.117529171,0.088178328,0.065311566,163,499,662
256,CSX,0.062955924,0.15270911,0.012875287,364,303,667
257,AON,0.040746219,0.295934828,0.00728679,572,95,667
258,CRH,0.088954417,0.107275683,0.030391654,234,433,667
259,WPP,0.076519957,0.122204027,0.040955606,292,379,671
260,MXL,0.047195163,0.214846371,0.0,500,174,674
261,ITT,0.054259921,0.180360721,0.012995769,429,245,674
262,WWE,0.038338428,0.306900661,0.006997351,594,81,675
263,GM,0.204362083,0.059671187,0.008167077,65,610,675
264,MAR,0.048819961,0.201934081,0.006645974,477,199,676
265,CCK,0.073169009,0.128845597,0.010668384,315,362,677
266,DAR,0.073205392,0.12651552,0.0,314,367,681
267,KMB,0.042225184,0.252068447,0.034015945,552,131,683
268,BKNG,0.038056958,0.302125896,0.0,597,87,684
269,SYY,0.047019831,0.212772935,0.026456365,504,180,684
270,GGG,0.040536492,0.280875319,0.012506917,575,109,684
271,FBHS,0.052109017,0.1827966,0.009647319,450,236,686
272,DOV,0.055142446,0.169800369,0.014883258,420,269,689
273,CE,0.170926602,0.06206089,0.026803168,91,598,689
274,VRSN,0.030396568,1.529764801,0.0,689,1,690
275,ITUB,0.120016312,0.080460864,0.027096808,157,533,690
276,EPD,0.104851334,0.088945794,0.078208782,196,496,692
277,WRK,0.120202341,0.079860587,0.033021922,156,536,692
278,LMT,0.044680923,0.225664315,0.023509711,531,161,692
279,TSCO,0.043466311,0.234706429,0.016353206,541,152,693
280,RL,0.066176628,0.132968278,0.025105845,349,348,697
281,CDW,0.046160506,0.212013098,0.011704764,515,184,699
282,AWI,0.061682098,0.140910602,0.013436909,376,325,701
283,HUN,0.08328083,0.103083295,0.030958743,258,445,703
284,UNP,0.054272258,0.16547915,0.024499294,428,276,704
285,PKX,0.151266668,0.064479445,0.058619264,114,591,705
286,GNRC,0.062880449,0.135569388,4.86e-05,365,340,705
287,SYF,0.191056043,0.055962915,0.030153407,76,630,706
288,WIT,0.056211344,0.153739418,0.016251269,409,299,708
289,WAT,0.0344412,0.349957687,0.0,644,65,709
290,CHTR,0.092303292,0.090307871,0.0,227,487,714
291,FN,0.052273998,0.16805329,0.0,444,271,715
292,FOXA,0.073375458,0.114069491,0.017707233,311,406,717
293,CPB,0.062626914,0.133387556,0.032627309,370,347,717
294,FOX,0.073375458,0.114069491,0.017707233,311,406,717
295,MRK,0.05168276,0.173219816,0.024960363,456,262,718
296,GPC,0.048182823,0.186904157,0.020203484,487,232,719
297,BIIB,0.075724822,0.109025295,0.0,295,425,720
298,MA,0.02950066,0.499490897,0.00565355,702,19,721
299,DISH,0.309457842,0.043915079,0.0,19,703,722
300,ALLE,0.049444665,0.178367198,0.015535125,472,251,723
301,CLH,0.066539874,0.124226042,0.0,348,375,723
302,TJX,0.036163432,0.281423188,0.013843006,617,107,724
303,ANET,0.036365364,0.27857346,0.0,614,112,726
304,CAJ,0.083278526,0.094740544,0.040733123,259,467,726
305,ASGN,0.062436015,0.130256378,0.0,372,357,729
306,LEG,0.070522103,0.114983404,0.052174519,328,401,729
307,BSMX,0.166214373,0.055787405,0.112236764,97,633,730
308,TTC,0.040116425,0.230968731,0.011374956,578,154,732
309,MOH,0.041494828,0.214874519,0.0,561,173,734
310,VRSK,0.034241846,0.303000926,0.007007033,650,86,736
311,UA,0.100442163,0.081084409,0.0,207,529,736
312,UAA,0.100442163,0.081084409,0.0,207,529,736
313,CIB,0.203965368,0.049092188,0.069476898,66,672,738
314,FL,0.083261712,0.092266158,0.036518295,260,478,738
315,DFS,0.146235193,0.057791655,0.023406954,119,620,739
316,KR,0.062342079,0.125456093,0.018947102,373,369,742
317,TT,0.045666556,0.19515442,0.016124337,524,219,743
318,EMN,0.071861475,0.10984583,0.034526131,322,422,744
319,ABM,0.077144037,0.099212106,0.017377498,287,457,744
320,JLL,0.084758333,0.089664931,0.0,253,491,744
321,OKE,0.058576535,0.131633963,0.056854191,395,352,747
322,APH,0.041905803,0.204409451,0.010516654,556,194,750
323,STR,0.465213494,0.037708111,0.337300116,10,742,752
324,KT,0.144908686,0.055812719,0.054726789,120,632,752
325,CAT,0.051450024,0.156788066,0.018723051,457,296,753
326,SBS,0.079888804,0.09140602,0.0,272,482,754
327,OGE,0.084117233,0.088312776,0.041610042,257,498,755
328,RBA,0.049895875,0.158612034,0.017984755,466,290,756
329,NSC,0.056516298,0.132713324,0.020169578,407,350,757
330,MAIN,0.087789165,0.082590289,0.070554429,237,521,758
331,CHE,0.032758155,0.300047082,0.002889291,667,91,758
332,PG,0.040002636,0.213158111,0.024567237,580,178,758
333,TRGP,0.07155876,0.104830446,0.022727613,324,437,761
334,MTD,0.026096984,0.484308199,0.0,739,23,762
335,DEO,0.048326536,0.165387225,0.022791385,485,277,762
336,TPL,0.0246581,0.685228829,0.013660392,759,6,765
337,ZBRA,0.034586752,0.258995574,0.0,641,124,765
338,PFSI,0.158151085,0.049898788,0.018166652,104,664,768
339,PNR,0.064875112,0.110560137,0.01869763,354,417,771
340,PAGP,0.481900752,0.032984473,0.06712633,9,762,771
341,ADBE,0.029628873,0.32032358,0.0,697,75,772
342,BCH,0.158099717,0.049682287,0.06055378,105,667,772
343,FIX,0.059478538,0.119894776,0.004855317,391,384,775
344,CMI,0.059904123,0.118338807,0.023811262,384,392,776
345,IHG,0.035512911,0.23502994,0.022065355,627,151,778
346,DRI,0.049943968,0.144723691,0.029999951,465,313,778
347,ACN,0.033655725,0.265068547,0.013848098,657,122,779
348,KOF,0.068529062,0.103201294,0.041270812,335,444,779
349,QSR,0.074646073,0.092001939,0.048907785,301,479,780
350,AEL,0.285224769,0.033580254,0.017338592,26,759,785
351,IT,0.029972321,0.297149267,0.0,694,92,786
352,CL,0.026810839,0.368873383,0.025398952,734,52,786
353,SNY,0.059171188,0.116458439,0.036700225,392,396,788
354,LH,0.065385604,0.103878992,0.009978321,351,441,792
355,JWN,0.083077827,0.080799305,0.040352087,262,531,793
356,SBUX,0.033389227,0.245280614,0.023028351,661,138,799
357,ROST,0.036847014,0.203505812,0.010510253,606,196,802
358,IDXX,0.019905971,0.594829652,0.0,792,13,805
359,WST,0.033460803,0.236942346,0.003089656,660,147,807
360,EW,0.032953263,0.240505633,0.0,666,141,807
361,TSLA,0.032636206,0.245483471,0.0,670,137,807
362,NLY,0.198971286,0.038039739,0.175205789,69,741,810
363,BWA,0.099589877,0.061216492,0.016985138,210,601,811
364,THO,0.060178371,0.107641151,0.015430685,383,430,813
365,DGX,0.052129714,0.126528442,0.016807149,448,366,814
366,BSAC,0.125235167,0.049727329,0.073498973,150,665,815
367,UNH,0.040500935,0.18173045,0.012059697,576,240,816
368,HSY,0.034357645,0.218113735,0.01618916,647,169,816
369,MSFT,0.028537334,0.287573865,0.007808615,717,101,818
370,WF,0.375213339,0.021626208,0.078226693,14,804,818
371,VAC,0.064920304,0.094602717,0.018207111,353,468,821
372,ZTS,0.030764316,0.245620003,0.008891673,685,136,821
373,DG,0.047045774,0.143488513,0.009614167,503,319,822
374,CPA,0.10312339,0.057418073,0.0,200,623,823
375,CNI,0.046329723,0.146091414,0.018140829,513,311,824
376,FMC,0.046846139,0.143711763,0.017014721,508,318,826
377,SLB,0.045456131,0.153003182,0.011202208,525,302,827
378,AIG,0.208692122,0.030272533,0.020532088,60,768,828
379,WD,0.084282491,0.06891134,0.031591153,254,575,829
380,KEYS,0.035856701,0.199372291,0.0,620,209,829
381,MPWR,0.026924629,0.293394264,0.008487306,732,98,830
382,JNJ,0.038687495,0.181773272,0.025190754,591,239,830
383,HII,0.062592781,0.097086159,0.020756155,371,461,832
384,ABBV,0.041354061,0.165804863,0.035089459,564,274,838
385,HAL,0.044191564,0.151144612,0.012228582,534,307,841
386,SAN,0.206335158,0.027787158,0.039698841,63,779,842
387,MSCI,0.023177814,0.322294481,0.009928351,769,73,842
388,NJR,0.073922244,0.078816031,0.034337617,304,539,843
389,JBHT,0.053588771,0.111276443,0.009217027,432,412,844
390,POST,0.151674342,0.039640602,0.109696272,113,731,844
391,SHG,0.246940412,0.020593394,0.081969694,35,813,848
392,BIP,0.100371341,0.055548675,0.103510227,209,639,848
393,ORAN,0.087240725,0.0596924,0.075654702,240,609,849
394,HUM,0.042571458,0.153379449,0.00594726,549,300,849
395,COF,0.1873937,0.029387186,0.029993176,77,772,849
396,CPRT,0.029366562,0.23803728,0.0,704,145,849
397,HMC,0.116160287,0.046468057,0.035665891,164,686,850
398,PFG,0.228337545,0.021310318,0.030480756,46,805,851
399,XPO,0.048062481,0.126837463,0.0,489,365,854
400,CTAS,0.028089001,0.246390317,0.009375093,721,134,855
401,ABB,0.042787838,0.147530837,0.02935505,546,310,856
402,BXMT,0.068832676,0.08181218,0.116654169,331,526,857
403,MMS,0.057017036,0.10126506,0.019222004,405,452,857
404,UHS,0.065582951,0.086664509,0.005673782,350,508,858
405,SAIC,0.052122932,0.113425402,0.014420678,449,411,860
406,WAL,0.17716414,0.028268226,0.027848936,84,777,861
407,FTNT,0.021489318,0.307848616,0.0,784,80,864
408,GIS,0.051805199,0.111097173,0.025721854,452,413,865
409,AAP,0.05331103,0.107421933,0.035715815,434,431,865
410,HSIC,0.049505637,0.11702961,0.0,471,395,866
411,MPW,0.135346589,0.038681939,0.104747002,130,739,869
412,LYG,0.174427459,0.026202722,0.047129603,86,784,870
413,IVZ,0.11058434,0.045300312,0.068654294,178,693,871
414,MKTX,0.02394614,0.280877047,0.010138524,764,108,872
415,GILD,0.042620433,0.141140679,0.03442491,548,324,872
416,UNM,0.159634532,0.029716534,0.030877414,102,771,873
417,ROL,0.020490652,0.303018467,0.011763979,789,85,874
418,BAP,0.113036974,0.043480462,0.029189968,169,705,874
419,GD,0.048727869,0.116184748,0.01967801,478,398,876
420,MFG,0.583531265,0.011936418,0.220015784,5,872,877
421,BMO,0.162582083,0.02816034,0.03116647,99,778,877
422,DLTR,0.048130978,0.118971745,0.0,488,389,877
423,PEP,0.035738524,0.176019082,0.024756248,622,255,877
424,TEF,0.104782096,0.046867417,0.07278995,197,681,878
425,G,0.041423693,0.144068859,0.010764529,562,317,879
426,LDOS,0.047533035,0.119245945,0.013808867,494,387,881
427,MSI,0.031575466,0.201235764,0.012278061,680,201,881
428,SMFG,0.553914841,0.01186363,0.207311999,7,874,881
429,HLT,0.036116147,0.172487644,0.00353967,618,263,881
430,MCD,0.031827528,0.200949961,0.021475621,678,204,882
431,MMC,0.036936333,0.162849098,0.013781491,604,282,886
432,JKHY,0.030049579,0.202471929,0.012067253,691,198,889
433,STWD,0.168607637,0.023325668,0.114431472,94,795,889
434,RKT,0.829262414,0.008248278,0.0,3,887,890
435,K,0.042052672,0.134601136,0.034912479,554,342,896
436,PAA,0.125792114,0.035452934,0.094859627,147,749,896
437,COST,0.026046546,0.229137839,0.005178676,740,157,897
438,TXT,0.057145219,0.088964588,0.001128303,403,495,898
439,CDNS,0.019486909,0.283341184,0.0,795,105,900
440,DB,0.245612064,0.012821305,0.018048597,36,867,903
441,FDX,0.071739587,0.066778145,0.021258181,323,584,907
442,ROK,0.036865381,0.152208895,0.020833292,605,304,909
443,BMY,0.040843505,0.137835313,0.029914462,571,338,909
444,SHW,0.032991383,0.179122603,0.010101069,663,247,910
445,FCN,0.044017619,0.122932171,0.0,535,377,912
446,HDB,1.329161067,-0.00066128,0.231774465,2,911,913
447,BCE,0.052882148,0.093536122,0.063576585,442,473,915
448,BCO,0.067152585,0.069463971,0.014800335,345,571,916
449,SXT,0.046124815,0.115095343,0.022561994,517,400,917
450,C,0.168598841,0.019226104,0.056820478,95,823,918
451,VMI,0.035599015,0.157373239,0.006501149,626,293,919
452,HBAN,0.156070211,0.020967054,0.070433831,109,810,919
453,A,0.030314275,0.186943963,0.006043516,690,231,921
454,SPG,0.055419524,0.086644463,0.06715177,414,509,923
455,BCS,0.225194144,0.010233871,0.075140691,48,879,927
456,FSS,0.042825105,0.119660664,0.007754047,545,385,930
457,ENS,0.049583891,0.096041063,0.00804878,468,464,932
458,NKE,0.031043081,0.178815208,0.012319266,682,250,932
459,CACI,0.048662906,0.101215712,0.0,480,453,933
460,SNV,0.138850116,0.021023274,0.042010522,127,807,934
461,NYCB,0.156287975,0.018880216,0.084155064,108,827,935
462,VIV,0.063768569,0.068054245,0.089123714,358,578,936
463,AMGN,0.046369322,0.107921673,0.029695616,512,428,940
464,FFIV,0.040911414,0.125165274,0.0,569,371,940
465,ALLY,0.220134167,0.006970484,0.063445904,53,888,941
466,BBVA,0.178183649,0.013953756,0.060643501,83,861,944
467,CLX,0.007580539,0.30387289,0.029660766,860,84,944
468,NI,0.07203466,0.057338026,0.039112464,320,625,945
469,IGT,0.060733287,0.070999647,0.035172875,379,566,945
470,MNST,0.022282257,0.217349252,0.0,775,170,945
471,HPE,0.046682202,0.106188695,0.033398212,510,435,945
472,HON,0.033472659,0.16045067,0.018327056,659,287,946
473,ABT,0.035651958,0.141851431,0.017016058,625,322,947
474,PAYC,0.015653909,0.248236616,0.0,815,132,947
475,LNC,0.258460596,-0.00758096,0.059000578,30,918,948
476,KO,0.034659857,0.149358562,0.027663956,640,308,948
477,NEP,0.208795331,0.005752946,0.118460152,59,890,949
478,KNX,0.090700938,0.040993138,0.009207852,230,720,950
479,RMD,0.027989492,0.188859995,0.008054109,725,227,952
480,AFL,0.096740296,0.039059505,0.021437019,216,736,952
481,IX,0.105802051,0.033924569,0.041181727,194,758,952
482,CI,0.059546173,0.071363131,0.012359314,389,564,953
483,DHR,0.042252771,0.114374482,0.004794391,551,403,954
484,SNX,0.066858885,0.06077754,0.011799599,347,607,954
485,FNF,0.109806196,0.028954207,0.047266928,181,774,955
486,KB,0.231506322,-0.001443785,0.075736364,43,912,955
487,CMA,0.127622065,0.020463532,0.041690614,141,816,957
488,MDU,0.059551241,0.070161045,0.028668049,388,569,957
489,BNS,0.125680388,0.021014329,0.064868115,148,809,957
490,IEX,0.033955119,0.151238854,0.010263483,652,306,958
491,BR,0.032347335,0.160468862,0.016979016,672,286,958
492,SKX,0.057137932,0.074416806,0.0,404,554,958
493,NGG,0.067343966,0.05838429,0.03987537,343,617,960
494,AXP,0.067717944,0.057561335,0.01410415,340,621,961
495,NDAQ,0.037180471,0.1299759,0.012657885,602,359,961
496,ACM,0.043081642,0.110303283,0.006575849,544,420,964
497,FDS,0.028085383,0.181038613,0.008315273,722,243,965
498,LLY,0.018929883,0.220307496,0.010718082,799,166,965
499,ORI,0.09421456,0.037313614,0.079569027,222,744,966
500,NYT,0.031903465,0.157707198,0.010418319,676,292,968
501,RCI,0.052462201,0.0817681,0.031539776,443,527,970
502,VC,0.033729354,0.143462898,0.0,656,320,976
503,SSL,0.060312332,0.062362351,0.0,381,596,977
504,WRB,0.06859673,0.054552734,0.011681881,334,644,978
505,SF,0.104219627,0.027246363,0.026918885,198,780,978
506,HST,0.055182947,0.071520856,0.013076528,418,563,981
507,SIVB,0.123165154,0.018441473,0.012007129,151,831,982
508,NFLX,0.034254837,0.138522023,0.0,649,334,983
509,MFC,0.155712379,0.01189482,0.060416316,110,873,983
510,R,0.224136618,-0.030978436,0.031797928,50,934,984
511,GS,0.094617922,0.031319375,0.030937145,220,766,986
512,TD,0.110468621,0.021021395,0.042244154,179,808,987
513,RF,0.111366861,0.02056436,0.037800244,174,814,988
514,SR,0.068123758,0.052806561,0.048346888,337,652,989
515,CW,0.045919565,0.094532372,0.004489649,521,469,990
516,CMG,0.023266863,0.193219389,0.0,768,222,990
517,CM,0.111346919,0.020522112,0.053203062,175,815,990
518,CRL,0.043915179,0.099977961,0.0,536,455,991
519,BRO,0.042491096,0.103861617,0.00755833,550,442,992
520,VTRS,0.15407682,0.009677419,0.043111267,111,882,993
521,VAL,0.034755985,0.13035358,0.0,639,356,995
522,AFG,0.076866925,0.043459491,0.103830267,289,707,996
523,ABMD,0.00906817,0.242806215,0.0,857,139,996
524,KEY,0.119050551,0.017481171,0.053035561,160,837,997
525,APD,0.043666964,0.098572079,0.026773863,539,458,997
526,HRL,0.039507312,0.110875291,0.022039006,584,414,998
527,HSBC,0.129629214,0.013885624,0.056346468,136,862,998
528,BUD,0.049387509,0.081300403,0.020205109,473,528,1001
529,UBS,0.125308543,0.015671089,0.027397385,149,853,1002
530,FITB,0.108258439,0.020041747,0.041028444,185,818,1003
531,SKM,0.053615163,0.069301407,0.053122731,431,574,1005
532,SJR,0.04542356,0.091719298,0.035197313,526,480,1006
533,EXR,0.043624201,0.095635187,0.040817403,540,466,1006
534,CHT,0.041834453,0.10234824,0.040996273,559,449,1008
535,ZION,0.122947271,0.01514465,0.036463965,153,855,1008
536,TFC,0.109538218,0.01877093,0.052301874,182,828,1010
537,EPR,0.062321165,0.055655237,0.093947664,374,636,1010
538,WM,0.034558335,0.124754384,0.01663062,642,374,1016
539,WNS,0.030589245,0.139346993,0.0,687,330,1017
540,HIG,0.073691866,0.042656702,0.021397032,307,711,1018
541,FLO,0.037639151,0.110317405,0.030735218,599,419,1018
542,VLY,0.103610772,0.019340075,0.039915167,199,822,1021
543,CFG,0.110627628,0.016332201,0.047602433,177,846,1023
544,BX,0.054393382,0.061348122,0.118631502,425,600,1025
545,ASB,0.106302553,0.017586651,0.039091496,193,835,1028
546,MCO,0.026815921,0.157257391,0.010051091,733,295,1028
547,EPAM,0.022337221,0.175666561,0.0,774,257,1031
548,WMB,0.051117513,0.069310796,0.051666359,459,573,1032
549,TGT,0.035701228,0.113728388,0.023578221,624,410,1034
550,RY,0.08935283,0.021705291,0.03937544,233,803,1036
551,WMT,0.029803378,0.135285664,0.015600844,696,341,1037
552,SCI,0.051845529,0.064998373,0.014676352,451,588,1039
553,BMI,0.02087368,0.177164196,0.007810365,788,252,1040
554,SNPS,0.021996824,0.174911208,0.0,780,260,1040
555,FUL,0.041893492,0.091393937,0.009109261,557,483,1040
556,BP,-0.01227594,0.236718808,0.039424131,894,148,1042
557,AME,0.036050185,0.109732217,0.006285438,619,423,1042
558,SEM,0.052267163,0.061946882,0.021232775,445,599,1044
559,JBT,0.044721066,0.085791431,0.004482372,530,514,1044
560,ADSK,0.017708613,0.181868334,0.0,807,238,1045
561,ST,0.049558023,0.067151161,0.008146603,469,580,1049
562,J,0.046138347,0.080445598,0.008306405,516,534,1050
563,CME,0.044611198,0.082654118,0.043657967,532,520,1052
564,AEM,0.052898892,0.058894193,0.048010166,440,614,1054
565,OHI,0.067070352,0.043025641,0.099427669,346,709,1055
566,PPG,0.034371081,0.113961181,0.019095045,646,409,1055
567,BAC,0.097860598,0.016890151,0.030487231,214,843,1057
568,FNB,0.096144152,0.016950606,0.039192554,218,842,1060
569,AIN,0.030044714,0.126505742,0.008303224,692,368,1060
570,ATR,0.033267194,0.115410972,0.01382764,662,399,1061
571,MLM,0.04116733,0.089068497,0.007556209,567,494,1061
572,STT,0.097762284,0.016069534,0.034255566,215,849,1064
573,CBOE,0.017619545,0.175688647,0.01570014,808,256,1064
574,OUT,0.055371732,0.052901589,0.077048698,415,651,1066
575,MGA,0.036286356,0.101661604,0.031505384,615,451,1066
576,TDG,0.028352054,0.132785804,0.03571835,719,349,1068
577,ALGN,0.021926444,0.159767632,0.0,781,289,1070
578,OGS,0.055115407,0.05312862,0.033295132,421,650,1071
579,PNC,0.089575415,0.017078112,0.039916738,231,841,1072
580,AKAM,0.039047356,0.090356217,0.0,586,486,1072
581,TU,0.048453545,0.064547143,0.035642608,483,590,1073
582,CCZ,0.036387642,0.096269203,0.032125477,612,462,1074
583,CMCSA,0.036387642,0.096269203,0.032125477,612,462,1074
584,NVS,0.03515106,0.103573319,0.037935853,632,443,1075
585,CVS,0.035259397,0.102504746,0.023776169,629,448,1077
586,ENPH,0.011080286,0.183258308,0.0,843,235,1078
587,EDR,0.085976259,0.017702909,0.0,244,834,1078
588,GLW,0.049761177,0.059118566,0.035241198,467,613,1080
589,USB,0.08851576,0.016322529,0.046727204,235,847,1082
590,PRI,0.068285791,0.036007723,0.015547806,336,747,1083
591,RSG,0.036434704,0.093197883,0.014521468,610,474,1084
592,ORCL,0.028978667,0.123753302,0.012500735,708,376,1084
593,PB,0.07786526,0.021090274,0.02867195,281,806,1087
594,ATO,0.055164468,0.04954076,0.026778344,419,669,1088
595,TRI,0.032965801,0.109036861,0.014622351,665,424,1089
596,GL,0.062659206,0.040845453,0.006823014,369,721,1090
597,CNP,0.056033516,0.046839949,0.02592279,413,682,1095
598,CUZ,0.073661919,0.025717791,0.050647229,308,787,1095
599,LEA,0.044725737,0.070894609,0.025317742,529,567,1096
600,JPM,0.094597479,0.011238945,0.034051678,221,876,1097
601,VFC,0.013348567,0.172116692,0.079116802,833,266,1099
602,TDY,0.042135549,0.075756395,0.0,553,547,1100
603,SLF,0.088143695,0.013230159,0.045375266,236,866,1102
604,PYPL,0.029432564,0.114142075,0.0,703,405,1108
605,FNV,0.02680602,0.124790925,0.007560476,735,373,1108
606,MTB,0.084129801,0.015398954,0.037214981,256,854,1110
607,NWE,0.060996271,0.039286611,0.046684479,377,733,1110
608,TMO,0.032195231,0.104682199,0.002107745,674,440,1114
609,TRV,0.063958404,0.03319833,0.019556599,357,760,1117
610,EA,0.024037417,0.130921958,0.006294087,762,355,1117
611,EFX,0.02926481,0.11077659,0.0080329,705,415,1120
612,EVRG,0.052231043,0.048745773,0.037110618,446,674,1120
613,DAL,0.062867642,0.034855614,0.0,366,754,1120
614,CX,0.093703336,0.003588345,0.0,223,897,1120
615,PH,0.041601648,0.072617688,0.014061789,560,560,1120
616,ESI,0.041988449,0.071348672,0.017584906,555,565,1120
617,PENN,0.046390288,0.059595923,0.0,511,611,1122
618,COTY,0.048705173,0.05478196,0.001312989,479,643,1122
619,TRMB,0.035777888,0.087981539,0.0,621,501,1122
620,ING,0.082893713,0.014335602,0.069785044,263,859,1122
621,LNT,0.049522859,0.052134831,0.030897644,470,654,1124
622,BXP,0.055299487,0.043381813,0.06492677,416,708,1124
623,CB,0.057373682,0.040726435,0.014848261,401,723,1124
624,WBS,0.081275206,0.014709097,0.032986772,268,856,1124
625,BLK,0.048416387,0.054885072,0.027957705,484,642,1126
626,NWL,0.036230845,0.086606441,0.070806473,616,510,1126
627,TR,0.025916679,0.119265166,0.008405677,741,386,1127
628,BK,0.069691573,0.022293827,0.037269959,329,799,1128
629,STN,0.034345457,0.090409861,0.010873744,648,485,1133
630,POR,0.053254587,0.044293205,0.036112552,436,698,1134
631,ENLC,0.085072763,0.008308041,0.037617555,249,886,1135
632,GMED,0.025485562,0.118915115,0.0,746,390,1136
633,FLS,0.047081284,0.055594065,0.026086848,501,638,1139
634,BABA,0.039533616,0.07337246,0.012378867,583,557,1140
635,KMI,0.062690927,0.028742003,0.061608352,368,775,1143
636,PTC,0.025539927,0.114855161,0.0,744,402,1146
637,ETN,0.03934418,0.072482987,0.020758769,585,561,1146
638,MTN,0.028715415,0.104855888,0.033663091,711,436,1147
639,IRM,0.03842049,0.073815277,0.049968206,592,556,1148
640,WEC,0.047656722,0.051640988,0.031039598,493,657,1150
641,AJG,0.029157254,0.102815544,0.011239491,706,447,1153
642,HWM,0.028604071,0.10475322,0.002683538,714,439,1153
643,RZA,0.077153491,0.012052933,0.025225623,285,869,1154
644,FRC,0.075468825,0.014708239,0.015773664,297,857,1154
645,NMR,0.060967007,0.028670441,0.03762521,378,776,1154
646,RGA,0.077153491,0.012052933,0.025225623,285,869,1154
647,WFC,0.078597222,0.009569527,0.031559331,275,883,1158
648,FHN,0.068662979,0.01898047,0.027160023,333,826,1159
649,CFR,0.068053051,0.019506766,0.025434556,338,821,1159
650,PNW,0.05618429,0.034917312,0.044017932,410,752,1162
651,IPGP,0.022871293,0.118813076,0.0,772,391,1163
652,SAM,0.016572557,0.132603538,0.0,812,351,1163
653,ES,0.048320126,0.04734175,0.029839112,486,678,1164
654,SRC,0.053143924,0.040304288,0.06678728,438,726,1164
655,TECH,0.022233157,0.119092512,0.00391917,776,388,1164
656,MS,0.076713435,0.011377927,0.037567256,290,875,1165
657,INTU,0.01658,0.130929554,0.006182726,811,354,1165
658,INCY,0.019104543,0.125301094,0.0,796,370,1166
659,ED,0.049283674,0.045453758,0.032331277,475,692,1167
660,ATI,0.034382675,0.082517161,0.008930565,645,523,1168
661,RJF,0.081754217,0.0,0.0,264,905,1169
662,BOH,0.073516818,0.013316083,0.039210663,309,865,1174
663,FISV,0.038972686,0.06514431,0.053314018,588,586,1174
664,NTRS,0.072477556,0.014592674,0.04322071,317,858,1175
665,CP,0.037450214,0.068253607,0.007528377,601,577,1178
666,AVB,0.050118663,0.041523984,0.039240099,463,715,1178
667,IDA,0.047402516,0.046775177,0.028239769,496,683,1179
668,WTW,0.036834282,0.069334903,0.013470614,607,572,1179
669,VEEV,0.018979777,0.120893179,0.0,798,382,1180
670,VMW,0.025375708,0.107290672,0.043451555,750,432,1182
671,DTE,0.047254711,0.046600906,0.029888714,499,684,1183
672,MKC,0.029852999,0.089099819,0.01736464,695,493,1188
673,AOS,0.027237564,0.097201952,0.020477286,729,460,1189
674,BKH,0.056640437,0.025918376,0.03435317,406,785,1191
675,KHC,0.047344785,0.044597165,0.039270325,498,697,1195
676,AEP,0.047473844,0.044139566,0.033852275,495,700,1195
677,EXC,0.050909354,0.039120583,0.031296349,460,735,1195
678,CPT,0.054291991,0.029984123,0.032961793,427,769,1196
679,APTV,0.034444602,0.074137121,0.002497135,643,555,1198
680,LW,0.012615404,0.129159764,0.008690751,838,361,1199
681,PCG,0.056146007,0.025569729,0.0,411,789,1200
682,RHP,0.028644642,0.089843225,0.001300182,712,488,1200
683,IQV,0.02838384,0.091047118,0.0,718,484,1202
684,CNA,0.077852538,-0.009380025,0.085515875,282,921,1203
685,HAE,0.027461434,0.092710734,0.0,727,476,1203
686,ATHM,0.073842062,0.001611784,0.016010864,305,900,1205
687,AXTA,0.033931329,0.07469905,0.0,653,553,1206
688,L,0.071447362,0.009324143,0.00430661,326,884,1210
689,HHC,0.047803957,0.040791981,0.0,490,722,1212
690,DUK,0.049317611,0.038817226,0.04008711,474,738,1212
691,AEE,0.046742541,0.043864729,0.026548371,509,704,1213
692,SO,0.046049182,0.045062811,0.03786845,520,694,1214
693,FTV,0.032980038,0.075010446,0.004345225,664,550,1214
694,BEN,0.073416554,0.0,,310,905,1215
695,WEX,0.027724389,0.089747366,0.0,726,490,1216
696,WAB,0.034808177,0.067180544,0.006103804,638,579,1217
697,SYK,0.025501233,0.092900821,0.011366326,745,475,1220
698,PVH,0.034959637,0.065138654,0.001761938,633,587,1220
699,FMS,0.074981721,-0.008821764,0.044070534,300,920,1220
700,AA,0.007168833,0.129467697,0.008748407,862,360,1222
701,TFX,0.031018572,0.07873937,0.005448723,683,540,1223
702,KBR,0.02588838,0.091588785,0.008992806,742,481,1223
703,ETR,0.047700273,0.039267511,0.03739005,492,734,1226
704,ANSS,0.024902225,0.094463206,0.0,756,470,1226
705,LYV,0.026099458,0.089747553,0.0,738,489,1227
706,STZ,-0.000893855,0.13104545,0.013644637,875,353,1228
707,XEL,0.045267074,0.04405734,0.02638841,527,701,1228
708,INTC,0.073811111,-0.012871129,0.055233994,306,924,1230
709,HE,0.052898765,0.024059335,0.033764026,441,792,1233
710,KMX,0.04421578,0.044030824,0.0,533,702,1235
711,NVDA,0.009165708,0.122013923,0.000835154,855,380,1235
712,RTX,0.034900871,0.060985386,0.021006335,634,602,1236
713,TRNO,0.046118652,0.041321065,0.025016668,518,718,1236
714,BAH,0.022186906,0.096022046,0.01924284,777,465,1242
715,H,0.04610819,0.040221607,0.0,519,727,1246
716,CBU,0.055284414,0.018657856,0.027450118,417,829,1246
717,VOYA,0.065102288,0.004853875,0.015190534,352,894,1246
718,FR,0.04185371,0.045909291,0.024379429,558,688,1246
719,TDC,0.009499924,0.116256158,0.0,852,397,1249
720,EBAY,-0.055055561,0.141745582,0.021132001,930,323,1253
721,ISRG,0.013966451,0.109002394,0.0,829,426,1255
722,PNM,0.040471765,0.047061034,0.028520245,577,680,1257
723,OFC,0.059517945,0.012077906,0.042531,390,868,1258
724,OSK,0.030013518,0.070239982,0.016793072,693,568,1261
725,WPC,0.038402945,0.049611723,0.053537374,593,668,1261
726,MDT,0.031071895,0.06697437,0.029897811,681,582,1263
727,XYL,0.017815388,0.097767997,0.01088997,806,459,1265
728,LIN,0.025441111,0.084980769,0.014380025,748,517,1265
729,LHX,0.025338398,0.085483638,0.02061429,751,515,1266
730,AMRC,0.032045834,0.06441061,0.0,675,592,1267
731,PWR,0.024022499,0.08670169,0.002008017,763,506,1269
732,PEAK,0.037048502,0.048778462,0.047975259,603,673,1276
733,SJI,0.034820965,0.054953652,0.052705591,636,641,1277
734,EXPE,0.025647626,0.080126124,0.004881792,743,535,1278
735,PKI,0.032703896,0.059130452,0.001995733,668,612,1280
736,DXCM,0.007737724,0.110122734,0.0,859,421,1280
737,IBN,0.04087533,0.042929729,0.002254939,570,710,1280
738,ARES,0.036539835,0.049264722,0.06962761,609,671,1280
739,DD,0.03101246,0.060928845,0.01905761,684,604,1288
740,MDLZ,0.029582867,0.06492743,0.021612805,699,589,1288
741,SBAC,0.015248091,0.093586375,0.010137196,820,471,1291
742,GHC,0.023018733,0.082229825,0.010539086,770,524,1294
743,CNC,0.025481534,0.075114655,0.0,747,548,1295
744,UNF,0.031899397,0.058018991,0.006799937,677,618,1295
745,CCI,0.028585335,0.067007461,0.044405398,715,581,1296
746,WCN,0.024492737,0.079515631,0.007122561,760,537,1297
747,AU,0.036396047,0.045612089,0.024876759,611,691,1302
748,CHD,0.021138735,0.083470636,0.013023381,786,519,1305
749,WTM,-0.047733659,0.122509876,0.000750529,928,378,1306
750,ARMK,0.033547431,0.053266845,0.019512584,658,649,1307
751,APO,0.053469873,0.011076198,0.025792259,433,877,1310
752,IR,0.028554665,0.062427913,0.001529967,716,595,1311
753,SCHW,0.045767596,0.025002058,0.013444192,522,790,1312
754,CAG,0.028241145,0.06242938,0.037387152,720,594,1314
755,AWR,0.022921565,0.077318341,0.01647747,771,543,1314
756,PSO,0.035198626,0.046364414,0.022690024,630,687,1317
757,SPGI,0.030600376,0.055857309,0.009647409,686,631,1317
758,HXL,0.025428131,0.069870389,0.006784862,749,570,1319
759,VMC,0.024714862,0.071652357,0.009128526,758,562,1320
760,ELS,0.015186827,0.086668654,0.02591042,821,507,1328
761,ENB,0.028015543,0.060863616,0.068159026,723,606,1329
762,PEG,0.033789475,0.048004187,0.035362603,654,677,1331
763,EL,0.014313275,0.087860262,0.013160815,827,504,1331
764,PBH,-0.026341729,0.108194327,0.0,907,427,1334
765,ASH,0.035293796,0.043462898,0.013649535,628,706,1334
766,REG,0.032322267,0.050053206,0.040494052,673,663,1336
767,SAP,0.01515802,0.085398845,0.025337063,822,516,1338
768,AXS,0.048527078,0.014023562,0.039066296,481,860,1341
769,RE,0.046209111,0.018595487,0.01973756,514,830,1344
770,CTVA,0.02707192,0.05860576,0.009865791,730,616,1346
771,FAF,0.046961099,0.016817127,0.038747371,505,844,1349
772,KRC,0.038790897,0.032439987,0.054806491,590,763,1353
773,FRT,0.03260085,0.046536099,0.044443651,671,685,1356
774,PPL,0.035151822,0.040354793,0.036593232,631,725,1356
775,AWK,0.029559733,0.05096893,0.016834628,700,659,1359
776,SWX,-0.399947836,0.117238993,0.039579424,967,394,1361
777,BURL,0.015634245,0.076533985,0.0,816,545,1361
778,PLD,0.03799129,0.031492168,0.029031183,598,765,1363
779,CUBE,0.022001575,0.065383337,0.042758307,779,585,1364
780,EGP,0.029518925,0.049489537,0.030748312,701,670,1371
781,WHR,-0.188678911,0.110515501,0.049319555,955,418,1373
782,SJM,-0.005515944,0.089659892,0.025990792,882,492,1374
783,ESS,0.029618721,0.04831078,0.041051505,698,676,1374
784,NNN,0.023364909,0.060650559,0.047620566,767,608,1375
785,ROP,0.021539247,0.063287986,0.005732289,783,593,1376
786,HAS,0.025205212,0.057372435,0.047722694,753,624,1377
787,EBR,0.039745458,0.023305989,0.0,582,796,1378
788,COO,0.028624155,0.049705741,0.000222583,713,666,1379
789,TEL,0.049085178,0.0,0.018631808,476,905,1381
790,TRP,0.013931142,0.074701614,0.061423671,830,552,1382
791,RYN,0.030547613,0.04488238,0.047261806,688,696,1384
792,BDX,0.028012367,0.050572879,0.017037314,724,660,1384
793,ICE,0.025214564,0.055726526,0.014874151,752,635,1387
794,MHK,0.003869691,0.084306752,0.0,870,518,1388
795,GLOB,0.021200348,0.060886047,0.0,785,605,1390
796,ALE,0.03884243,0.021894476,0.043161543,589,802,1391
797,CAH,0.010574178,0.074863557,0.021269898,845,551,1396
798,EDU,0.028890584,0.045888426,0.0,709,689,1398
799,BRX,0.023790536,0.055779683,0.042595481,766,634,1400
800,RPM,0.047051424,9.05e-05,0.021025806,502,901,1403
801,CMS,0.045731782,0.010004409,0.029832202,523,881,1404
802,FE,0.016953583,0.06223013,0.037206016,809,597,1406
803,SRE,0.032670095,0.038674918,0.06118897,669,740,1409
804,STOR,0.028880643,0.044142421,0.042834828,710,699,1409
805,TM,0.009509413,0.072885925,0.002824057,851,559,1410
806,CALX,0.009471033,0.073129065,0.0,853,558,1411
807,TAP,-0.016689504,0.081928075,0.029468384,898,525,1423
808,AIZ,0.040678243,0.015862685,0.022089198,573,852,1425
809,ECL,0.026297335,0.0457172,0.014520503,737,690,1427
810,CIEN,0.020957577,0.055300395,0.0,787,640,1427
811,PHI,0.038247415,0.017798812,0.092052791,595,833,1428
812,T,-0.052104944,0.088012,0.074731255,929,500,1429
813,MET,0.043679779,0.004659406,0.030673905,538,895,1433
814,BFAM,0.021904042,0.052309071,0.0,782,653,1435
815,NCR,0.018749139,0.055612419,0.00499977,800,637,1437
816,AES,-0.022963657,0.080540914,0.022328717,905,532,1437
817,PDI,0.035733333,0.020032248,0.153051757,623,819,1442
818,DV,0.012022734,0.060967775,0.0,840,603,1443
819,FLR,0.014893886,0.057878704,0.007957008,824,619,1443
820,SNN,0.018594273,0.054538844,0.027266042,801,645,1446
821,EIX,0.033994493,0.021907407,0.047402515,651,800,1451
822,CWT,0.029147549,0.035898858,0.016450085,707,748,1455
823,LUV,0.026995474,0.04069465,0.0,731,724,1455
824,AZN,0.015663945,0.053526143,0.020789981,814,648,1462
825,NE,0.01786417,0.050083564,0.0,805,662,1467
826,TYL,0.012262023,0.056415135,0.0,839,628,1467
827,F,-0.046098329,0.077984882,0.043035104,927,541,1468
828,BSX,0.010545521,0.057522587,0.000830951,846,622,1468
829,LUMN,-0.294339177,0.086786993,0.148310438,963,505,1468
830,TEVA,-0.232436384,0.085963672,0.0,958,513,1471
831,CAE,0.014888963,0.053581922,0.0,825,647,1472
832,SWK,0.015300259,0.051996392,0.042369949,818,655,1473
833,SWH,0.015300259,0.051996392,0.042369949,818,655,1473
834,ZBH,0.008658883,0.056880018,0.007528813,858,627,1485
835,ADC,0.027321854,0.033007564,0.040819052,728,761,1489
836,PANW,0.00580172,0.057262405,0.0,865,626,1491
837,RBC,0.02489578,0.039025131,0.003420837,757,737,1494
838,KWR,-0.00598003,0.058633407,0.01010933,884,615,1499
839,SMG,-0.184394921,0.075939872,0.070048996,954,546,1500
840,ADT,0.025097197,0.036813042,0.018423954,755,745,1500
841,BAK,-0.041738787,0.066894241,0.068717822,921,583,1504
842,HIW,0.019914271,0.042059341,0.072305466,791,713,1504
843,LXP,0.040571938,-0.035721531,0.050797736,574,936,1510
844,FMX,0.009094439,0.050240494,0.006430797,856,661,1517
845,AER,-0.09817252,0.068646643,0.0,943,576,1519
846,AGO,0.033749285,0.012052485,0.017418986,655,871,1526
847,AMT,0.018059385,0.039948983,0.026901918,803,729,1532
848,DIS,0.018298793,0.039637255,0.0,802,732,1534
849,NOW,0.00416441,0.04867014,0.0,869,675,1544
850,EQIX,0.011742911,0.042164557,0.019197241,841,712,1553
851,NOV,0.019025175,0.034294622,0.009573959,797,757,1554
852,O,0.022404936,0.027129551,0.046732726,773,781,1554
853,STAG,0.018044469,0.034868305,0.046198003,804,753,1557
854,BKR,-0.01983112,0.05128538,0.025492253,901,658,1559
855,NEE,0.019540891,0.030860557,0.02017901,794,767,1561
856,CZR,-0.058860532,0.05635309,0.0,932,629,1561
857,GPN,0.001990468,0.044998931,0.009462393,871,695,1566
858,HASI,0.016366606,0.034545565,0.052133212,813,756,1569
859,AGI,0.009345838,0.041405378,0.008842019,854,717,1571
860,SUI,0.014079099,0.036241487,0.025260929,828,746,1574
861,TMUS,0.014802796,0.03506506,0.0,826,751,1577
862,BEP,0.0197776,0.025670663,0.131134089,793,788,1581
863,AMH,0.016637559,0.029238998,0.025607577,810,773,1583
864,KEX,0.031653354,-3.24e-05,0.0,679,909,1588
865,ALK,0.010664408,0.034599243,0.0,844,755,1599
866,FTI,-0.006661307,0.041669829,0.0,887,714,1601
867,CRM,0.001248303,0.04009156,0.0,873,728,1601
868,ARE,0.022152234,0.019091734,0.03217743,778,824,1602
869,AUY,-0.26170857,0.053687563,0.021493337,961,646,1607
870,AMZN,-0.003214286,0.039859152,0.0,880,730,1610
871,NEM,-0.013501686,0.041090111,0.046588823,895,719,1614
872,NU,-0.019155678,0.041503281,0.0,899,716,1615
873,PUK,0.02654775,0.010114442,0.012608851,736,880,1616
874,QRVO,0.010167019,0.029850688,0.0,849,770,1619
875,THG,0.024113276,0.013365497,0.022637377,761,863,1624
876,REXR,0.013813222,0.024020376,0.0239272,831,793,1624
877,DOC,0.011528937,0.026258912,0.063868457,842,783,1625
878,D,0.020012402,0.017578448,0.044474242,790,836,1626
879,XRAY,-0.138453287,0.047273289,0.015156991,947,679,1626
880,KIM,-0.000947312,0.031730569,0.041784528,876,764,1640
881,ELP,0.010539782,0.023215447,0.020546465,847,797,1644
882,STE,0.005611961,0.026926218,0.009621449,866,782,1648
883,AMD,0.013055609,0.020649883,0.0,837,812,1649
884,UDR,0.006977186,0.023628961,0.039171019,863,794,1657
885,RS,0.025155703,0.0,0.0,754,905,1659
886,MTZ,0.00521754,0.022849629,0.0,867,798,1665
887,DLB,0.023885853,0.0,0.009678592,765,905,1670
888,NWSA,0.013117675,0.01711819,0.015318627,835,839,1674
889,NWS,0.013117675,0.01711819,0.015318627,835,839,1674
890,KGC,0.005842767,0.02077782,0.029404773,864,811,1675
891,KSS,-0.005028051,0.02190561,0.063247592,881,801,1682
892,WELL,0.004661108,0.020053327,0.037348776,868,817,1685
893,DLR,0.01316136,0.015901295,0.050525988,834,851,1685
894,DEI,-0.019465835,0.025772719,0.071413433,900,786,1686
895,AL,-0.022623223,0.024896966,0.029135467,904,791,1695
896,PGR,0.009518153,0.016667572,0.003440519,850,845,1695
897,VTR,-0.002273985,0.019734699,0.040018428,877,820,1697
898,BIO,-0.289639864,0.037316753,5.444138924,962,743,1705
899,DNB,0.000304138,0.017910697,0.008154706,874,832,1706
900,CCJ,0.007182235,0.016149997,0.00416999,861,848,1709
901,FIS,-0.40769715,0.035129851,0.027768695,968,750,1718
902,ORA,0.013580145,0.005642424,0.005598425,832,893,1725
903,AAL,0.015352277,-0.003470615,0.429017574,817,914,1731
904,MAC,-0.026878276,0.019071967,0.076955322,908,825,1733
905,MKL,-0.00565648,0.016039782,0.002012127,883,850,1733
906,PRGO,-0.028548965,0.017448024,0.031057086,909,838,1747
907,GRMN,0.010469173,0.0,,848,905,1753
908,GE,-0.011103461,0.013326352,0.008913457,892,864,1756
909,KRG,-0.002635575,0.009254169,0.038951173,878,885,1763
910,MGM,0.015067298,-0.044057246,0.000295033,823,941,1764
911,HP,0.001776085,0.005704264,0.027433143,872,892,1764
912,HL,-0.01205228,0.010295026,0.004173184,893,878,1771
913,DNP,-0.006206065,0.002128325,0.077335261,885,899,1784
914,MBLY,-0.00293913,-0.000531314,0.012079107,879,910,1789
915,HR,-0.021797281,0.005910976,0.289407754,903,889,1792
916,KKR,-0.029418469,0.005739273,0.014754561,911,891,1802
917,CDAY,-0.007481307,-0.010136832,0.0,888,922,1810
918,MANU,-0.009167261,-0.014132685,0.0,891,925,1816
919,WDAY,-0.007932828,-0.025084465,0.0,889,932,1821
920,TWTR,-0.006502209,-0.038750598,0.0,886,939,1825
921,PRU,-0.036509133,-0.001559288,0.047181433,915,913,1828
922,HUBS,-0.00811317,-0.061186651,0.0,890,943,1833
923,CTLT,-0.029561069,-0.014770889,0.0,912,926,1838
924,KMPR,-0.095261937,0.003387287,0.025207093,941,898,1839
925,GPS,-0.04169763,-0.008487085,0.045413261,920,919,1839
926,TAL,-0.028933945,-0.023025061,0.0,910,930,1840
927,CINF,-0.029890159,-0.021558984,0.026015509,913,929,1842
928,ENV,-0.025098302,-0.036986143,0.0,906,937,1843
929,ALL,-0.037090697,-0.015065952,0.028035564,916,927,1843
930,GWRE,-0.016047553,-0.090346646,0.0,897,951,1848
931,AEG,-0.085288416,-0.004058917,0.013895771,938,915,1853
932,SNOW,-0.015994626,-0.147023158,0.0,896,962,1858
933,CVT,-0.038440373,-0.040667179,0.0,918,940,1858
934,RIG,-0.213789969,5.3e-05,0.0,957,902,1859
935,LVS,-0.041959969,-0.037271875,0.0,922,938,1860
936,PHG,-0.130723182,-0.005098005,0.033286743,945,916,1861
937,WYNN,-0.075702347,-0.021294629,0.000154208,935,928,1863
938,VNO,-0.095872602,-0.011371494,0.1174385,942,923,1865
939,STX,-0.041305246,-0.068896052,0.045443579,919,948,1867
940,WK,-0.020453367,-0.215091596,0.0,902,967,1869
941,COUP,-0.037241024,-0.092940938,0.0,917,952,1869
942,CS,-1.000265352,0.003799,0.038334834,974,896,1870
943,BAX,-0.094243112,-0.023320024,0.022305371,940,931,1871
944,BA,-0.044589556,-0.075178541,0.0,923,949,1872
945,TV,-0.244532022,-0.005607294,0.020952843,959,917,1876
946,RNR,-0.146270411,-0.028932792,0.012620473,951,933,1884
947,TTWO,-0.058958685,-0.094434037,0.0,933,953,1886
948,RCL,-0.166779323,-0.033644267,0.0,952,935,1887
949,NEWR,-0.035128464,-0.43017642,0.0,914,973,1887
950,DXC,-0.09889235,-0.061831488,0.0,944,944,1888
951,GME,-0.04510329,-0.174096827,0.0,924,965,1889
952,SE,-0.057471989,-0.112501569,0.0,931,960,1891
953,GOL,-0.068362527,-0.103655214,0.0,934,959,1893
954,MU,-0.076303803,-0.096572476,0.006593025,936,957,1893
955,HCP,-0.045820091,-0.238307932,0.0,926,969,1895
956,TTM,-0.077412565,-0.101220175,1.04e-05,937,958,1895
957,WDC,-0.141438963,-0.067649381,0.0,950,947,1897
958,ETSY,-0.045720325,-0.328753009,0.0,925,972,1897
959,SPR,-0.175895303,-0.062604748,0.001356519,953,945,1898
960,ZNH,-0.197684061,-0.046786133,0.0,956,942,1898
961,WBA,-0.140976635,-0.095460031,0.075935142,949,954,1903
962,S,-0.090332519,-0.225452696,0.0,939,968,1907
963,CEA,-0.30845019,-0.066624281,0.0,964,946,1910
964,NIO,-0.131147633,-0.310257459,0.0,946,971,1917
965,ILMN,-0.138728761,-0.44086929,0.0,948,974,1922
966,LPL,-0.714363331,-0.080366042,0.051992553,973,950,1923
967,CUK,-0.577674136,-0.095819748,0.0,971,955,1926
968,CCL,-0.577674136,-0.095819748,0.0,971,955,1926
969,NEA,-0.392244409,-0.168459055,0.073260271,966,963,1929
970,NCLH,-0.441786383,-0.114920762,0.0,969,961,1930
971,RNG,-0.260767099,-0.25739584,0.0,960,970,1930
972,TEO,-0.491679368,-0.179262728,0.002938504,970,966,1936
973,KEP,-1.747402647,-0.171610531,0.003991992,975,964,1939
974,W,-0.38177573,-0.871352785,0.0,965,975,1940
